ID,Флаг дозвона,Флаг продажи,Расходы,PV,NPV
0,1,1,30,1422,1392
1,0,0,12,0,-12
2,0,0,58,0,-58
3,1,1,724,1326,602
4,0,0,12,0,-12
5,1,0,32,0,-32
6,0,0,122,0,-122
7,1,1,674,2665,1991
8,1,1,743,1416,673
9,0,0,23,0,-23
10,1,0,77,0,-77
11,1,1,468,1291,823
12,1,0,7,0,-7
13,0,0,5,0,-5
14,1,1,583,1316,733
15,0,0,69,0,-69
16,1,0,30,0,-30
17,1,0,74,0,-74
18,1,0,44,0,-44
19,1,1,181,1580,1399
20,0,0,63,0,-63
21,1,0,78,0,-78
22,0,0,92,0,-92
23,1,1,320,2621,2301
24,0,0,19,0,-19
25,1,0,2,0,-2
26,1,0,37,0,-37
27,1,0,23,0,-23
28,0,0,6,0,-6
29,1,1,1883,1344,-539
30,1,0,25,0,-25
31,1,1,367,1762,1395
32,1,1,1257,1466,209
33,1,0,54,0,-54
34,0,0,111,0,-111
35,1,1,185,1361,1176
36,1,1,132,1327,1195
37,0,0,7,0,-7
38,0,0,27,0,-27
39,1,0,44,0,-44
40,1,1,55,1350,1295
41,1,1,87,1602,1515
42,0,0,14,0,-14
43,1,0,89,0,-89
44,1,0,13,0,-13
45,1,0,57,0,-57
46,0,0,71,0,-71
47,1,0,31,0,-31
48,1,1,1154,1577,423
49,1,1,443,1233,790
50,1,0,21,0,-21
51,1,1,821,2713,1892
52,1,1,303,1809,1506
53,0,0,20,0,-20
54,1,0,46,0,-46
55,1,1,156,1319,1163
56,0,0,21,0,-21
57,0,0,118,0,-118
58,1,0,16,0,-16
59,1,0,180,0,-180
60,0,0,83,0,-83
61,0,0,48,0,-48
62,1,0,12,0,-12
63,1,0,130,0,-130
64,1,1,977,1324,347
65,0,0,20,0,-20
66,0,0,7,0,-7
67,1,0,89,0,-89
68,1,1,561,1454,893
69,1,0,33,0,-33
70,0,0,17,0,-17
71,0,0,12,0,-12
72,1,1,558,1588,1030
73,0,0,117,0,-117
74,0,0,32,0,-32
75,0,0,67,0,-67
76,0,0,187,0,-187
77,1,0,117,0,-117
78,0,0,21,0,-21
79,1,0,80,0,-80
80,1,0,148,0,-148
81,0,0,31,0,-31
82,1,0,12,0,-12
83,1,1,255,1591,1336
84,1,0,132,0,-132
85,1,1,82,1648,1566
86,0,0,46,0,-46
87,1,0,5,0,-5
88,1,1,67,2331,2264
89,1,0,17,0,-17
90,1,0,34,0,-34
91,1,0,27,0,-27
92,0,0,30,0,-30
93,0,0,116,0,-116
94,1,1,537,2552,2015
95,1,0,44,0,-44
96,1,1,1263,1467,204
97,0,0,113,0,-113
98,0,0,83,0,-83
99,1,0,7,0,-7
100,1,0,23,0,-23
101,1,0,39,0,-39
102,0,0,93,0,-93
103,1,1,1357,1412,55
104,1,0,19,0,-19
105,1,0,10,0,-10
106,1,1,236,1310,1074
107,0,0,78,0,-78
108,0,0,39,0,-39
109,1,0,22,0,-22
110,0,0,145,0,-145
111,1,1,561,2204,1643
112,0,0,43,0,-43
113,0,0,64,0,-64
114,0,0,4,0,-4
115,1,0,123,0,-123
116,1,0,59,0,-59
117,1,0,24,0,-24
118,1,1,668,1286,618
119,0,0,25,0,-25
120,1,0,3,0,-3
121,0,0,16,0,-16
122,0,0,51,0,-51
123,1,0,15,0,-15
124,0,0,12,0,-12
125,0,0,117,0,-117
126,0,0,8,0,-8
127,0,0,13,0,-13
128,1,1,97,1318,1221
129,1,0,0,0,0
130,0,0,20,0,-20
131,1,0,55,0,-55
132,0,0,1,0,-1
133,0,0,155,0,-155
134,1,1,1429,1538,109
135,0,0,10,0,-10
136,1,1,840,1278,438
137,1,0,88,0,-88
138,0,0,178,0,-178
139,1,0,27,0,-27
140,0,0,9,0,-9
141,1,1,356,2815,2459
142,0,0,175,0,-175
143,1,1,116,1658,1542
144,1,1,702,1937,1235
145,1,1,369,1652,1283
146,1,0,62,0,-62
147,0,0,99,0,-99
148,1,0,141,0,-141
149,1,0,110,0,-110
150,0,0,32,0,-32
151,1,1,1105,1296,191
152,1,1,499,1266,767
153,0,0,27,0,-27
154,1,1,307,1323,1016
155,0,0,67,0,-67
156,1,0,55,0,-55
157,0,0,34,0,-34
158,1,1,97,1299,1202
159,0,0,39,0,-39
160,0,0,45,0,-45
161,1,1,547,1204,657
162,1,0,58,0,-58
163,0,0,28,0,-28
164,1,0,75,0,-75
165,1,1,623,1339,716
166,1,0,75,0,-75
167,1,0,19,0,-19
168,1,1,225,1637,1412
169,0,0,86,0,-86
170,1,1,565,1282,717
171,0,0,0,0,0
172,1,0,50,0,-50
173,1,1,1086,1295,209
174,0,0,73,0,-73
175,1,1,73,2189,2116
176,0,0,3,0,-3
177,1,0,150,0,-150
178,1,0,52,0,-52
179,1,1,457,1907,1450
180,1,1,203,1347,1144
181,1,1,644,2299,1655
182,1,0,78,0,-78
183,0,0,27,0,-27
184,1,0,170,0,-170
185,1,0,42,0,-42
186,0,0,8,0,-8
187,0,0,24,0,-24
188,1,1,779,1361,582
189,0,0,12,0,-12
190,0,0,27,0,-27
191,1,0,47,0,-47
192,1,1,463,1252,789
193,1,1,289,1523,1234
194,1,1,1385,1972,587
195,1,0,22,0,-22
196,0,0,38,0,-38
197,1,1,325,1561,1236
198,1,0,8,0,-8
199,1,0,64,0,-64
200,1,1,214,1819,1605
201,0,0,40,0,-40
202,1,1,384,1216,832
203,1,0,38,0,-38
204,1,0,25,0,-25
205,1,0,2,0,-2
206,0,0,32,0,-32
207,0,0,74,0,-74
208,0,0,2,0,-2
209,1,1,954,1794,840
210,1,0,3,0,-3
211,0,0,30,0,-30
212,0,0,45,0,-45
213,0,0,37,0,-37
214,1,0,58,0,-58
215,0,0,22,0,-22
216,0,0,25,0,-25
217,0,0,37,0,-37
218,1,1,95,1234,1139
219,0,0,28,0,-28
220,1,1,361,1515,1154
221,0,0,49,0,-49
222,1,1,267,1643,1376
223,0,0,16,0,-16
224,1,0,1,0,-1
225,0,0,15,0,-15
226,0,0,111,0,-111
227,1,1,494,2593,2099
228,1,0,102,0,-102
229,0,0,11,0,-11
230,1,1,527,1237,710
231,1,0,53,0,-53
232,0,0,76,0,-76
233,0,0,35,0,-35
234,0,0,27,0,-27
235,1,0,35,0,-35
236,1,1,253,1412,1159
237,1,0,6,0,-6
238,1,1,245,3441,3196
239,1,1,499,1495,996
240,1,0,19,0,-19
241,0,0,54,0,-54
242,0,0,8,0,-8
243,0,0,23,0,-23
244,1,1,422,1337,915
245,1,0,91,0,-91
246,1,1,185,2770,2585
247,1,0,110,0,-110
248,1,0,62,0,-62
249,1,0,54,0,-54
250,1,1,835,1224,389
251,0,0,10,0,-10
252,1,0,61,0,-61
253,0,0,79,0,-79
254,0,0,8,0,-8
255,1,0,12,0,-12
256,1,0,6,0,-6
257,1,1,923,1266,343
258,1,0,3,0,-3
259,1,0,26,0,-26
260,0,0,71,0,-71
261,1,0,40,0,-40
262,1,0,27,0,-27
263,0,0,89,0,-89
264,0,0,0,0,0
265,0,0,12,0,-12
266,0,0,6,0,-6
267,0,0,92,0,-92
268,1,0,68,0,-68
269,1,1,486,6045,5559
270,1,0,13,0,-13
271,1,1,111,1527,1416
272,0,0,15,0,-15
273,1,0,19,0,-19
274,0,0,25,0,-25
275,1,0,82,0,-82
276,1,0,14,0,-14
277,1,1,128,1533,1405
278,1,0,13,0,-13
279,0,0,206,0,-206
280,1,0,10,0,-10
281,0,0,31,0,-31
282,0,0,52,0,-52
283,0,0,35,0,-35
284,1,0,28,0,-28
285,1,1,478,1771,1293
286,1,0,7,0,-7
287,1,1,274,3171,2897
288,1,0,0,0,0
289,1,1,105,1218,1113
290,0,0,17,0,-17
291,0,0,115,0,-115
292,1,0,60,0,-60
293,1,0,0,0,0
294,0,0,147,0,-147
295,1,1,107,1493,1386
296,0,0,28,0,-28
297,0,0,105,0,-105
298,1,0,10,0,-10
299,0,0,10,0,-10
300,1,0,4,0,-4
301,0,0,47,0,-47
302,1,0,26,0,-26
303,0,0,13,0,-13
304,0,0,9,0,-9
305,1,0,33,0,-33
306,1,0,50,0,-50
307,1,1,129,1245,1116
308,1,1,586,1231,645
309,1,0,12,0,-12
310,1,0,11,0,-11
311,0,0,178,0,-178
312,1,0,104,0,-104
313,0,0,40,0,-40
314,0,0,76,0,-76
315,0,0,19,0,-19
316,0,0,3,0,-3
317,1,1,1445,1319,-126
318,0,0,106,0,-106
319,0,0,29,0,-29
320,1,0,174,0,-174
321,1,1,75,6014,5939
322,1,0,0,0,0
323,0,0,18,0,-18
324,0,0,77,0,-77
325,1,1,822,3336,2514
326,0,0,32,0,-32
327,1,1,304,1362,1058
328,1,0,25,0,-25
329,1,0,80,0,-80
330,1,0,41,0,-41
331,0,0,4,0,-4
332,1,1,1298,1617,319
333,1,1,106,2524,2418
334,1,1,164,1299,1135
335,1,0,14,0,-14
336,0,0,17,0,-17
337,0,0,19,0,-19
338,0,0,11,0,-11
339,1,0,9,0,-9
340,0,0,13,0,-13
341,0,0,45,0,-45
342,0,0,59,0,-59
343,1,1,300,1280,980
344,1,1,527,1461,934
345,1,0,2,0,-2
346,0,0,145,0,-145
347,1,1,877,1752,875
348,0,0,29,0,-29
349,0,0,17,0,-17
350,1,1,297,3283,2986
351,0,0,36,0,-36
352,1,1,566,1587,1021
353,1,1,253,1629,1376
354,1,0,45,0,-45
355,1,0,20,0,-20
356,0,0,3,0,-3
357,0,0,54,0,-54
358,1,1,1077,1365,288
359,0,0,0,0,0
360,1,0,40,0,-40
361,0,0,10,0,-10
362,0,0,77,0,-77
363,1,0,0,0,0
364,0,0,78,0,-78
365,0,0,28,0,-28
366,1,1,327,1245,918
367,1,0,17,0,-17
368,1,1,1835,1419,-416
369,0,0,15,0,-15
370,1,1,341,1377,1036
371,0,0,38,0,-38
372,1,1,104,1469,1365
373,0,0,63,0,-63
374,1,1,1335,1945,610
375,0,0,82,0,-82
376,1,1,965,1671,706
377,1,0,77,0,-77
378,0,0,1,0,-1
379,0,0,88,0,-88
380,0,0,35,0,-35
381,1,0,79,0,-79
382,0,0,17,0,-17
383,1,1,44,2181,2137
384,0,0,16,0,-16
385,1,1,581,1655,1074
386,1,0,8,0,-8
387,1,1,785,1357,572
388,1,1,146,1434,1288
389,1,0,56,0,-56
390,0,0,8,0,-8
391,0,0,83,0,-83
392,1,1,646,2144,1498
393,1,0,30,0,-30
394,1,0,88,0,-88
395,1,0,24,0,-24
396,0,0,36,0,-36
397,0,0,69,0,-69
398,1,0,5,0,-5
399,0,0,70,0,-70
400,0,0,2,0,-2
401,1,1,449,1699,1250
402,0,0,59,0,-59
403,0,0,20,0,-20
404,1,1,309,1228,919
405,0,0,25,0,-25
406,1,1,67,1968,1901
407,1,1,231,1230,999
408,1,1,371,2119,1748
409,1,0,8,0,-8
410,1,1,143,1907,1764
411,1,0,31,0,-31
412,0,0,63,0,-63
413,0,0,0,0,0
414,1,1,589,1280,691
415,1,1,57,1424,1367
416,1,1,26,1230,1204
417,1,1,407,1254,847
418,0,0,2,0,-2
419,0,0,76,0,-76
420,1,1,269,1416,1147
421,1,0,45,0,-45
422,1,1,574,1974,1400
423,1,1,176,5226,5050
424,0,0,26,0,-26
425,0,0,16,0,-16
426,1,0,16,0,-16
427,1,0,137,0,-137
428,0,0,10,0,-10
429,1,0,0,0,0
430,1,1,151,1773,1622
431,1,0,31,0,-31
432,1,1,102,1374,1272
433,1,1,616,1247,631
434,1,0,1,0,-1
435,0,0,52,0,-52
436,1,0,32,0,-32
437,1,0,7,0,-7
438,0,0,2,0,-2
439,1,1,392,1202,810
440,0,0,0,0,0
441,0,0,20,0,-20
442,0,0,162,0,-162
443,1,1,1199,1703,504
444,1,1,328,1312,984
445,0,0,1,0,-1
446,1,0,42,0,-42
447,1,1,674,1364,690
448,0,0,21,0,-21
449,1,0,23,0,-23
450,1,1,369,1771,1402
451,1,0,27,0,-27
452,1,1,494,1366,872
453,1,1,612,1388,776
454,0,0,25,0,-25
455,1,0,0,0,0
456,0,0,1,0,-1
457,1,0,24,0,-24
458,1,0,9,0,-9
459,1,1,350,1401,1051
460,1,0,19,0,-19
461,0,0,7,0,-7
462,1,1,529,2403,1874
463,1,0,24,0,-24
464,1,1,406,1696,1290
465,1,0,3,0,-3
466,1,1,295,1799,1504
467,0,0,87,0,-87
468,1,0,32,0,-32
469,1,0,27,0,-27
470,1,1,137,1274,1137
471,1,1,1138,1881,743
472,1,0,16,0,-16
473,1,0,26,0,-26
474,1,1,49,1896,1847
475,0,0,34,0,-34
476,1,1,146,1275,1129
477,0,0,36,0,-36
478,1,0,54,0,-54
479,0,0,59,0,-59
480,1,0,28,0,-28
481,0,0,11,0,-11
482,1,0,11,0,-11
483,1,1,181,1223,1042
484,0,0,6,0,-6
485,0,0,68,0,-68
486,1,1,264,2507,2243
487,1,0,32,0,-32
488,0,0,238,0,-238
489,0,0,10,0,-10
490,1,1,746,2028,1282
491,1,0,30,0,-30
492,1,1,464,1285,821
493,1,1,826,1527,701
494,1,1,492,1331,839
495,1,0,2,0,-2
496,1,1,260,1209,949
497,0,0,14,0,-14
498,1,1,342,1273,931
499,1,1,158,3799,3641
500,0,0,45,0,-45
501,0,0,52,0,-52
502,1,0,23,0,-23
503,0,0,3,0,-3
504,1,1,103,1213,1110
505,1,0,21,0,-21
506,0,0,98,0,-98
507,0,0,19,0,-19
508,1,0,56,0,-56
509,1,1,1048,1451,403
510,1,1,213,1211,998
511,1,0,6,0,-6
512,0,0,16,0,-16
513,0,0,69,0,-69
514,1,1,449,1253,804
515,0,0,32,0,-32
516,1,0,6,0,-6
517,1,0,15,0,-15
518,1,1,905,1592,687
519,0,0,3,0,-3
520,1,1,4052,1467,-2585
521,1,1,1322,1252,-70
522,0,0,63,0,-63
523,1,1,282,1263,981
524,1,1,141,1595,1454
525,0,0,110,0,-110
526,0,0,70,0,-70
527,0,0,44,0,-44
528,1,0,14,0,-14
529,1,1,234,1323,1089
530,1,0,94,0,-94
531,1,1,357,1350,993
532,0,0,43,0,-43
533,1,1,474,1336,862
534,1,0,23,0,-23
535,0,0,114,0,-114
536,1,0,74,0,-74
537,1,0,113,0,-113
538,1,0,0,0,0
539,0,0,34,0,-34
540,1,0,57,0,-57
541,0,0,111,0,-111
542,1,1,537,1418,881
543,1,1,361,1242,881
544,1,0,12,0,-12
545,1,0,5,0,-5
546,0,0,80,0,-80
547,1,0,11,0,-11
548,0,0,39,0,-39
549,0,0,22,0,-22
550,0,0,184,0,-184
551,1,0,14,0,-14
552,1,0,86,0,-86
553,1,0,11,0,-11
554,0,0,3,0,-3
555,1,1,881,1408,527
556,0,0,8,0,-8
557,1,1,1127,2472,1345
558,0,0,45,0,-45
559,1,1,307,1694,1387
560,0,0,180,0,-180
561,0,0,41,0,-41
562,1,0,59,0,-59
563,1,0,159,0,-159
564,0,0,13,0,-13
565,1,1,1437,1811,374
566,1,0,32,0,-32
567,0,0,12,0,-12
568,1,1,42,1343,1301
569,1,1,1017,1274,257
570,0,0,3,0,-3
571,0,0,72,0,-72
572,0,0,21,0,-21
573,0,0,199,0,-199
574,1,1,96,2099,2003
575,0,0,64,0,-64
576,0,0,27,0,-27
577,0,0,108,0,-108
578,1,1,121,1298,1177
579,0,0,14,0,-14
580,0,0,1,0,-1
581,1,0,23,0,-23
582,1,1,445,1227,782
583,0,0,6,0,-6
584,0,0,37,0,-37
585,1,1,1235,1419,184
586,1,0,37,0,-37
587,1,1,383,1815,1432
588,1,1,386,1528,1142
589,0,0,9,0,-9
590,0,0,13,0,-13
591,0,0,61,0,-61
592,1,0,53,0,-53
593,0,0,8,0,-8
594,1,1,186,1597,1411
595,0,0,30,0,-30
596,1,1,123,1201,1078
597,1,0,145,0,-145
598,0,0,1,0,-1
599,1,1,1009,2664,1655
600,0,0,10,0,-10
601,0,0,1,0,-1
602,1,1,652,1248,596
603,1,1,734,2107,1373
604,1,0,29,0,-29
605,0,0,10,0,-10
606,1,1,324,1209,885
607,1,1,38,1801,1763
608,1,0,90,0,-90
609,0,0,34,0,-34
610,1,1,432,1416,984
611,1,1,215,1453,1238
612,0,0,17,0,-17
613,0,0,3,0,-3
614,1,1,257,1645,1388
615,1,0,237,0,-237
616,1,0,100,0,-100
617,1,1,378,1260,882
618,1,1,337,1522,1185
619,1,0,33,0,-33
620,1,0,4,0,-4
621,0,0,54,0,-54
622,1,0,83,0,-83
623,1,0,3,0,-3
624,1,1,66,1267,1201
625,0,0,7,0,-7
626,1,1,1150,2048,898
627,1,1,56,1308,1252
628,1,0,111,0,-111
629,1,1,415,1238,823
630,0,0,93,0,-93
631,1,1,273,1389,1116
632,1,1,500,2260,1760
633,1,1,381,1729,1348
634,0,0,16,0,-16
635,0,0,70,0,-70
636,0,0,10,0,-10
637,0,0,5,0,-5
638,1,1,1065,2146,1081
639,1,0,0,0,0
640,1,1,740,1402,662
641,1,1,752,1490,738
642,1,1,41,1367,1326
643,1,1,742,1367,625
644,1,1,692,3069,2377
645,1,1,2127,2297,170
646,0,0,22,0,-22
647,1,1,304,1677,1373
648,1,1,506,1513,1007
649,1,0,32,0,-32
650,0,0,23,0,-23
651,1,1,452,1648,1196
652,0,0,70,0,-70
653,1,1,163,1288,1125
654,1,0,9,0,-9
655,0,0,61,0,-61
656,1,0,245,0,-245
657,1,1,857,1660,803
658,1,1,567,1357,790
659,1,0,14,0,-14
660,0,0,105,0,-105
661,1,1,102,3001,2899
662,0,0,44,0,-44
663,1,0,13,0,-13
664,1,1,68,1305,1237
665,1,1,102,1418,1316
666,1,0,56,0,-56
667,0,0,5,0,-5
668,1,0,40,0,-40
669,1,1,90,1236,1146
670,1,0,92,0,-92
671,0,0,2,0,-2
672,1,0,34,0,-34
673,1,0,13,0,-13
674,1,1,1110,1200,90
675,1,0,96,0,-96
676,1,0,19,0,-19
677,1,1,1025,1570,545
678,0,0,70,0,-70
679,1,0,22,0,-22
680,1,0,91,0,-91
681,0,0,1,0,-1
682,1,1,1154,1283,129
683,0,0,27,0,-27
684,0,0,28,0,-28
685,1,1,742,2332,1590
686,1,0,7,0,-7
687,1,0,4,0,-4
688,1,1,823,2810,1987
689,0,0,116,0,-116
690,0,0,55,0,-55
691,0,0,19,0,-19
692,1,0,33,0,-33
693,1,0,89,0,-89
694,0,0,2,0,-2
695,0,0,3,0,-3
696,1,0,9,0,-9
697,1,0,97,0,-97
698,1,0,46,0,-46
699,0,0,20,0,-20
700,1,1,642,2530,1888
701,0,0,68,0,-68
702,1,0,27,0,-27
703,0,0,39,0,-39
704,1,0,46,0,-46
705,1,0,33,0,-33
706,0,0,25,0,-25
707,1,0,5,0,-5
708,1,1,1032,1661,629
709,1,1,610,1984,1374
710,1,1,110,1243,1133
711,0,0,86,0,-86
712,1,1,646,1364,718
713,0,0,28,0,-28
714,0,0,0,0,0
715,0,0,21,0,-21
716,1,1,121,1263,1142
717,1,0,68,0,-68
718,1,0,44,0,-44
719,1,0,15,0,-15
720,1,1,320,1596,1276
721,1,1,777,1470,693
722,1,1,514,1729,1215
723,1,0,64,0,-64
724,1,1,965,1255,290
725,1,0,2,0,-2
726,1,1,2720,1329,-1391
727,1,0,102,0,-102
728,1,1,613,1814,1201
729,0,0,56,0,-56
730,1,1,290,1319,1029
731,0,0,222,0,-222
732,1,1,558,1342,784
733,0,0,17,0,-17
734,1,0,122,0,-122
735,0,0,33,0,-33
736,0,0,83,0,-83
737,1,0,5,0,-5
738,1,1,848,1290,442
739,0,0,94,0,-94
740,0,0,48,0,-48
741,0,0,37,0,-37
742,1,0,20,0,-20
743,1,1,293,1597,1304
744,0,0,32,0,-32
745,0,0,45,0,-45
746,0,0,42,0,-42
747,1,0,126,0,-126
748,0,0,22,0,-22
749,1,1,409,1426,1017
750,1,0,28,0,-28
751,0,0,30,0,-30
752,0,0,6,0,-6
753,0,0,22,0,-22
754,0,0,13,0,-13
755,1,1,380,1303,923
756,1,0,14,0,-14
757,1,1,2173,1307,-866
758,0,0,37,0,-37
759,1,0,44,0,-44
760,1,0,0,0,0
761,0,0,38,0,-38
762,1,1,781,1345,564
763,0,0,7,0,-7
764,0,0,0,0,0
765,1,1,206,1377,1171
766,0,0,24,0,-24
767,1,0,21,0,-21
768,0,0,13,0,-13
769,1,0,24,0,-24
770,1,0,13,0,-13
771,0,0,17,0,-17
772,0,0,43,0,-43
773,1,0,66,0,-66
774,1,0,55,0,-55
775,0,0,60,0,-60
776,1,1,1251,1520,269
777,0,0,29,0,-29
778,1,1,137,1587,1450
779,1,0,19,0,-19
780,1,0,44,0,-44
781,1,1,197,1240,1043
782,1,1,300,1257,957
783,1,1,685,1603,918
784,1,1,504,1567,1063
785,0,0,35,0,-35
786,0,0,95,0,-95
787,1,0,126,0,-126
788,0,0,73,0,-73
789,0,0,142,0,-142
790,1,1,1148,2207,1059
791,1,0,2,0,-2
792,0,0,24,0,-24
793,1,0,13,0,-13
794,1,1,531,1855,1324
795,0,0,57,0,-57
796,0,0,55,0,-55
797,0,0,69,0,-69
798,1,0,47,0,-47
799,1,0,16,0,-16
800,1,1,973,1372,399
801,1,1,1072,1601,529
802,0,0,14,0,-14
803,1,1,422,1653,1231
804,0,0,6,0,-6
805,1,0,2,0,-2
806,1,1,321,3261,2940
807,1,1,410,1221,811
808,1,0,15,0,-15
809,0,0,207,0,-207
810,1,1,337,1259,922
811,0,0,2,0,-2
812,0,0,18,0,-18
813,0,0,0,0,0
814,1,1,1834,1664,-170
815,1,0,125,0,-125
816,1,0,9,0,-9
817,1,1,600,1282,682
818,0,0,6,0,-6
819,0,0,5,0,-5
820,0,0,112,0,-112
821,1,0,24,0,-24
822,0,0,7,0,-7
823,1,0,54,0,-54
824,0,0,14,0,-14
825,1,0,6,0,-6
826,0,0,18,0,-18
827,1,1,63,1231,1168
828,0,0,3,0,-3
829,1,0,34,0,-34
830,1,0,14,0,-14
831,1,0,18,0,-18
832,0,0,1,0,-1
833,1,0,16,0,-16
834,0,0,37,0,-37
835,1,0,11,0,-11
836,1,1,245,1469,1224
837,1,1,171,1251,1080
838,1,0,77,0,-77
839,1,0,11,0,-11
840,0,0,24,0,-24
841,1,1,540,1822,1282
842,1,1,185,1229,1044
843,1,0,84,0,-84
844,0,0,30,0,-30
845,1,0,37,0,-37
846,1,1,472,2167,1695
847,0,0,28,0,-28
848,0,0,1,0,-1
849,0,0,45,0,-45
850,1,1,991,1358,367
851,0,0,104,0,-104
852,0,0,72,0,-72
853,0,0,181,0,-181
854,1,1,143,1233,1090
855,0,0,43,0,-43
856,0,0,66,0,-66
857,1,0,84,0,-84
858,0,0,24,0,-24
859,1,1,468,1603,1135
860,0,0,73,0,-73
861,1,0,7,0,-7
862,0,0,58,0,-58
863,0,0,31,0,-31
864,1,0,21,0,-21
865,0,0,5,0,-5
866,1,1,1155,1579,424
867,1,1,1404,1891,487
868,1,1,945,1568,623
869,1,0,69,0,-69
870,0,0,13,0,-13
871,0,0,43,0,-43
872,0,0,56,0,-56
873,1,0,20,0,-20
874,0,0,21,0,-21
875,0,0,10,0,-10
876,0,0,47,0,-47
877,1,1,448,1538,1090
878,1,0,7,0,-7
879,1,0,83,0,-83
880,0,0,0,0,0
881,0,0,81,0,-81
882,0,0,4,0,-4
883,0,0,31,0,-31
884,0,0,57,0,-57
885,0,0,7,0,-7
886,1,1,545,1615,1070
887,1,0,44,0,-44
888,0,0,13,0,-13
889,1,1,565,1495,930
890,1,0,70,0,-70
891,0,0,180,0,-180
892,0,0,53,0,-53
893,0,0,36,0,-36
894,1,1,915,1606,691
895,0,0,12,0,-12
896,1,0,130,0,-130
897,1,1,170,1390,1220
898,1,1,672,2426,1754
899,1,1,1557,1393,-164
900,1,1,259,1314,1055
901,0,0,11,0,-11
902,0,0,120,0,-120
903,1,1,292,1335,1043
904,1,0,78,0,-78
905,0,0,0,0,0
906,0,0,11,0,-11
907,0,0,18,0,-18
908,1,0,169,0,-169
909,0,0,35,0,-35
910,1,1,351,1770,1419
911,0,0,13,0,-13
912,1,1,1437,1314,-123
913,1,1,926,1655,729
914,1,1,33,1972,1939
915,1,0,141,0,-141
916,1,1,187,1594,1407
917,1,1,512,1472,960
918,0,0,63,0,-63
919,0,0,16,0,-16
920,1,0,23,0,-23
921,1,1,410,1389,979
922,1,1,238,1258,1020
923,1,0,25,0,-25
924,0,0,46,0,-46
925,0,0,60,0,-60
926,0,0,7,0,-7
927,1,0,4,0,-4
928,1,0,26,0,-26
929,1,0,40,0,-40
930,1,1,111,1233,1122
931,0,0,33,0,-33
932,0,0,41,0,-41
933,0,0,40,0,-40
934,0,0,4,0,-4
935,0,0,50,0,-50
936,0,0,52,0,-52
937,1,0,45,0,-45
938,1,1,373,1248,875
939,1,1,227,1438,1211
940,0,0,58,0,-58
941,1,1,473,1612,1139
942,1,1,286,1223,937
943,1,1,1235,1555,320
944,0,0,6,0,-6
945,0,0,115,0,-115
946,1,1,149,1262,1113
947,1,0,63,0,-63
948,1,0,39,0,-39
949,1,0,68,0,-68
950,1,1,1051,1255,204
951,0,0,62,0,-62
952,0,0,2,0,-2
953,1,1,89,1312,1223
954,1,1,119,1233,1114
955,1,1,1040,1661,621
956,1,0,90,0,-90
957,1,0,69,0,-69
958,1,1,287,1209,922
959,0,0,40,0,-40
960,1,0,27,0,-27
961,0,0,28,0,-28
962,0,0,27,0,-27
963,1,1,860,1267,407
964,1,0,40,0,-40
965,0,0,26,0,-26
966,1,0,3,0,-3
967,1,1,271,1200,929
968,0,0,66,0,-66
969,0,0,2,0,-2
970,0,0,63,0,-63
971,0,0,19,0,-19
972,0,0,59,0,-59
973,1,1,1235,1283,48
974,1,1,231,2112,1881
975,0,0,19,0,-19
976,1,0,94,0,-94
977,0,0,8,0,-8
978,0,0,36,0,-36
979,0,0,67,0,-67
980,0,0,20,0,-20
981,1,1,500,1513,1013
982,1,1,449,1542,1093
983,0,0,184,0,-184
984,0,0,14,0,-14
985,0,0,9,0,-9
986,1,0,63,0,-63
987,1,1,236,1303,1067
988,0,0,110,0,-110
989,0,0,130,0,-130
990,1,1,218,1572,1354
991,0,0,62,0,-62
992,1,0,132,0,-132
993,0,0,68,0,-68
994,1,0,17,0,-17
995,0,0,154,0,-154
996,0,0,3,0,-3
997,0,0,39,0,-39
998,1,0,70,0,-70
999,1,0,16,0,-16
1000,0,0,8,0,-8
1001,0,0,137,0,-137
1002,0,0,45,0,-45
1003,1,0,62,0,-62
1004,0,0,33,0,-33
1005,1,1,383,1757,1374
1006,0,0,3,0,-3
1007,1,0,5,0,-5
1008,1,0,14,0,-14
1009,1,1,616,1463,847
1010,1,1,314,1862,1548
1011,1,1,567,1411,844
1012,1,0,17,0,-17
1013,1,1,145,2856,2711
1014,0,0,102,0,-102
1015,0,0,43,0,-43
1016,0,0,13,0,-13
1017,0,0,12,0,-12
1018,1,0,56,0,-56
1019,1,0,72,0,-72
1020,1,1,403,1378,975
1021,1,1,591,2225,1634
1022,1,1,102,1471,1369
1023,1,1,497,1270,773
1024,0,0,73,0,-73
1025,1,0,104,0,-104
1026,0,0,82,0,-82
1027,0,0,26,0,-26
1028,1,1,302,1436,1134
1029,0,0,10,0,-10
1030,1,0,74,0,-74
1031,1,1,17,1963,1946
1032,1,0,95,0,-95
1033,0,0,10,0,-10
1034,0,0,9,0,-9
1035,1,0,0,0,0
1036,0,0,14,0,-14
1037,1,0,52,0,-52
1038,1,1,1250,1218,-32
1039,1,1,738,1321,583
1040,0,0,123,0,-123
1041,0,0,11,0,-11
1042,1,0,70,0,-70
1043,0,0,0,0,0
1044,1,0,87,0,-87
1045,1,0,119,0,-119
1046,1,1,436,1832,1396
1047,0,0,83,0,-83
1048,0,0,2,0,-2
1049,0,0,2,0,-2
1050,1,1,146,1349,1203
1051,1,1,873,1276,403
1052,1,1,1327,1443,116
1053,0,0,8,0,-8
1054,1,1,166,2335,2169
1055,0,0,24,0,-24
1056,1,1,239,1285,1046
1057,0,0,28,0,-28
1058,0,0,41,0,-41
1059,0,0,2,0,-2
1060,1,1,238,1385,1147
1061,0,0,79,0,-79
1062,1,1,69,2114,2045
1063,1,0,137,0,-137
1064,0,0,174,0,-174
1065,0,0,41,0,-41
1066,1,0,71,0,-71
1067,1,0,25,0,-25
1068,1,0,44,0,-44
1069,0,0,3,0,-3
1070,1,1,524,1266,742
1071,1,0,79,0,-79
1072,0,0,46,0,-46
1073,1,1,567,1337,770
1074,0,0,41,0,-41
1075,1,0,10,0,-10
1076,1,0,33,0,-33
1077,1,0,24,0,-24
1078,1,0,7,0,-7
1079,0,0,1,0,-1
1080,0,0,3,0,-3
1081,1,1,927,1424,497
1082,1,0,61,0,-61
1083,1,1,952,1505,553
1084,0,0,2,0,-2
1085,1,1,63,1507,1444
1086,1,1,69,1306,1237
1087,1,0,4,0,-4
1088,1,0,87,0,-87
1089,1,0,10,0,-10
1090,1,1,115,1205,1090
1091,1,0,30,0,-30
1092,1,1,159,1431,1272
1093,0,0,27,0,-27
1094,0,0,4,0,-4
1095,0,0,86,0,-86
1096,0,0,44,0,-44
1097,1,0,31,0,-31
1098,1,1,161,1308,1147
1099,1,0,91,0,-91
1100,0,0,90,0,-90
1101,1,0,92,0,-92
1102,1,0,34,0,-34
1103,0,0,4,0,-4
1104,0,0,57,0,-57
1105,1,1,371,3614,3243
1106,0,0,3,0,-3
1107,0,0,75,0,-75
1108,0,0,47,0,-47
1109,1,1,393,1205,812
1110,0,0,60,0,-60
1111,1,1,394,2637,2243
1112,0,0,24,0,-24
1113,1,0,179,0,-179
1114,0,0,14,0,-14
1115,0,0,37,0,-37
1116,0,0,37,0,-37
1117,1,1,106,1240,1134
1118,1,0,15,0,-15
1119,1,0,29,0,-29
1120,1,1,2020,2189,169
1121,0,0,93,0,-93
1122,0,0,16,0,-16
1123,0,0,6,0,-6
1124,1,1,338,1433,1095
1125,0,0,43,0,-43
1126,0,0,26,0,-26
1127,0,0,3,0,-3
1128,0,0,15,0,-15
1129,0,0,8,0,-8
1130,0,0,6,0,-6
1131,0,0,86,0,-86
1132,1,1,224,1311,1087
1133,0,0,58,0,-58
1134,0,0,119,0,-119
1135,0,0,7,0,-7
1136,1,0,6,0,-6
1137,0,0,33,0,-33
1138,1,0,5,0,-5
1139,0,0,42,0,-42
1140,1,0,13,0,-13
1141,0,0,163,0,-163
1142,1,0,80,0,-80
1143,1,1,150,2037,1887
1144,1,0,29,0,-29
1145,0,0,11,0,-11
1146,1,0,44,0,-44
1147,0,0,107,0,-107
1148,1,1,196,1841,1645
1149,0,0,29,0,-29
1150,0,0,25,0,-25
1151,0,0,30,0,-30
1152,0,0,9,0,-9
1153,1,1,420,1664,1244
1154,0,0,23,0,-23
1155,1,1,1309,1283,-26
1156,1,1,626,1266,640
1157,1,1,1769,1916,147
1158,0,0,36,0,-36
1159,1,1,494,1393,899
1160,0,0,39,0,-39
1161,0,0,100,0,-100
1162,0,0,41,0,-41
1163,0,0,0,0,0
1164,1,0,71,0,-71
1165,0,0,47,0,-47
1166,1,1,517,2040,1523
1167,0,0,27,0,-27
1168,0,0,26,0,-26
1169,0,0,17,0,-17
1170,1,1,586,1395,809
1171,1,1,690,1382,692
1172,1,0,37,0,-37
1173,1,0,15,0,-15
1174,0,0,5,0,-5
1175,0,0,13,0,-13
1176,0,0,14,0,-14
1177,1,1,392,1388,996
1178,0,0,6,0,-6
1179,1,1,294,1227,933
1180,0,0,68,0,-68
1181,1,1,956,1282,326
1182,1,0,9,0,-9
1183,1,0,24,0,-24
1184,0,0,16,0,-16
1185,1,1,1152,1416,264
1186,1,1,1321,1303,-18
1187,0,0,40,0,-40
1188,1,1,618,2272,1654
1189,0,0,141,0,-141
1190,0,0,146,0,-146
1191,0,0,18,0,-18
1192,1,1,434,1518,1084
1193,1,0,34,0,-34
1194,0,0,29,0,-29
1195,0,0,16,0,-16
1196,0,0,12,0,-12
1197,0,0,16,0,-16
1198,1,0,2,0,-2
1199,0,0,157,0,-157
1200,1,1,723,1323,600
1201,0,0,5,0,-5
1202,1,0,12,0,-12
1203,1,1,2323,1573,-750
1204,1,1,892,2521,1629
1205,1,1,66,1220,1154
1206,1,1,187,1320,1133
1207,1,0,53,0,-53
1208,1,1,1655,2664,1009
1209,0,0,128,0,-128
1210,1,0,40,0,-40
1211,0,0,63,0,-63
1212,0,0,12,0,-12
1213,1,1,291,1311,1020
1214,1,1,547,1932,1385
1215,1,0,172,0,-172
1216,0,0,36,0,-36
1217,0,0,125,0,-125
1218,1,1,6,1401,1395
1219,1,1,131,1320,1189
1220,1,0,12,0,-12
1221,1,1,44,1453,1409
1222,1,1,283,1599,1316
1223,0,0,24,0,-24
1224,0,0,19,0,-19
1225,1,1,318,1546,1228
1226,0,0,3,0,-3
1227,0,0,115,0,-115
1228,1,1,456,1591,1135
1229,1,1,769,1747,978
1230,0,0,26,0,-26
1231,0,0,116,0,-116
1232,1,0,75,0,-75
1233,0,0,3,0,-3
1234,0,0,88,0,-88
1235,1,0,23,0,-23
1236,1,1,413,1229,816
1237,1,1,271,1274,1003
1238,1,1,839,1459,620
1239,0,0,1,0,-1
1240,0,0,59,0,-59
1241,0,0,12,0,-12
1242,0,0,68,0,-68
1243,1,1,443,2099,1656
1244,0,0,14,0,-14
1245,1,0,62,0,-62
1246,1,1,309,1304,995
1247,1,1,393,1318,925
1248,0,0,97,0,-97
1249,0,0,35,0,-35
1250,0,0,19,0,-19
1251,0,0,36,0,-36
1252,1,0,32,0,-32
1253,1,1,2395,1511,-884
1254,1,0,43,0,-43
1255,1,1,145,1830,1685
1256,0,0,4,0,-4
1257,1,1,1084,1292,208
1258,0,0,14,0,-14
1259,1,1,792,2521,1729
1260,1,0,99,0,-99
1261,0,0,101,0,-101
1262,1,0,122,0,-122
1263,1,0,31,0,-31
1264,0,0,24,0,-24
1265,0,0,107,0,-107
1266,1,1,9,5258,5249
1267,1,0,38,0,-38
1268,0,0,81,0,-81
1269,0,0,11,0,-11
1270,1,1,1052,1612,560
1271,0,0,17,0,-17
1272,1,0,27,0,-27
1273,0,0,118,0,-118
1274,1,1,85,4056,3971
1275,0,0,15,0,-15
1276,1,1,140,1291,1151
1277,0,0,22,0,-22
1278,1,0,25,0,-25
1279,0,0,44,0,-44
1280,1,0,84,0,-84
1281,0,0,18,0,-18
1282,0,0,38,0,-38
1283,1,1,737,1258,521
1284,1,0,44,0,-44
1285,1,1,526,1309,783
1286,1,0,29,0,-29
1287,1,1,641,1492,851
1288,0,0,119,0,-119
1289,1,0,23,0,-23
1290,1,0,4,0,-4
1291,1,1,285,1424,1139
1292,1,0,34,0,-34
1293,1,1,50,1548,1498
1294,1,0,251,0,-251
1295,0,0,9,0,-9
1296,1,1,148,1395,1247
1297,1,0,43,0,-43
1298,1,1,1106,1350,244
1299,0,0,21,0,-21
1300,1,0,19,0,-19
1301,1,1,1205,1902,697
1302,1,1,154,1219,1065
1303,0,0,97,0,-97
1304,0,0,4,0,-4
1305,0,0,16,0,-16
1306,0,0,9,0,-9
1307,1,0,156,0,-156
1308,1,1,430,1753,1323
1309,1,0,28,0,-28
1310,1,0,1,0,-1
1311,0,0,43,0,-43
1312,1,0,165,0,-165
1313,1,0,11,0,-11
1314,1,0,137,0,-137
1315,1,0,9,0,-9
1316,0,0,4,0,-4
1317,0,0,72,0,-72
1318,1,0,13,0,-13
1319,0,0,119,0,-119
1320,0,0,55,0,-55
1321,1,0,115,0,-115
1322,0,0,35,0,-35
1323,1,0,48,0,-48
1324,1,0,9,0,-9
1325,1,1,2028,2041,13
1326,1,0,39,0,-39
1327,0,0,123,0,-123
1328,0,0,7,0,-7
1329,0,0,0,0,0
1330,1,0,42,0,-42
1331,1,1,545,1378,833
1332,0,0,0,0,0
1333,1,1,659,1308,649
1334,1,1,937,1538,601
1335,1,1,498,1298,800
1336,0,0,3,0,-3
1337,0,0,47,0,-47
1338,1,0,81,0,-81
1339,0,0,25,0,-25
1340,1,1,520,1293,773
1341,0,0,52,0,-52
1342,0,0,28,0,-28
1343,0,0,56,0,-56
1344,0,0,53,0,-53
1345,1,1,675,1460,785
1346,0,0,25,0,-25
1347,1,1,276,1294,1018
1348,1,0,15,0,-15
1349,0,0,43,0,-43
1350,1,1,278,1228,950
1351,1,1,1431,1241,-190
1352,1,1,1404,1207,-197
1353,0,0,1,0,-1
1354,1,0,23,0,-23
1355,1,1,1100,2030,930
1356,1,0,43,0,-43
1357,1,0,13,0,-13
1358,0,0,307,0,-307
1359,1,0,29,0,-29
1360,1,0,85,0,-85
1361,1,1,1146,2443,1297
1362,1,1,461,1221,760
1363,1,0,50,0,-50
1364,0,0,46,0,-46
1365,1,0,28,0,-28
1366,0,0,36,0,-36
1367,0,0,23,0,-23
1368,0,0,3,0,-3
1369,0,0,27,0,-27
1370,1,1,927,1762,835
1371,1,0,25,0,-25
1372,0,0,13,0,-13
1373,1,1,641,2172,1531
1374,0,0,3,0,-3
1375,1,0,51,0,-51
1376,0,0,94,0,-94
1377,1,0,19,0,-19
1378,1,0,3,0,-3
1379,0,0,10,0,-10
1380,1,1,969,1830,861
1381,1,0,78,0,-78
1382,0,0,60,0,-60
1383,1,1,635,1435,800
1384,1,0,64,0,-64
1385,1,0,45,0,-45
1386,1,1,783,1211,428
1387,1,1,624,1641,1017
1388,1,0,2,0,-2
1389,0,0,7,0,-7
1390,1,1,709,1622,913
1391,0,0,7,0,-7
1392,1,0,170,0,-170
1393,0,0,31,0,-31
1394,0,0,15,0,-15
1395,0,0,75,0,-75
1396,1,1,162,1320,1158
1397,1,0,4,0,-4
1398,0,0,32,0,-32
1399,1,0,45,0,-45
1400,1,0,14,0,-14
1401,0,0,169,0,-169
1402,0,0,235,0,-235
1403,1,1,338,1637,1299
1404,1,0,20,0,-20
1405,1,1,193,2108,1915
1406,0,0,19,0,-19
1407,1,0,18,0,-18
1408,1,0,64,0,-64
1409,1,1,125,1278,1153
1410,1,0,60,0,-60
1411,1,0,2,0,-2
1412,0,0,26,0,-26
1413,0,0,106,0,-106
1414,0,0,205,0,-205
1415,0,0,100,0,-100
1416,1,0,254,0,-254
1417,0,0,301,0,-301
1418,0,0,10,0,-10
1419,0,0,144,0,-144
1420,1,0,35,0,-35
1421,0,0,210,0,-210
1422,1,0,23,0,-23
1423,0,0,9,0,-9
1424,1,1,107,1228,1121
1425,0,0,45,0,-45
1426,1,1,717,1644,927
1427,1,1,165,1279,1114
1428,0,0,31,0,-31
1429,0,0,147,0,-147
1430,0,0,9,0,-9
1431,0,0,50,0,-50
1432,0,0,12,0,-12
1433,1,0,19,0,-19
1434,1,0,23,0,-23
1435,0,0,14,0,-14
1436,1,1,776,1241,465
1437,0,0,59,0,-59
1438,1,1,683,1297,614
1439,0,0,40,0,-40
1440,1,1,425,2185,1760
1441,0,0,286,0,-286
1442,1,1,775,1677,902
1443,1,0,30,0,-30
1444,0,0,64,0,-64
1445,1,0,173,0,-173
1446,1,1,348,1237,889
1447,1,1,565,1279,714
1448,0,0,56,0,-56
1449,1,1,286,1413,1127
1450,1,0,15,0,-15
1451,1,1,37,1913,1876
1452,0,0,68,0,-68
1453,1,1,713,1450,737
1454,0,0,71,0,-71
1455,1,1,666,1284,618
1456,1,0,43,0,-43
1457,1,1,65,1780,1715
1458,1,1,453,1369,916
1459,1,0,89,0,-89
1460,0,0,0,0,0
1461,1,0,113,0,-113
1462,1,0,58,0,-58
1463,1,1,262,1411,1149
1464,1,0,69,0,-69
1465,1,1,359,2280,1921
1466,1,1,481,3379,2898
1467,0,0,34,0,-34
1468,0,0,41,0,-41
1469,1,1,910,1457,547
1470,1,1,183,1660,1477
1471,1,0,3,0,-3
1472,0,0,46,0,-46
1473,0,0,96,0,-96
1474,1,1,198,1438,1240
1475,0,0,33,0,-33
1476,0,0,51,0,-51
1477,1,0,33,0,-33
1478,0,0,42,0,-42
1479,1,1,1048,1249,201
1480,1,0,5,0,-5
1481,1,0,38,0,-38
1482,1,1,648,1279,631
1483,0,0,234,0,-234
1484,1,1,867,1324,457
1485,0,0,223,0,-223
1486,0,0,0,0,0
1487,1,0,3,0,-3
1488,1,1,36,1212,1176
1489,0,0,10,0,-10
1490,0,0,5,0,-5
1491,0,0,32,0,-32
1492,1,0,21,0,-21
1493,0,0,1,0,-1
1494,1,1,208,1232,1024
1495,0,0,43,0,-43
1496,1,1,177,2154,1977
1497,0,0,76,0,-76
1498,1,1,447,2575,2128
1499,0,0,8,0,-8
1500,1,0,11,0,-11
1501,1,0,188,0,-188
1502,0,0,33,0,-33
1503,0,0,18,0,-18
1504,0,0,84,0,-84
1505,0,0,11,0,-11
1506,1,0,21,0,-21
1507,1,0,12,0,-12
1508,1,0,3,0,-3
1509,1,0,40,0,-40
1510,1,1,622,1442,820
1511,1,0,272,0,-272
1512,0,0,57,0,-57
1513,0,0,97,0,-97
1514,1,0,14,0,-14
1515,0,0,87,0,-87
1516,1,1,1413,1296,-117
1517,1,1,557,1202,645
1518,1,0,34,0,-34
1519,1,0,31,0,-31
1520,0,0,6,0,-6
1521,1,1,220,1305,1085
1522,1,0,22,0,-22
1523,1,0,7,0,-7
1524,1,0,25,0,-25
1525,1,1,173,1279,1106
1526,1,0,162,0,-162
1527,1,1,262,1351,1089
1528,1,0,18,0,-18
1529,1,1,357,1534,1177
1530,1,1,229,1344,1115
1531,1,0,23,0,-23
1532,1,1,331,1406,1075
1533,0,0,124,0,-124
1534,1,1,53,1731,1678
1535,1,1,529,1220,691
1536,1,0,96,0,-96
1537,0,0,49,0,-49
1538,1,1,30,1584,1554
1539,0,0,34,0,-34
1540,1,1,1128,1508,380
1541,1,0,14,0,-14
1542,0,0,1,0,-1
1543,1,0,16,0,-16
1544,1,1,2646,1417,-1229
1545,1,1,197,1343,1146
1546,0,0,31,0,-31
1547,1,0,283,0,-283
1548,1,0,1,0,-1
1549,1,0,29,0,-29
1550,0,0,3,0,-3
1551,1,0,170,0,-170
1552,0,0,19,0,-19
1553,0,0,16,0,-16
1554,1,0,0,0,0
1555,0,0,69,0,-69
1556,1,0,57,0,-57
1557,1,1,235,1791,1556
1558,1,0,57,0,-57
1559,0,0,24,0,-24
1560,1,1,302,2706,2404
1561,1,0,33,0,-33
1562,0,0,14,0,-14
1563,1,0,13,0,-13
1564,0,0,61,0,-61
1565,0,0,21,0,-21
1566,1,1,585,1569,984
1567,0,0,21,0,-21
1568,0,0,84,0,-84
1569,1,1,1328,1860,532
1570,1,1,943,1654,711
1571,1,1,900,1753,853
1572,0,0,112,0,-112
1573,1,1,457,1262,805
1574,1,0,74,0,-74
1575,1,0,50,0,-50
1576,1,1,193,1243,1050
1577,0,0,60,0,-60
1578,1,1,693,1729,1036
1579,1,1,299,1744,1445
1580,1,0,17,0,-17
1581,0,0,2,0,-2
1582,0,0,162,0,-162
1583,1,1,1288,1822,534
1584,0,0,188,0,-188
1585,1,0,104,0,-104
1586,1,1,203,1577,1374
1587,1,0,111,0,-111
1588,1,1,112,1242,1130
1589,1,1,374,1529,1155
1590,1,1,842,1319,477
1591,0,0,12,0,-12
1592,0,0,102,0,-102
1593,1,0,1,0,-1
1594,1,0,450,0,-450
1595,1,1,448,1212,764
1596,1,1,278,1314,1036
1597,0,0,160,0,-160
1598,1,0,52,0,-52
1599,0,0,105,0,-105
1600,1,1,138,1280,1142
1601,1,0,105,0,-105
1602,0,0,2,0,-2
1603,1,1,961,1237,276
1604,1,1,1224,4043,2819
1605,1,0,48,0,-48
1606,1,1,402,1237,835
1607,1,0,3,0,-3
1608,1,1,344,1395,1051
1609,1,0,4,0,-4
1610,1,1,58,1547,1489
1611,1,1,111,1381,1270
1612,1,1,504,2000,1496
1613,1,0,117,0,-117
1614,1,0,17,0,-17
1615,0,0,101,0,-101
1616,1,0,2,0,-2
1617,1,1,238,2161,1923
1618,0,0,26,0,-26
1619,1,0,11,0,-11
1620,1,0,8,0,-8
1621,0,0,20,0,-20
1622,1,0,65,0,-65
1623,1,0,164,0,-164
1624,1,1,789,4552,3763
1625,1,1,86,1342,1256
1626,0,0,27,0,-27
1627,0,0,109,0,-109
1628,1,0,4,0,-4
1629,1,0,15,0,-15
1630,1,1,357,1726,1369
1631,0,0,40,0,-40
1632,1,0,53,0,-53
1633,0,0,98,0,-98
1634,1,0,27,0,-27
1635,0,0,8,0,-8
1636,1,0,17,0,-17
1637,0,0,78,0,-78
1638,1,0,18,0,-18
1639,1,0,246,0,-246
1640,0,0,10,0,-10
1641,0,0,7,0,-7
1642,1,1,524,1358,834
1643,1,0,27,0,-27
1644,0,0,17,0,-17
1645,1,0,44,0,-44
1646,1,1,412,1980,1568
1647,1,1,1009,1275,266
1648,1,1,42,1245,1203
1649,1,0,4,0,-4
1650,0,0,22,0,-22
1651,1,0,24,0,-24
1652,1,1,186,1759,1573
1653,0,0,200,0,-200
1654,1,0,23,0,-23
1655,1,0,0,0,0
1656,0,0,135,0,-135
1657,1,0,14,0,-14
1658,1,1,947,1835,888
1659,0,0,10,0,-10
1660,1,0,25,0,-25
1661,0,0,21,0,-21
1662,1,0,26,0,-26
1663,0,0,44,0,-44
1664,0,0,52,0,-52
1665,1,1,714,1978,1264
1666,1,1,264,1351,1087
1667,1,1,667,2594,1927
1668,0,0,139,0,-139
1669,1,0,112,0,-112
1670,0,0,136,0,-136
1671,1,1,426,1292,866
1672,0,0,3,0,-3
1673,1,1,184,1345,1161
1674,1,0,263,0,-263
1675,0,0,69,0,-69
1676,0,0,17,0,-17
1677,0,0,46,0,-46
1678,0,0,90,0,-90
1679,0,0,38,0,-38
1680,1,1,1064,1203,139
1681,1,0,33,0,-33
1682,0,0,105,0,-105
1683,0,0,82,0,-82
1684,1,0,31,0,-31
1685,1,0,12,0,-12
1686,1,0,57,0,-57
1687,1,0,76,0,-76
1688,1,0,17,0,-17
1689,1,0,75,0,-75
1690,0,0,178,0,-178
1691,1,0,34,0,-34
1692,1,1,1032,1282,250
1693,0,0,11,0,-11
1694,1,1,213,1523,1310
1695,0,0,196,0,-196
1696,0,0,146,0,-146
1697,0,0,28,0,-28
1698,1,0,10,0,-10
1699,1,1,1345,1243,-102
1700,0,0,18,0,-18
1701,0,0,2,0,-2
1702,0,0,76,0,-76
1703,1,1,206,1583,1377
1704,0,0,96,0,-96
1705,1,0,148,0,-148
1706,1,0,21,0,-21
1707,1,1,223,3031,2808
1708,0,0,53,0,-53
1709,0,0,64,0,-64
1710,1,1,291,1216,925
1711,1,0,11,0,-11
1712,0,0,11,0,-11
1713,0,0,8,0,-8
1714,1,0,18,0,-18
1715,1,0,73,0,-73
1716,0,0,23,0,-23
1717,0,0,22,0,-22
1718,1,1,1575,1298,-277
1719,1,1,157,1226,1069
1720,0,0,21,0,-21
1721,1,1,1637,1587,-50
1722,1,1,504,2228,1724
1723,1,0,11,0,-11
1724,0,0,4,0,-4
1725,1,0,14,0,-14
1726,0,0,21,0,-21
1727,1,1,651,1217,566
1728,0,0,4,0,-4
1729,0,0,50,0,-50
1730,1,1,202,1948,1746
1731,1,0,49,0,-49
1732,1,0,1,0,-1
1733,1,0,64,0,-64
1734,1,0,121,0,-121
1735,0,0,101,0,-101
1736,1,0,118,0,-118
1737,1,1,72,1381,1309
1738,1,1,1855,1346,-509
1739,1,1,198,1346,1148
1740,1,0,27,0,-27
1741,1,0,131,0,-131
1742,0,0,89,0,-89
1743,0,0,76,0,-76
1744,1,1,80,1202,1122
1745,1,1,795,1356,561
1746,1,0,9,0,-9
1747,0,0,2,0,-2
1748,1,1,4141,1278,-2863
1749,0,0,47,0,-47
1750,0,0,40,0,-40
1751,1,0,10,0,-10
1752,1,1,154,1309,1155
1753,0,0,26,0,-26
1754,0,0,61,0,-61
1755,0,0,54,0,-54
1756,1,0,10,0,-10
1757,1,1,528,1565,1037
1758,0,0,118,0,-118
1759,0,0,86,0,-86
1760,1,0,77,0,-77
1761,1,0,9,0,-9
1762,0,0,82,0,-82
1763,1,1,394,2060,1666
1764,0,0,95,0,-95
1765,1,0,1,0,-1
1766,1,1,315,1218,903
1767,1,1,88,1291,1203
1768,1,0,9,0,-9
1769,1,1,593,1383,790
1770,0,0,21,0,-21
1771,0,0,52,0,-52
1772,1,1,194,1325,1131
1773,0,0,1,0,-1
1774,1,1,1176,1343,167
1775,1,1,224,1377,1153
1776,1,1,718,1619,901
1777,0,0,103,0,-103
1778,1,0,46,0,-46
1779,0,0,46,0,-46
1780,1,1,638,1348,710
1781,1,0,57,0,-57
1782,0,0,28,0,-28
1783,1,1,153,1341,1188
1784,1,1,674,2508,1834
1785,1,1,573,4334,3761
1786,1,1,301,1350,1049
1787,0,0,5,0,-5
1788,0,0,38,0,-38
1789,0,0,61,0,-61
1790,1,0,126,0,-126
1791,1,0,15,0,-15
1792,0,0,11,0,-11
1793,0,0,34,0,-34
1794,1,1,291,1478,1187
1795,1,0,91,0,-91
1796,0,0,120,0,-120
1797,0,0,87,0,-87
1798,0,0,52,0,-52
1799,1,0,1,0,-1
1800,1,1,622,1237,615
1801,0,0,27,0,-27
1802,1,0,18,0,-18
1803,1,0,15,0,-15
1804,1,1,309,1312,1003
1805,0,0,42,0,-42
1806,0,0,52,0,-52
1807,1,1,305,1967,1662
1808,1,0,3,0,-3
1809,0,0,168,0,-168
1810,1,0,1,0,-1
1811,0,0,11,0,-11
1812,0,0,186,0,-186
1813,1,0,25,0,-25
1814,0,0,31,0,-31
1815,1,1,108,2138,2030
1816,1,1,247,2040,1793
1817,1,1,595,1451,856
1818,0,0,63,0,-63
1819,1,0,91,0,-91
1820,1,1,828,2770,1942
1821,0,0,160,0,-160
1822,1,1,64,1384,1320
1823,1,1,513,2093,1580
1824,1,0,37,0,-37
1825,0,0,78,0,-78
1826,0,0,56,0,-56
1827,0,0,98,0,-98
1828,0,0,28,0,-28
1829,1,1,332,1259,927
1830,1,0,8,0,-8
1831,1,0,103,0,-103
1832,1,0,7,0,-7
1833,0,0,18,0,-18
1834,1,0,37,0,-37
1835,1,0,1,0,-1
1836,1,1,326,1284,958
1837,1,1,159,1394,1235
1838,1,0,60,0,-60
1839,1,0,200,0,-200
1840,1,0,3,0,-3
1841,1,1,458,1539,1081
1842,0,0,177,0,-177
1843,1,1,992,1209,217
1844,1,0,238,0,-238
1845,0,0,100,0,-100
1846,1,0,19,0,-19
1847,1,0,41,0,-41
1848,0,0,37,0,-37
1849,1,1,1986,1414,-572
1850,1,0,60,0,-60
1851,0,0,38,0,-38
1852,1,0,88,0,-88
1853,1,0,88,0,-88
1854,1,0,28,0,-28
1855,0,0,16,0,-16
1856,1,1,125,1347,1222
1857,1,1,1000,1716,716
1858,0,0,186,0,-186
1859,1,1,172,1266,1094
1860,0,0,1,0,-1
1861,1,1,94,1432,1338
1862,0,0,98,0,-98
1863,0,0,7,0,-7
1864,1,0,67,0,-67
1865,1,1,1580,1334,-246
1866,0,0,9,0,-9
1867,0,0,48,0,-48
1868,0,0,28,0,-28
1869,1,1,743,1231,488
1870,1,0,33,0,-33
1871,0,0,3,0,-3
1872,1,0,14,0,-14
1873,0,0,27,0,-27
1874,1,1,539,1449,910
1875,0,0,15,0,-15
1876,1,1,58,1769,1711
1877,0,0,54,0,-54
1878,1,0,19,0,-19
1879,0,0,187,0,-187
1880,1,0,60,0,-60
1881,0,0,101,0,-101
1882,0,0,9,0,-9
1883,0,0,36,0,-36
1884,0,0,3,0,-3
1885,1,0,37,0,-37
1886,0,0,284,0,-284
1887,0,0,8,0,-8
1888,0,0,60,0,-60
1889,0,0,58,0,-58
1890,0,0,205,0,-205
1891,1,1,397,1346,949
1892,1,0,102,0,-102
1893,1,1,553,1280,727
1894,0,0,119,0,-119
1895,0,0,56,0,-56
1896,0,0,1,0,-1
1897,0,0,3,0,-3
1898,1,1,216,1512,1296
1899,0,0,7,0,-7
1900,1,0,64,0,-64
1901,1,1,291,3298,3007
1902,1,1,657,1348,691
1903,0,0,5,0,-5
1904,0,0,72,0,-72
1905,1,0,5,0,-5
1906,1,1,702,1414,712
1907,1,1,1004,1279,275
1908,0,0,166,0,-166
1909,0,0,4,0,-4
1910,0,0,1,0,-1
1911,1,0,60,0,-60
1912,1,1,68,2067,1999
1913,1,1,500,1213,713
1914,0,0,65,0,-65
1915,1,0,31,0,-31
1916,0,0,35,0,-35
1917,1,1,460,1387,927
1918,0,0,113,0,-113
1919,1,0,19,0,-19
1920,0,0,60,0,-60
1921,1,0,82,0,-82
1922,1,1,502,1202,700
1923,0,0,41,0,-41
1924,1,0,36,0,-36
1925,1,0,9,0,-9
1926,0,0,36,0,-36
1927,0,0,83,0,-83
1928,1,0,254,0,-254
1929,0,0,55,0,-55
1930,0,0,209,0,-209
1931,1,0,84,0,-84
1932,1,0,51,0,-51
1933,1,0,148,0,-148
1934,1,0,79,0,-79
1935,0,0,5,0,-5
1936,1,0,92,0,-92
1937,1,0,60,0,-60
1938,0,0,11,0,-11
1939,0,0,7,0,-7
1940,0,0,51,0,-51
1941,1,0,0,0,0
1942,1,1,3356,1236,-2120
1943,0,0,65,0,-65
1944,1,1,120,1231,1111
1945,1,1,60,1421,1361
1946,1,1,1348,1440,92
1947,0,0,61,0,-61
1948,1,1,200,1705,1505
1949,1,1,466,1385,919
1950,1,1,320,1237,917
1951,0,0,120,0,-120
1952,1,1,397,1759,1362
1953,1,1,589,1629,1040
1954,0,0,98,0,-98
1955,0,0,110,0,-110
1956,0,0,199,0,-199
1957,1,0,0,0,0
1958,0,0,26,0,-26
1959,0,0,12,0,-12
1960,1,0,111,0,-111
1961,0,0,17,0,-17
1962,1,1,262,1359,1097
1963,1,1,1306,1447,141
1964,1,0,35,0,-35
1965,1,0,34,0,-34
1966,1,1,120,1469,1349
1967,1,0,2,0,-2
1968,1,0,4,0,-4
1969,1,1,138,1201,1063
1970,1,0,17,0,-17
1971,1,0,17,0,-17
1972,1,1,441,1204,763
1973,1,1,2447,1524,-923
1974,0,0,29,0,-29
1975,0,0,137,0,-137
1976,1,1,390,1275,885
1977,1,0,10,0,-10
1978,0,0,57,0,-57
1979,1,0,22,0,-22
1980,0,0,18,0,-18
1981,0,0,37,0,-37
1982,0,0,23,0,-23
1983,1,0,44,0,-44
1984,1,0,28,0,-28
1985,0,0,14,0,-14
1986,1,0,21,0,-21
1987,1,0,38,0,-38
1988,1,1,477,1384,907
1989,0,0,18,0,-18
1990,1,1,1221,1604,383
1991,0,0,2,0,-2
1992,1,1,139,1908,1769
1993,1,1,60,1393,1333
1994,1,0,4,0,-4
1995,1,1,266,1310,1044
1996,1,1,59,1361,1302
1997,0,0,91,0,-91
1998,1,0,28,0,-28
1999,1,0,139,0,-139
2000,1,0,5,0,-5
2001,0,0,57,0,-57
2002,0,0,25,0,-25
2003,1,0,27,0,-27
2004,1,1,92,1262,1170
2005,1,1,338,1428,1090
2006,0,0,93,0,-93
2007,1,0,90,0,-90
2008,0,0,0,0,0
2009,1,1,365,1228,863
2010,1,1,808,1363,555
2011,0,0,66,0,-66
2012,0,0,51,0,-51
2013,1,0,2,0,-2
2014,0,0,77,0,-77
2015,1,1,690,1359,669
2016,0,0,57,0,-57
2017,1,1,225,1871,1646
2018,0,0,8,0,-8
2019,0,0,19,0,-19
2020,0,0,65,0,-65
2021,0,0,31,0,-31
2022,1,1,1004,1303,299
2023,1,0,6,0,-6
2024,1,0,46,0,-46
2025,0,0,90,0,-90
2026,0,0,11,0,-11
2027,0,0,26,0,-26
2028,1,1,148,1288,1140
2029,1,1,260,1467,1207
2030,0,0,53,0,-53
2031,0,0,50,0,-50
2032,0,0,4,0,-4
2033,0,0,46,0,-46
2034,0,0,3,0,-3
2035,0,0,30,0,-30
2036,1,1,440,1455,1015
2037,1,0,9,0,-9
2038,1,0,100,0,-100
2039,0,0,108,0,-108
2040,0,0,50,0,-50
2041,0,0,81,0,-81
2042,1,0,28,0,-28
2043,0,0,126,0,-126
2044,1,0,139,0,-139
2045,1,1,485,1411,926
2046,1,0,90,0,-90
2047,1,0,1,0,-1
2048,0,0,106,0,-106
2049,1,0,58,0,-58
2050,1,1,348,1316,968
2051,0,0,108,0,-108
2052,1,0,10,0,-10
2053,0,0,53,0,-53
2054,1,0,65,0,-65
2055,0,0,85,0,-85
2056,1,1,100,1381,1281
2057,1,1,248,2825,2577
2058,1,0,34,0,-34
2059,1,1,888,1501,613
2060,1,0,79,0,-79
2061,1,0,3,0,-3
2062,0,0,29,0,-29
2063,0,0,0,0,0
2064,1,1,535,2562,2027
2065,0,0,18,0,-18
2066,1,1,500,1631,1131
2067,1,1,880,1533,653
2068,0,0,21,0,-21
2069,0,0,63,0,-63
2070,0,0,132,0,-132
2071,1,1,936,1784,848
2072,0,0,6,0,-6
2073,0,0,67,0,-67
2074,0,0,7,0,-7
2075,0,0,43,0,-43
2076,1,0,76,0,-76
2077,0,0,3,0,-3
2078,1,1,424,1209,785
2079,1,1,155,2010,1855
2080,1,1,1418,1540,122
2081,1,0,63,0,-63
2082,1,0,11,0,-11
2083,1,1,2498,1633,-865
2084,1,0,1,0,-1
2085,0,0,45,0,-45
2086,1,1,1263,1478,215
2087,0,0,69,0,-69
2088,1,1,1988,2579,591
2089,0,0,32,0,-32
2090,1,1,162,1395,1233
2091,1,0,87,0,-87
2092,0,0,9,0,-9
2093,1,0,137,0,-137
2094,1,0,68,0,-68
2095,0,0,98,0,-98
2096,0,0,13,0,-13
2097,1,0,23,0,-23
2098,1,0,91,0,-91
2099,1,0,71,0,-71
2100,0,0,77,0,-77
2101,0,0,25,0,-25
2102,0,0,239,0,-239
2103,1,0,43,0,-43
2104,1,1,443,1477,1034
2105,0,0,76,0,-76
2106,0,0,26,0,-26
2107,1,1,311,1201,890
2108,1,1,67,2049,1982
2109,0,0,24,0,-24
2110,1,0,119,0,-119
2111,0,0,33,0,-33
2112,0,0,69,0,-69
2113,1,1,400,1290,890
2114,1,1,83,1826,1743
2115,1,0,51,0,-51
2116,1,1,1094,1596,502
2117,1,1,312,1421,1109
2118,0,0,68,0,-68
2119,1,0,8,0,-8
2120,0,0,120,0,-120
2121,0,0,32,0,-32
2122,1,1,892,1425,533
2123,1,1,135,2002,1867
2124,0,0,39,0,-39
2125,0,0,23,0,-23
2126,1,0,8,0,-8
2127,1,1,373,1210,837
2128,1,1,150,1215,1065
2129,1,0,97,0,-97
2130,1,1,408,1819,1411
2131,0,0,12,0,-12
2132,1,1,384,1216,832
2133,1,1,184,1803,1619
2134,1,1,614,3019,2405
2135,1,1,1221,1546,325
2136,0,0,27,0,-27
2137,1,1,1296,1224,-72
2138,1,1,157,1373,1216
2139,0,0,92,0,-92
2140,1,1,417,1382,965
2141,1,1,1115,1999,884
2142,1,1,149,1404,1255
2143,1,1,127,1207,1080
2144,0,0,34,0,-34
2145,1,1,976,1440,464
2146,0,0,5,0,-5
2147,1,1,1751,1296,-455
2148,1,0,52,0,-52
2149,0,0,20,0,-20
2150,0,0,57,0,-57
2151,0,0,119,0,-119
2152,0,0,21,0,-21
2153,1,1,1145,1383,238
2154,0,0,58,0,-58
2155,1,0,27,0,-27
2156,1,0,67,0,-67
2157,0,0,47,0,-47
2158,1,0,51,0,-51
2159,1,0,52,0,-52
2160,1,1,1315,1556,241
2161,0,0,10,0,-10
2162,1,1,1052,1446,394
2163,0,0,82,0,-82
2164,1,0,15,0,-15
2165,1,1,313,1226,913
2166,1,0,36,0,-36
2167,1,0,46,0,-46
2168,1,1,172,1264,1092
2169,1,0,26,0,-26
2170,1,1,381,1849,1468
2171,1,0,12,0,-12
2172,0,0,10,0,-10
2173,1,0,32,0,-32
2174,0,0,27,0,-27
2175,1,1,473,1230,757
2176,1,1,1118,1290,172
2177,0,0,38,0,-38
2178,0,0,13,0,-13
2179,0,0,34,0,-34
2180,1,1,159,1245,1086
2181,0,0,24,0,-24
2182,1,0,150,0,-150
2183,1,0,8,0,-8
2184,0,0,48,0,-48
2185,0,0,68,0,-68
2186,1,1,253,1339,1086
2187,0,0,15,0,-15
2188,0,0,70,0,-70
2189,1,1,410,1688,1278
2190,1,0,22,0,-22
2191,1,0,29,0,-29
2192,0,0,31,0,-31
2193,1,1,1272,1288,16
2194,1,0,8,0,-8
2195,1,0,104,0,-104
2196,0,0,59,0,-59
2197,1,0,37,0,-37
2198,1,0,18,0,-18
2199,1,0,111,0,-111
2200,0,0,54,0,-54
2201,0,0,188,0,-188
2202,1,1,401,1740,1339
2203,0,0,56,0,-56
2204,0,0,6,0,-6
2205,0,0,98,0,-98
2206,1,0,31,0,-31
2207,1,0,37,0,-37
2208,1,1,176,1738,1562
2209,1,1,91,2004,1913
2210,0,0,32,0,-32
2211,1,0,25,0,-25
2212,0,0,11,0,-11
2213,0,0,66,0,-66
2214,1,1,528,1423,895
2215,0,0,35,0,-35
2216,1,1,309,1595,1286
2217,1,0,10,0,-10
2218,0,0,68,0,-68
2219,1,0,14,0,-14
2220,1,1,1112,1838,726
2221,1,0,105,0,-105
2222,1,1,310,1919,1609
2223,0,0,119,0,-119
2224,0,0,118,0,-118
2225,1,1,350,1277,927
2226,1,0,15,0,-15
2227,1,0,34,0,-34
2228,0,0,11,0,-11
2229,1,1,252,1276,1024
2230,1,0,23,0,-23
2231,1,0,15,0,-15
2232,0,0,28,0,-28
2233,1,0,46,0,-46
2234,0,0,139,0,-139
2235,0,0,114,0,-114
2236,0,0,56,0,-56
2237,0,0,54,0,-54
2238,1,0,4,0,-4
2239,1,1,655,2148,1493
2240,1,0,55,0,-55
2241,1,1,52,1226,1174
2242,1,0,171,0,-171
2243,1,0,23,0,-23
2244,1,0,84,0,-84
2245,1,1,799,1348,549
2246,1,1,162,1891,1729
2247,1,0,6,0,-6
2248,1,0,10,0,-10
2249,1,1,443,1206,763
2250,0,0,8,0,-8
2251,1,1,252,1462,1210
2252,0,0,97,0,-97
2253,0,0,94,0,-94
2254,1,0,75,0,-75
2255,1,0,56,0,-56
2256,0,0,2,0,-2
2257,0,0,144,0,-144
2258,1,1,175,2028,1853
2259,1,1,527,1430,903
2260,1,0,23,0,-23
2261,0,0,37,0,-37
2262,0,0,12,0,-12
2263,1,0,51,0,-51
2264,1,0,113,0,-113
2265,1,0,93,0,-93
2266,0,0,123,0,-123
2267,0,0,66,0,-66
2268,1,0,11,0,-11
2269,1,1,1425,1212,-213
2270,1,0,197,0,-197
2271,1,0,133,0,-133
2272,0,0,46,0,-46
2273,1,1,1943,1263,-680
2274,1,0,122,0,-122
2275,1,1,31,2020,1989
2276,1,1,1135,1537,402
2277,0,0,5,0,-5
2278,1,0,20,0,-20
2279,0,0,7,0,-7
2280,1,1,713,1209,496
2281,0,0,198,0,-198
2282,0,0,21,0,-21
2283,1,1,67,1482,1415
2284,0,0,64,0,-64
2285,1,0,37,0,-37
2286,1,1,170,1230,1060
2287,1,0,10,0,-10
2288,0,0,19,0,-19
2289,0,0,153,0,-153
2290,0,0,75,0,-75
2291,0,0,16,0,-16
2292,0,0,8,0,-8
2293,1,0,5,0,-5
2294,1,0,0,0,0
2295,0,0,145,0,-145
2296,1,1,1761,1881,120
2297,1,0,15,0,-15
2298,0,0,18,0,-18
2299,1,1,82,1491,1409
2300,0,0,30,0,-30
2301,1,1,2185,1438,-747
2302,0,0,87,0,-87
2303,0,0,53,0,-53
2304,1,0,1,0,-1
2305,1,1,303,1680,1377
2306,1,1,228,1928,1700
2307,1,1,971,1433,462
2308,0,0,13,0,-13
2309,0,0,113,0,-113
2310,1,1,984,2241,1257
2311,0,0,102,0,-102
2312,1,0,4,0,-4
2313,1,1,228,1291,1063
2314,1,0,149,0,-149
2315,1,0,124,0,-124
2316,1,0,22,0,-22
2317,1,1,313,1389,1076
2318,0,0,67,0,-67
2319,1,0,26,0,-26
2320,0,0,2,0,-2
2321,1,0,55,0,-55
2322,0,0,67,0,-67
2323,1,0,8,0,-8
2324,1,1,288,7179,6891
2325,1,1,224,1360,1136
2326,1,0,58,0,-58
2327,0,0,16,0,-16
2328,1,0,17,0,-17
2329,0,0,98,0,-98
2330,1,1,338,1353,1015
2331,1,1,1671,1361,-310
2332,0,0,68,0,-68
2333,0,0,12,0,-12
2334,0,0,46,0,-46
2335,1,0,72,0,-72
2336,1,1,667,1553,886
2337,0,0,25,0,-25
2338,1,0,148,0,-148
2339,1,0,2,0,-2
2340,1,1,33,1959,1926
2341,1,1,467,1400,933
2342,1,1,364,6169,5805
2343,1,0,36,0,-36
2344,0,0,10,0,-10
2345,0,0,4,0,-4
2346,1,1,196,1278,1082
2347,0,0,51,0,-51
2348,1,0,20,0,-20
2349,0,0,9,0,-9
2350,0,0,3,0,-3
2351,0,0,33,0,-33
2352,1,1,79,1620,1541
2353,1,0,39,0,-39
2354,1,0,31,0,-31
2355,1,0,47,0,-47
2356,1,1,1388,1334,-54
2357,1,0,54,0,-54
2358,0,0,32,0,-32
2359,0,0,141,0,-141
2360,0,0,17,0,-17
2361,1,0,10,0,-10
2362,1,1,210,1345,1135
2363,1,1,149,1271,1122
2364,0,0,19,0,-19
2365,1,1,310,1242,932
2366,1,1,434,1802,1368
2367,1,0,5,0,-5
2368,1,1,539,1247,708
2369,1,1,831,1935,1104
2370,0,0,20,0,-20
2371,0,0,30,0,-30
2372,1,0,53,0,-53
2373,1,0,38,0,-38
2374,1,1,830,1625,795
2375,0,0,2,0,-2
2376,1,1,164,1591,1427
2377,1,1,322,1967,1645
2378,1,0,139,0,-139
2379,0,0,190,0,-190
2380,1,1,146,1211,1065
2381,0,0,57,0,-57
2382,0,0,126,0,-126
2383,1,0,6,0,-6
2384,1,1,552,1275,723
2385,1,1,683,1337,654
2386,1,0,139,0,-139
2387,1,1,382,2065,1683
2388,1,0,62,0,-62
2389,1,0,121,0,-121
2390,0,0,9,0,-9
2391,1,0,10,0,-10
2392,0,0,5,0,-5
2393,1,0,112,0,-112
2394,1,0,131,0,-131
2395,1,1,222,1328,1106
2396,1,0,16,0,-16
2397,0,0,121,0,-121
2398,1,0,0,0,0
2399,1,0,16,0,-16
2400,0,0,9,0,-9
2401,1,1,356,2680,2324
2402,0,0,15,0,-15
2403,0,0,7,0,-7
2404,0,0,19,0,-19
2405,0,0,3,0,-3
2406,0,0,5,0,-5
2407,1,1,847,1304,457
2408,1,1,2181,1230,-951
2409,1,0,14,0,-14
2410,0,0,72,0,-72
2411,1,1,15,1469,1454
2412,0,0,61,0,-61
2413,0,0,42,0,-42
2414,1,1,1552,2155,603
2415,0,0,0,0,0
2416,0,0,4,0,-4
2417,1,1,100,1412,1312
2418,1,0,52,0,-52
2419,0,0,12,0,-12
2420,0,0,68,0,-68
2421,1,0,55,0,-55
2422,0,0,93,0,-93
2423,0,0,30,0,-30
2424,1,0,5,0,-5
2425,0,0,40,0,-40
2426,0,0,81,0,-81
2427,0,0,52,0,-52
2428,0,0,55,0,-55
2429,1,0,9,0,-9
2430,1,1,180,1964,1784
2431,0,0,115,0,-115
2432,1,0,115,0,-115
2433,1,1,624,1668,1044
2434,0,0,5,0,-5
2435,1,0,42,0,-42
2436,0,0,42,0,-42
2437,0,0,78,0,-78
2438,1,1,697,1660,963
2439,1,1,377,1945,1568
2440,0,0,15,0,-15
2441,1,1,1704,1229,-475
2442,0,0,216,0,-216
2443,0,0,7,0,-7
2444,0,0,6,0,-6
2445,0,0,6,0,-6
2446,1,1,149,1244,1095
2447,1,1,411,1773,1362
2448,0,0,52,0,-52
2449,1,1,557,1395,838
2450,1,0,8,0,-8
2451,0,0,114,0,-114
2452,1,0,21,0,-21
2453,0,0,55,0,-55
2454,1,1,258,1208,950
2455,1,0,7,0,-7
2456,0,0,7,0,-7
2457,0,0,10,0,-10
2458,0,0,68,0,-68
2459,1,0,13,0,-13
2460,0,0,6,0,-6
2461,1,0,16,0,-16
2462,1,1,786,2186,1400
2463,1,0,8,0,-8
2464,1,0,24,0,-24
2465,1,0,11,0,-11
2466,0,0,10,0,-10
2467,0,0,38,0,-38
2468,1,0,7,0,-7
2469,1,1,112,1257,1145
2470,0,0,39,0,-39
2471,1,1,732,1217,485
2472,1,0,78,0,-78
2473,1,0,19,0,-19
2474,1,0,117,0,-117
2475,0,0,56,0,-56
2476,0,0,3,0,-3
2477,1,1,725,1678,953
2478,1,1,108,1279,1171
2479,0,0,14,0,-14
2480,1,0,41,0,-41
2481,1,1,422,1227,805
2482,0,0,68,0,-68
2483,1,1,226,1241,1015
2484,1,0,73,0,-73
2485,0,0,47,0,-47
2486,1,1,862,1404,542
2487,1,1,526,1674,1148
2488,1,0,169,0,-169
2489,1,0,52,0,-52
2490,1,0,12,0,-12
2491,1,0,3,0,-3
2492,1,1,551,1566,1015
2493,0,0,53,0,-53
2494,0,0,76,0,-76
2495,0,0,51,0,-51
2496,1,1,558,1465,907
2497,0,0,41,0,-41
2498,1,0,6,0,-6
2499,1,0,104,0,-104
2500,1,0,10,0,-10
2501,0,0,30,0,-30
2502,0,0,83,0,-83
2503,0,0,48,0,-48
2504,0,0,25,0,-25
2505,1,1,496,1691,1195
2506,1,0,15,0,-15
2507,1,0,130,0,-130
2508,0,0,37,0,-37
2509,1,0,98,0,-98
2510,1,0,28,0,-28
2511,1,1,599,1580,981
2512,1,1,1252,1261,9
2513,0,0,4,0,-4
2514,1,1,513,1427,914
2515,0,0,115,0,-115
2516,0,0,42,0,-42
2517,0,0,139,0,-139
2518,0,0,37,0,-37
2519,1,0,85,0,-85
2520,1,1,808,1338,530
2521,0,0,8,0,-8
2522,1,0,22,0,-22
2523,0,0,74,0,-74
2524,1,0,18,0,-18
2525,0,0,94,0,-94
2526,0,0,90,0,-90
2527,1,1,304,2168,1864
2528,1,1,640,1264,624
2529,0,0,126,0,-126
2530,0,0,165,0,-165
2531,0,0,48,0,-48
2532,0,0,11,0,-11
2533,1,0,396,0,-396
2534,1,0,1,0,-1
2535,0,0,11,0,-11
2536,1,0,2,0,-2
2537,1,0,2,0,-2
2538,0,0,74,0,-74
2539,1,0,49,0,-49
2540,0,0,120,0,-120
2541,0,0,23,0,-23
2542,1,1,277,1876,1599
2543,1,1,501,1303,802
2544,0,0,7,0,-7
2545,0,0,27,0,-27
2546,1,0,0,0,0
2547,0,0,85,0,-85
2548,1,1,683,1273,590
2549,0,0,69,0,-69
2550,0,0,188,0,-188
2551,0,0,24,0,-24
2552,0,0,39,0,-39
2553,1,0,30,0,-30
2554,1,1,140,1316,1176
2555,0,0,0,0,0
2556,1,0,67,0,-67
2557,1,1,269,1588,1319
2558,1,1,689,1293,604
2559,0,0,199,0,-199
2560,1,0,219,0,-219
2561,0,0,0,0,0
2562,0,0,87,0,-87
2563,0,0,12,0,-12
2564,0,0,1,0,-1
2565,1,1,612,1291,679
2566,0,0,21,0,-21
2567,0,0,82,0,-82
2568,1,1,1418,1241,-177
2569,1,1,53,1451,1398
2570,1,1,1046,1219,173
2571,1,1,377,1519,1142
2572,0,0,6,0,-6
2573,0,0,77,0,-77
2574,1,1,158,1580,1422
2575,0,0,0,0,0
2576,0,0,140,0,-140
2577,1,1,292,1234,942
2578,1,1,217,1700,1483
2579,1,1,146,1397,1251
2580,1,1,495,1667,1172
2581,1,1,833,1613,780
2582,0,0,68,0,-68
2583,0,0,49,0,-49
2584,1,1,284,1549,1265
2585,1,1,150,1334,1184
2586,1,0,4,0,-4
2587,1,0,118,0,-118
2588,1,1,1056,2160,1104
2589,1,1,1876,1680,-196
2590,1,0,54,0,-54
2591,0,0,0,0,0
2592,1,0,12,0,-12
2593,1,0,78,0,-78
2594,0,0,7,0,-7
2595,0,0,12,0,-12
2596,1,1,101,1408,1307
2597,0,0,24,0,-24
2598,1,1,1270,1382,112
2599,0,0,25,0,-25
2600,1,1,342,1609,1267
2601,0,0,43,0,-43
2602,0,0,104,0,-104
2603,1,0,5,0,-5
2604,1,0,9,0,-9
2605,1,1,469,1288,819
2606,1,0,6,0,-6
2607,1,1,765,1590,825
2608,0,0,36,0,-36
2609,1,1,778,1268,490
2610,0,0,101,0,-101
2611,0,0,8,0,-8
2612,1,0,0,0,0
2613,1,1,1128,1306,178
2614,0,0,91,0,-91
2615,0,0,18,0,-18
2616,1,0,38,0,-38
2617,0,0,53,0,-53
2618,1,1,215,1713,1498
2619,0,0,75,0,-75
2620,1,1,150,1939,1789
2621,1,0,27,0,-27
2622,1,0,7,0,-7
2623,0,0,54,0,-54
2624,1,0,13,0,-13
2625,1,0,36,0,-36
2626,1,0,41,0,-41
2627,1,0,62,0,-62
2628,1,0,21,0,-21
2629,0,0,29,0,-29
2630,0,0,25,0,-25
2631,1,1,93,1577,1484
2632,1,1,375,1350,975
2633,0,0,58,0,-58
2634,0,0,105,0,-105
2635,1,0,32,0,-32
2636,1,0,9,0,-9
2637,1,1,257,1274,1017
2638,1,1,1313,3784,2471
2639,1,0,55,0,-55
2640,0,0,43,0,-43
2641,1,1,217,3011,2794
2642,1,1,303,1539,1236
2643,1,0,90,0,-90
2644,0,0,1,0,-1
2645,1,0,46,0,-46
2646,1,0,147,0,-147
2647,1,0,35,0,-35
2648,0,0,7,0,-7
2649,1,0,26,0,-26
2650,0,0,30,0,-30
2651,1,0,22,0,-22
2652,1,0,114,0,-114
2653,0,0,0,0,0
2654,1,1,927,2046,1119
2655,1,0,140,0,-140
2656,1,0,48,0,-48
2657,1,1,353,1372,1019
2658,1,1,2533,1277,-1256
2659,0,0,2,0,-2
2660,0,0,6,0,-6
2661,1,1,495,1336,841
2662,0,0,55,0,-55
2663,1,1,88,1245,1157
2664,0,0,10,0,-10
2665,0,0,43,0,-43
2666,0,0,16,0,-16
2667,1,0,33,0,-33
2668,0,0,1,0,-1
2669,1,1,263,1696,1433
2670,1,0,25,0,-25
2671,1,0,5,0,-5
2672,1,1,368,1577,1209
2673,1,0,46,0,-46
2674,1,0,22,0,-22
2675,1,1,619,1772,1153
2676,0,0,211,0,-211
2677,1,0,25,0,-25
2678,1,0,12,0,-12
2679,0,0,39,0,-39
2680,1,0,175,0,-175
2681,1,1,892,2342,1450
2682,1,0,52,0,-52
2683,1,1,1183,1329,146
2684,1,1,270,1332,1062
2685,0,0,28,0,-28
2686,0,0,36,0,-36
2687,1,1,154,1282,1128
2688,1,0,53,0,-53
2689,1,1,617,1697,1080
2690,0,0,45,0,-45
2691,1,1,875,1418,543
2692,0,0,9,0,-9
2693,1,0,142,0,-142
2694,1,0,64,0,-64
2695,1,1,836,1341,505
2696,0,0,40,0,-40
2697,0,0,47,0,-47
2698,1,1,451,1293,842
2699,1,0,5,0,-5
2700,0,0,157,0,-157
2701,0,0,47,0,-47
2702,1,1,192,1201,1009
2703,1,1,557,1602,1045
2704,0,0,35,0,-35
2705,1,1,541,1368,827
2706,0,0,1,0,-1
2707,1,0,56,0,-56
2708,1,1,228,1503,1275
2709,1,0,1,0,-1
2710,0,0,69,0,-69
2711,1,1,577,1447,870
2712,0,0,5,0,-5
2713,0,0,0,0,0
2714,1,0,126,0,-126
2715,1,0,69,0,-69
2716,0,0,103,0,-103
2717,0,0,97,0,-97
2718,1,1,919,1366,447
2719,1,1,191,1439,1248
2720,1,1,222,1855,1633
2721,1,1,812,1607,795
2722,1,0,2,0,-2
2723,1,0,34,0,-34
2724,0,0,13,0,-13
2725,0,0,4,0,-4
2726,0,0,25,0,-25
2727,1,0,83,0,-83
2728,0,0,45,0,-45
2729,0,0,15,0,-15
2730,1,1,933,2796,1863
2731,1,1,459,1219,760
2732,0,0,35,0,-35
2733,1,0,64,0,-64
2734,1,0,33,0,-33
2735,1,0,22,0,-22
2736,1,1,183,1407,1224
2737,1,1,767,1293,526
2738,0,0,89,0,-89
2739,0,0,49,0,-49
2740,1,1,107,2227,2120
2741,0,0,9,0,-9
2742,1,0,17,0,-17
2743,1,1,220,1872,1652
2744,0,0,94,0,-94
2745,1,1,314,1805,1491
2746,1,0,51,0,-51
2747,1,1,426,1200,774
2748,1,0,53,0,-53
2749,1,0,180,0,-180
2750,1,1,1496,1539,43
2751,1,1,1166,1284,118
2752,0,0,10,0,-10
2753,0,0,107,0,-107
2754,1,0,38,0,-38
2755,0,0,16,0,-16
2756,1,1,235,1394,1159
2757,1,1,333,2588,2255
2758,1,0,23,0,-23
2759,0,0,13,0,-13
2760,1,1,240,1239,999
2761,0,0,62,0,-62
2762,1,1,210,1237,1027
2763,0,0,20,0,-20
2764,0,0,114,0,-114
2765,1,1,236,1641,1405
2766,1,1,90,1218,1128
2767,1,0,47,0,-47
2768,1,1,140,1375,1235
2769,1,1,431,1234,803
2770,1,0,40,0,-40
2771,1,0,6,0,-6
2772,0,0,7,0,-7
2773,0,0,89,0,-89
2774,1,0,22,0,-22
2775,1,0,9,0,-9
2776,1,0,20,0,-20
2777,0,0,2,0,-2
2778,1,0,10,0,-10
2779,0,0,77,0,-77
2780,0,0,15,0,-15
2781,1,0,24,0,-24
2782,0,0,38,0,-38
2783,0,0,108,0,-108
2784,1,0,5,0,-5
2785,0,0,26,0,-26
2786,1,1,604,1392,788
2787,0,0,82,0,-82
2788,0,0,65,0,-65
2789,0,0,12,0,-12
2790,1,0,67,0,-67
2791,1,1,293,1219,926
2792,1,1,182,1326,1144
2793,1,0,4,0,-4
2794,0,0,135,0,-135
2795,1,0,75,0,-75
2796,1,0,61,0,-61
2797,0,0,105,0,-105
2798,1,1,1012,1834,822
2799,0,0,30,0,-30
2800,1,0,100,0,-100
2801,1,0,3,0,-3
2802,0,0,2,0,-2
2803,1,1,81,1234,1153
2804,0,0,15,0,-15
2805,0,0,1,0,-1
2806,0,0,5,0,-5
2807,1,1,472,1383,911
2808,0,0,38,0,-38
2809,0,0,130,0,-130
2810,1,1,136,1708,1572
2811,1,1,872,1487,615
2812,1,0,29,0,-29
2813,1,0,80,0,-80
2814,1,1,440,1243,803
2815,1,0,7,0,-7
2816,1,0,73,0,-73
2817,0,0,24,0,-24
2818,0,0,42,0,-42
2819,0,0,28,0,-28
2820,1,1,293,1333,1040
2821,1,1,143,3295,3152
2822,1,1,1620,1238,-382
2823,1,0,71,0,-71
2824,1,0,33,0,-33
2825,1,0,76,0,-76
2826,1,0,0,0,0
2827,1,0,85,0,-85
2828,1,0,67,0,-67
2829,0,0,54,0,-54
2830,1,0,7,0,-7
2831,0,0,11,0,-11
2832,1,1,493,1325,832
2833,1,1,533,1945,1412
2834,0,0,59,0,-59
2835,1,1,483,2157,1674
2836,1,0,12,0,-12
2837,1,0,88,0,-88
2838,1,1,192,1767,1575
2839,1,1,462,1816,1354
2840,0,0,97,0,-97
2841,1,0,73,0,-73
2842,1,0,13,0,-13
2843,0,0,21,0,-21
2844,0,0,16,0,-16
2845,1,1,293,1238,945
2846,0,0,3,0,-3
2847,0,0,2,0,-2
2848,0,0,57,0,-57
2849,1,0,126,0,-126
2850,0,0,51,0,-51
2851,0,0,24,0,-24
2852,1,0,36,0,-36
2853,1,1,22,1627,1605
2854,1,0,109,0,-109
2855,0,0,65,0,-65
2856,1,1,102,1356,1254
2857,0,0,31,0,-31
2858,0,0,204,0,-204
2859,1,1,382,1374,992
2860,1,1,1050,1709,659
2861,0,0,113,0,-113
2862,1,1,215,1405,1190
2863,0,0,29,0,-29
2864,0,0,80,0,-80
2865,1,1,644,1207,563
2866,1,1,65,1564,1499
2867,0,0,193,0,-193
2868,1,0,26,0,-26
2869,1,0,86,0,-86
2870,0,0,60,0,-60
2871,1,0,45,0,-45
2872,1,1,1038,1453,415
2873,1,1,236,1251,1015
2874,1,0,1,0,-1
2875,0,0,142,0,-142
2876,1,0,53,0,-53
2877,0,0,36,0,-36
2878,0,0,3,0,-3
2879,1,1,261,1396,1135
2880,0,0,82,0,-82
2881,1,0,111,0,-111
2882,1,0,79,0,-79
2883,0,0,130,0,-130
2884,1,1,737,1607,870
2885,0,0,44,0,-44
2886,1,1,226,1263,1037
2887,0,0,45,0,-45
2888,1,1,1026,2754,1728
2889,1,1,323,1264,941
2890,1,0,66,0,-66
2891,1,1,156,1382,1226
2892,1,1,223,1445,1222
2893,0,0,11,0,-11
2894,1,1,249,1348,1099
2895,1,1,702,2185,1483
2896,1,0,39,0,-39
2897,0,0,152,0,-152
2898,0,0,44,0,-44
2899,1,0,53,0,-53
2900,1,0,53,0,-53
2901,0,0,34,0,-34
2902,1,0,27,0,-27
2903,1,0,5,0,-5
2904,0,0,95,0,-95
2905,1,0,45,0,-45
2906,0,0,80,0,-80
2907,1,1,1056,1292,236
2908,1,1,766,1303,537
2909,0,0,61,0,-61
2910,1,1,369,2022,1653
2911,1,1,185,1413,1228
2912,1,0,44,0,-44
2913,1,1,302,1699,1397
2914,1,1,447,1663,1216
2915,0,0,117,0,-117
2916,0,0,18,0,-18
2917,1,0,44,0,-44
2918,1,1,99,1585,1486
2919,0,0,55,0,-55
2920,0,0,11,0,-11
2921,0,0,44,0,-44
2922,0,0,41,0,-41
2923,0,0,35,0,-35
2924,0,0,105,0,-105
2925,0,0,39,0,-39
2926,1,1,733,2470,1737
2927,1,0,54,0,-54
2928,0,0,31,0,-31
2929,1,0,45,0,-45
2930,1,1,630,1213,583
2931,0,0,3,0,-3
2932,1,1,190,1407,1217
2933,1,0,11,0,-11
2934,1,0,32,0,-32
2935,1,1,501,1436,935
2936,1,0,23,0,-23
2937,0,0,61,0,-61
2938,0,0,34,0,-34
2939,0,0,24,0,-24
2940,1,1,188,1338,1150
2941,1,1,344,2032,1688
2942,0,0,50,0,-50
2943,1,0,50,0,-50
2944,0,0,31,0,-31
2945,0,0,35,0,-35
2946,1,0,21,0,-21
2947,0,0,54,0,-54
2948,0,0,68,0,-68
2949,1,1,29,1400,1371
2950,1,0,76,0,-76
2951,1,0,0,0,0
2952,0,0,125,0,-125
2953,1,1,84,1418,1334
2954,1,0,16,0,-16
2955,0,0,47,0,-47
2956,1,1,1217,1339,122
2957,0,0,147,0,-147
2958,1,1,688,1389,701
2959,0,0,7,0,-7
2960,1,1,215,1290,1075
2961,1,1,611,1363,752
2962,0,0,19,0,-19
2963,0,0,3,0,-3
2964,1,0,1,0,-1
2965,1,0,104,0,-104
2966,0,0,80,0,-80
2967,1,1,778,1406,628
2968,0,0,125,0,-125
2969,1,1,464,1402,938
2970,0,0,11,0,-11
2971,0,0,17,0,-17
2972,1,0,146,0,-146
2973,1,1,234,1577,1343
2974,0,0,34,0,-34
2975,0,0,212,0,-212
2976,0,0,77,0,-77
2977,0,0,30,0,-30
2978,1,1,167,1866,1699
2979,1,0,90,0,-90
2980,0,0,41,0,-41
2981,0,0,95,0,-95
2982,0,0,21,0,-21
2983,1,0,59,0,-59
2984,0,0,67,0,-67
2985,0,0,63,0,-63
2986,0,0,110,0,-110
2987,1,1,825,2665,1840
2988,1,0,16,0,-16
2989,1,1,493,1323,830
2990,1,1,264,1387,1123
2991,1,1,120,1291,1171
2992,0,0,25,0,-25
2993,1,0,30,0,-30
2994,0,0,70,0,-70
2995,0,0,25,0,-25
2996,0,0,117,0,-117
2997,1,1,82,1522,1440
2998,1,0,28,0,-28
2999,1,1,179,1351,1172
3000,1,1,1040,1381,341
3001,0,0,31,0,-31
3002,1,1,605,1642,1037
3003,1,1,367,1820,1453
3004,0,0,121,0,-121
3005,0,0,36,0,-36
3006,1,1,3134,1208,-1926
3007,1,1,532,1892,1360
3008,0,0,30,0,-30
3009,1,0,9,0,-9
3010,1,1,339,1204,865
3011,1,0,27,0,-27
3012,0,0,66,0,-66
3013,0,0,126,0,-126
3014,1,1,1339,1848,509
3015,1,1,828,1308,480
3016,0,0,186,0,-186
3017,0,0,173,0,-173
3018,0,0,46,0,-46
3019,0,0,57,0,-57
3020,1,0,74,0,-74
3021,0,0,10,0,-10
3022,1,1,735,3051,2316
3023,1,1,690,1245,555
3024,1,1,381,1506,1125
3025,1,0,26,0,-26
3026,1,1,490,1211,721
3027,1,1,285,1225,940
3028,0,0,20,0,-20
3029,1,0,5,0,-5
3030,1,0,66,0,-66
3031,1,1,101,1468,1367
3032,0,0,46,0,-46
3033,1,1,807,1769,962
3034,1,0,44,0,-44
3035,0,0,34,0,-34
3036,1,1,182,1254,1072
3037,1,1,143,1320,1177
3038,1,0,71,0,-71
3039,0,0,34,0,-34
3040,0,0,8,0,-8
3041,1,1,563,1468,905
3042,0,0,21,0,-21
3043,1,1,430,1327,897
3044,0,0,59,0,-59
3045,0,0,39,0,-39
3046,1,1,526,1567,1041
3047,0,0,12,0,-12
3048,1,0,19,0,-19
3049,0,0,69,0,-69
3050,1,0,127,0,-127
3051,0,0,93,0,-93
3052,1,0,26,0,-26
3053,0,0,49,0,-49
3054,1,1,196,1574,1378
3055,0,0,16,0,-16
3056,0,0,33,0,-33
3057,0,0,15,0,-15
3058,0,0,158,0,-158
3059,1,0,8,0,-8
3060,1,0,7,0,-7
3061,0,0,22,0,-22
3062,0,0,150,0,-150
3063,1,1,162,1418,1256
3064,0,0,62,0,-62
3065,1,1,2165,1866,-299
3066,1,1,320,1328,1008
3067,0,0,39,0,-39
3068,1,1,719,1964,1245
3069,1,1,188,1392,1204
3070,1,1,569,1304,735
3071,1,0,33,0,-33
3072,1,1,378,1582,1204
3073,0,0,72,0,-72
3074,1,0,22,0,-22
3075,0,0,8,0,-8
3076,0,0,38,0,-38
3077,0,0,203,0,-203
3078,1,0,34,0,-34
3079,1,0,21,0,-21
3080,1,1,463,2040,1577
3081,1,0,8,0,-8
3082,1,0,9,0,-9
3083,0,0,61,0,-61
3084,1,1,1085,1307,222
3085,0,0,147,0,-147
3086,1,1,819,1843,1024
3087,1,1,132,1301,1169
3088,0,0,5,0,-5
3089,0,0,29,0,-29
3090,1,1,324,2034,1710
3091,1,1,424,2517,2093
3092,1,1,498,6784,6286
3093,1,1,1405,1674,269
3094,1,0,149,0,-149
3095,0,0,10,0,-10
3096,0,0,4,0,-4
3097,1,0,145,0,-145
3098,1,0,28,0,-28
3099,1,0,54,0,-54
3100,1,1,1029,1308,279
3101,1,0,68,0,-68
3102,0,0,60,0,-60
3103,0,0,47,0,-47
3104,0,0,1,0,-1
3105,0,0,69,0,-69
3106,1,0,69,0,-69
3107,0,0,37,0,-37
3108,1,0,131,0,-131
3109,0,0,11,0,-11
3110,1,0,9,0,-9
3111,0,0,12,0,-12
3112,0,0,0,0,0
3113,1,1,93,1549,1456
3114,1,1,572,8623,8051
3115,1,0,76,0,-76
3116,0,0,214,0,-214
3117,0,0,44,0,-44
3118,0,0,1,0,-1
3119,0,0,25,0,-25
3120,1,0,5,0,-5
3121,0,0,48,0,-48
3122,1,0,100,0,-100
3123,0,0,46,0,-46
3124,1,1,646,1422,776
3125,0,0,13,0,-13
3126,1,1,146,1619,1473
3127,0,0,201,0,-201
3128,1,0,17,0,-17
3129,1,1,181,1338,1157
3130,1,0,21,0,-21
3131,1,0,20,0,-20
3132,0,0,19,0,-19
3133,0,0,7,0,-7
3134,1,1,691,1308,617
3135,1,1,1316,1545,229
3136,1,1,17,1499,1482
3137,0,0,54,0,-54
3138,1,0,9,0,-9
3139,1,0,66,0,-66
3140,1,1,129,2336,2207
3141,1,1,291,1525,1234
3142,1,0,9,0,-9
3143,1,1,354,1411,1057
3144,1,1,949,1298,349
3145,1,1,41,1341,1300
3146,1,0,50,0,-50
3147,1,1,337,1542,1205
3148,0,0,27,0,-27
3149,1,1,153,2269,2116
3150,1,0,6,0,-6
3151,1,1,1402,1236,-166
3152,1,1,700,1686,986
3153,1,0,27,0,-27
3154,0,0,55,0,-55
3155,1,0,48,0,-48
3156,1,1,1458,2148,690
3157,1,1,163,1253,1090
3158,1,0,79,0,-79
3159,0,0,34,0,-34
3160,0,0,97,0,-97
3161,1,0,3,0,-3
3162,0,0,40,0,-40
3163,1,0,64,0,-64
3164,1,1,168,1448,1280
3165,1,0,98,0,-98
3166,0,0,23,0,-23
3167,0,0,3,0,-3
3168,0,0,27,0,-27
3169,1,1,398,1239,841
3170,0,0,142,0,-142
3171,0,0,54,0,-54
3172,1,1,905,1211,306
3173,1,1,724,2000,1276
3174,0,0,58,0,-58
3175,1,1,87,1409,1322
3176,1,1,340,1444,1104
3177,0,0,5,0,-5
3178,0,0,89,0,-89
3179,1,0,91,0,-91
3180,0,0,17,0,-17
3181,1,1,360,1356,996
3182,0,0,9,0,-9
3183,1,1,75,1810,1735
3184,1,0,112,0,-112
3185,1,1,1191,1209,18
3186,0,0,22,0,-22
3187,1,1,280,2463,2183
3188,1,1,1923,2019,96
3189,1,0,8,0,-8
3190,0,0,35,0,-35
3191,1,1,59,1296,1237
3192,0,0,86,0,-86
3193,0,0,37,0,-37
3194,1,1,2093,1393,-700
3195,1,1,213,1393,1180
3196,1,0,25,0,-25
3197,1,1,216,1235,1019
3198,0,0,49,0,-49
3199,1,0,34,0,-34
3200,0,0,25,0,-25
3201,1,1,570,1538,968
3202,0,0,36,0,-36
3203,1,0,79,0,-79
3204,0,0,4,0,-4
3205,1,0,133,0,-133
3206,1,1,249,1666,1417
3207,0,0,44,0,-44
3208,1,1,369,1456,1087
3209,1,0,33,0,-33
3210,1,0,121,0,-121
3211,1,0,27,0,-27
3212,1,0,71,0,-71
3213,1,0,28,0,-28
3214,0,0,21,0,-21
3215,1,1,140,3967,3827
3216,0,0,22,0,-22
3217,0,0,32,0,-32
3218,1,1,74,1481,1407
3219,1,0,79,0,-79
3220,1,0,150,0,-150
3221,1,0,23,0,-23
3222,1,1,2229,1452,-777
3223,1,0,33,0,-33
3224,0,0,44,0,-44
3225,0,0,17,0,-17
3226,1,0,207,0,-207
3227,0,0,0,0,0
3228,1,0,4,0,-4
3229,0,0,80,0,-80
3230,1,1,323,1391,1068
3231,1,1,318,1414,1096
3232,0,0,5,0,-5
3233,0,0,7,0,-7
3234,1,0,34,0,-34
3235,1,1,35,1490,1455
3236,0,0,27,0,-27
3237,0,0,19,0,-19
3238,0,0,80,0,-80
3239,1,0,19,0,-19
3240,0,0,11,0,-11
3241,1,1,157,1303,1146
3242,0,0,37,0,-37
3243,0,0,23,0,-23
3244,1,0,58,0,-58
3245,1,1,604,1235,631
3246,1,0,22,0,-22
3247,1,1,1150,1784,634
3248,0,0,17,0,-17
3249,1,1,1285,1377,92
3250,1,1,808,1435,627
3251,0,0,0,0,0
3252,1,0,19,0,-19
3253,1,0,32,0,-32
3254,0,0,72,0,-72
3255,0,0,5,0,-5
3256,0,0,73,0,-73
3257,1,0,52,0,-52
3258,0,0,9,0,-9
3259,1,1,167,1335,1168
3260,1,0,19,0,-19
3261,1,0,58,0,-58
3262,0,0,18,0,-18
3263,0,0,4,0,-4
3264,0,0,72,0,-72
3265,1,0,8,0,-8
3266,0,0,6,0,-6
3267,1,1,72,1231,1159
3268,0,0,50,0,-50
3269,0,0,89,0,-89
3270,1,0,8,0,-8
3271,1,0,14,0,-14
3272,1,1,754,1202,448
3273,0,0,22,0,-22
3274,1,1,233,1565,1332
3275,1,0,29,0,-29
3276,0,0,92,0,-92
3277,0,0,24,0,-24
3278,0,0,11,0,-11
3279,0,0,188,0,-188
3280,0,0,25,0,-25
3281,0,0,110,0,-110
3282,0,0,273,0,-273
3283,0,0,4,0,-4
3284,0,0,68,0,-68
3285,1,1,551,1849,1298
3286,1,0,305,0,-305
3287,1,0,69,0,-69
3288,0,0,13,0,-13
3289,1,0,19,0,-19
3290,0,0,103,0,-103
3291,0,0,44,0,-44
3292,1,0,73,0,-73
3293,1,0,110,0,-110
3294,0,0,183,0,-183
3295,1,1,180,1209,1029
3296,0,0,60,0,-60
3297,0,0,154,0,-154
3298,1,0,57,0,-57
3299,1,0,15,0,-15
3300,1,0,39,0,-39
3301,1,1,1393,1204,-189
3302,1,1,83,1462,1379
3303,1,1,421,1464,1043
3304,0,0,77,0,-77
3305,0,0,13,0,-13
3306,1,1,324,1578,1254
3307,1,1,98,1417,1319
3308,1,0,21,0,-21
3309,1,0,174,0,-174
3310,1,0,36,0,-36
3311,1,0,73,0,-73
3312,1,0,64,0,-64
3313,0,0,84,0,-84
3314,1,1,500,1200,700
3315,0,0,47,0,-47
3316,0,0,11,0,-11
3317,1,0,67,0,-67
3318,0,0,52,0,-52
3319,1,0,35,0,-35
3320,1,0,10,0,-10
3321,1,0,79,0,-79
3322,1,1,889,1272,383
3323,1,0,62,0,-62
3324,1,1,467,1262,795
3325,1,0,18,0,-18
3326,0,0,15,0,-15
3327,1,0,15,0,-15
3328,0,0,12,0,-12
3329,1,1,9,1266,1257
3330,1,1,799,1888,1089
3331,1,1,272,1288,1016
3332,0,0,3,0,-3
3333,1,0,76,0,-76
3334,1,0,156,0,-156
3335,1,1,92,1701,1609
3336,0,0,21,0,-21
3337,1,0,63,0,-63
3338,1,1,1118,1398,280
3339,0,0,4,0,-4
3340,1,1,275,1404,1129
3341,0,0,40,0,-40
3342,0,0,45,0,-45
3343,1,1,135,1232,1097
3344,1,1,329,1201,872
3345,0,0,42,0,-42
3346,0,0,19,0,-19
3347,1,0,60,0,-60
3348,0,0,35,0,-35
3349,0,0,3,0,-3
3350,0,0,27,0,-27
3351,0,0,33,0,-33
3352,0,0,32,0,-32
3353,1,1,745,1283,538
3354,0,0,10,0,-10
3355,1,1,371,2907,2536
3356,0,0,16,0,-16
3357,1,1,18,7453,7435
3358,1,0,37,0,-37
3359,1,1,384,1205,821
3360,0,0,22,0,-22
3361,1,1,411,1632,1221
3362,1,0,81,0,-81
3363,1,1,103,1897,1794
3364,0,0,54,0,-54
3365,0,0,58,0,-58
3366,0,0,111,0,-111
3367,0,0,38,0,-38
3368,1,0,145,0,-145
3369,1,1,697,1469,772
3370,0,0,14,0,-14
3371,1,1,878,1368,490
3372,1,1,834,1308,474
3373,0,0,62,0,-62
3374,0,0,3,0,-3
3375,1,0,24,0,-24
3376,0,0,43,0,-43
3377,1,0,46,0,-46
3378,1,1,733,1733,1000
3379,1,1,353,1261,908
3380,1,0,98,0,-98
3381,0,0,38,0,-38
3382,0,0,22,0,-22
3383,0,0,3,0,-3
3384,1,1,832,1376,544
3385,0,0,162,0,-162
3386,1,0,31,0,-31
3387,0,0,85,0,-85
3388,1,0,88,0,-88
3389,1,1,266,2390,2124
3390,0,0,99,0,-99
3391,0,0,38,0,-38
3392,1,1,58,1390,1332
3393,0,0,41,0,-41
3394,1,1,397,1648,1251
3395,1,0,23,0,-23
3396,1,1,497,1232,735
3397,1,1,280,1254,974
3398,1,1,48,1312,1264
3399,1,1,391,1235,844
3400,1,0,87,0,-87
3401,1,0,40,0,-40
3402,1,0,7,0,-7
3403,1,1,367,1209,842
3404,0,0,49,0,-49
3405,0,0,47,0,-47
3406,1,0,113,0,-113
3407,1,1,1532,1862,330
3408,0,0,31,0,-31
3409,1,1,469,2098,1629
3410,0,0,6,0,-6
3411,1,1,330,1322,992
3412,1,0,94,0,-94
3413,1,0,3,0,-3
3414,1,1,582,1357,775
3415,0,0,99,0,-99
3416,1,0,49,0,-49
3417,0,0,4,0,-4
3418,0,0,0,0,0
3419,1,1,595,1231,636
3420,0,0,52,0,-52
3421,0,0,61,0,-61
3422,1,0,63,0,-63
3423,1,0,22,0,-22
3424,1,0,179,0,-179
3425,1,0,112,0,-112
3426,1,1,690,2500,1810
3427,0,0,16,0,-16
3428,0,0,17,0,-17
3429,1,1,525,1539,1014
3430,0,0,52,0,-52
3431,0,0,42,0,-42
3432,0,0,36,0,-36
3433,0,0,12,0,-12
3434,0,0,37,0,-37
3435,1,1,189,1591,1402
3436,1,0,9,0,-9
3437,0,0,24,0,-24
3438,1,1,499,1598,1099
3439,0,0,25,0,-25
3440,1,1,1019,2221,1202
3441,1,0,16,0,-16
3442,0,0,8,0,-8
3443,1,1,379,1807,1428
3444,0,0,5,0,-5
3445,0,0,75,0,-75
3446,1,0,18,0,-18
3447,0,0,3,0,-3
3448,1,0,16,0,-16
3449,0,0,2,0,-2
3450,0,0,43,0,-43
3451,0,0,48,0,-48
3452,0,0,36,0,-36
3453,1,1,206,1323,1117
3454,0,0,52,0,-52
3455,1,0,66,0,-66
3456,1,1,5253,1342,-3911
3457,1,1,144,3010,2866
3458,1,0,12,0,-12
3459,1,1,292,1255,963
3460,1,0,125,0,-125
3461,1,0,63,0,-63
3462,0,0,18,0,-18
3463,0,0,25,0,-25
3464,1,0,3,0,-3
3465,1,1,1027,1468,441
3466,0,0,53,0,-53
3467,1,1,50,1412,1362
3468,0,0,135,0,-135
3469,1,0,51,0,-51
3470,1,0,80,0,-80
3471,0,0,2,0,-2
3472,0,0,111,0,-111
3473,1,0,28,0,-28
3474,0,0,23,0,-23
3475,1,1,15,1311,1296
3476,1,1,839,1284,445
3477,0,0,32,0,-32
3478,1,1,670,1208,538
3479,1,1,760,1813,1053
3480,1,0,10,0,-10
3481,1,1,283,1243,960
3482,0,0,64,0,-64
3483,1,1,54,1713,1659
3484,0,0,76,0,-76
3485,1,0,24,0,-24
3486,1,0,15,0,-15
3487,0,0,8,0,-8
3488,0,0,20,0,-20
3489,0,0,45,0,-45
3490,1,1,310,1448,1138
3491,1,1,30,1397,1367
3492,1,1,332,1445,1113
3493,1,1,527,1300,773
3494,1,1,807,1297,490
3495,1,0,141,0,-141
3496,1,0,47,0,-47
3497,1,1,574,1286,712
3498,1,0,34,0,-34
3499,0,0,28,0,-28
3500,1,1,1015,1317,302
3501,1,0,102,0,-102
3502,1,0,5,0,-5
3503,1,1,84,1572,1488
3504,1,0,42,0,-42
3505,1,0,7,0,-7
3506,1,0,44,0,-44
3507,0,0,6,0,-6
3508,1,0,24,0,-24
3509,1,1,521,2289,1768
3510,1,1,899,1315,416
3511,0,0,21,0,-21
3512,1,1,381,1826,1445
3513,1,0,9,0,-9
3514,1,1,644,1292,648
3515,0,0,57,0,-57
3516,1,0,5,0,-5
3517,1,1,580,2189,1609
3518,0,0,36,0,-36
3519,0,0,22,0,-22
3520,1,0,44,0,-44
3521,0,0,3,0,-3
3522,1,1,363,1414,1051
3523,1,0,27,0,-27
3524,0,0,24,0,-24
3525,1,1,580,1232,652
3526,0,0,9,0,-9
3527,1,0,33,0,-33
3528,0,0,70,0,-70
3529,1,1,307,1340,1033
3530,0,0,40,0,-40
3531,1,0,218,0,-218
3532,1,1,643,2072,1429
3533,1,0,111,0,-111
3534,1,1,282,4154,3872
3535,0,0,110,0,-110
3536,0,0,1,0,-1
3537,1,0,118,0,-118
3538,1,1,670,1715,1045
3539,0,0,0,0,0
3540,0,0,27,0,-27
3541,1,1,356,1304,948
3542,1,1,814,1252,438
3543,1,1,278,1325,1047
3544,1,0,81,0,-81
3545,1,1,373,1592,1219
3546,0,0,59,0,-59
3547,1,1,313,1574,1261
3548,0,0,37,0,-37
3549,1,0,21,0,-21
3550,1,0,96,0,-96
3551,1,0,55,0,-55
3552,1,0,65,0,-65
3553,0,0,36,0,-36
3554,1,1,801,1410,609
3555,1,0,87,0,-87
3556,1,0,22,0,-22
3557,0,0,106,0,-106
3558,0,0,0,0,0
3559,1,1,965,1276,311
3560,0,0,54,0,-54
3561,0,0,110,0,-110
3562,0,0,89,0,-89
3563,1,1,168,1299,1131
3564,0,0,62,0,-62
3565,1,0,29,0,-29
3566,0,0,28,0,-28
3567,1,1,2460,1836,-624
3568,1,1,263,1847,1584
3569,1,0,14,0,-14
3570,1,0,117,0,-117
3571,0,0,32,0,-32
3572,1,0,28,0,-28
3573,1,1,87,1362,1275
3574,0,0,20,0,-20
3575,0,0,4,0,-4
3576,0,0,29,0,-29
3577,1,0,71,0,-71
3578,1,1,256,1451,1195
3579,1,0,20,0,-20
3580,1,1,327,1357,1030
3581,0,0,9,0,-9
3582,1,1,618,1242,624
3583,1,1,229,3454,3225
3584,1,0,7,0,-7
3585,1,0,54,0,-54
3586,0,0,92,0,-92
3587,1,1,308,1356,1048
3588,0,0,27,0,-27
3589,1,1,603,1597,994
3590,1,0,2,0,-2
3591,1,0,214,0,-214
3592,1,0,61,0,-61
3593,1,1,200,1571,1371
3594,1,1,669,1213,544
3595,1,0,73,0,-73
3596,1,0,214,0,-214
3597,0,0,10,0,-10
3598,1,1,1290,1686,396
3599,0,0,102,0,-102
3600,0,0,123,0,-123
3601,1,1,181,1641,1460
3602,1,1,104,1375,1271
3603,1,0,3,0,-3
3604,0,0,60,0,-60
3605,1,1,35,1231,1196
3606,1,0,71,0,-71
3607,1,1,1446,1262,-184
3608,1,1,62,3094,3032
3609,0,0,26,0,-26
3610,0,0,136,0,-136
3611,0,0,143,0,-143
3612,1,1,469,1513,1044
3613,0,0,0,0,0
3614,1,0,69,0,-69
3615,0,0,27,0,-27
3616,1,1,444,1696,1252
3617,0,0,54,0,-54
3618,0,0,62,0,-62
3619,0,0,2,0,-2
3620,0,0,8,0,-8
3621,1,0,45,0,-45
3622,1,0,25,0,-25
3623,0,0,140,0,-140
3624,1,1,502,2235,1733
3625,1,1,212,1636,1424
3626,1,0,27,0,-27
3627,0,0,47,0,-47
3628,0,0,0,0,0
3629,1,1,363,1334,971
3630,1,1,453,1800,1347
3631,0,0,30,0,-30
3632,0,0,44,0,-44
3633,1,0,40,0,-40
3634,1,0,110,0,-110
3635,1,0,17,0,-17
3636,1,1,1108,1403,295
3637,1,1,617,1671,1054
3638,0,0,18,0,-18
3639,1,0,8,0,-8
3640,1,0,80,0,-80
3641,0,0,68,0,-68
3642,1,1,559,1239,680
3643,1,0,46,0,-46
3644,1,1,142,2200,2058
3645,0,0,7,0,-7
3646,1,1,158,1692,1534
3647,0,0,14,0,-14
3648,1,0,111,0,-111
3649,1,0,65,0,-65
3650,1,1,329,1714,1385
3651,1,1,584,1703,1119
3652,1,0,30,0,-30
3653,1,1,132,1511,1379
3654,0,0,42,0,-42
3655,0,0,64,0,-64
3656,1,1,122,1215,1093
3657,1,1,371,1731,1360
3658,1,1,224,1478,1254
3659,0,0,1,0,-1
3660,0,0,18,0,-18
3661,0,0,6,0,-6
3662,1,1,111,1719,1608
3663,1,0,4,0,-4
3664,1,0,14,0,-14
3665,1,0,149,0,-149
3666,1,1,93,1646,1553
3667,1,1,318,1479,1161
3668,1,0,118,0,-118
3669,0,0,56,0,-56
3670,1,1,147,1236,1089
3671,0,0,99,0,-99
3672,1,0,1,0,-1
3673,1,0,173,0,-173
3674,0,0,84,0,-84
3675,1,1,834,1429,595
3676,0,0,61,0,-61
3677,0,0,153,0,-153
3678,0,0,18,0,-18
3679,0,0,36,0,-36
3680,0,0,66,0,-66
3681,1,0,45,0,-45
3682,0,0,46,0,-46
3683,1,0,80,0,-80
3684,1,0,103,0,-103
3685,1,0,50,0,-50
3686,0,0,43,0,-43
3687,1,0,147,0,-147
3688,1,1,2165,1336,-829
3689,0,0,28,0,-28
3690,1,1,61,1785,1724
3691,1,1,924,1265,341
3692,0,0,92,0,-92
3693,0,0,6,0,-6
3694,1,1,239,1449,1210
3695,1,0,37,0,-37
3696,0,0,103,0,-103
3697,1,1,1573,1487,-86
3698,1,0,94,0,-94
3699,1,0,42,0,-42
3700,1,1,73,1492,1419
3701,0,0,49,0,-49
3702,0,0,36,0,-36
3703,1,0,14,0,-14
3704,0,0,59,0,-59
3705,1,0,42,0,-42
3706,1,1,260,2149,1889
3707,1,1,590,1286,696
3708,1,1,300,2834,2534
3709,1,0,16,0,-16
3710,1,1,718,1224,506
3711,1,1,675,1532,857
3712,1,0,1,0,-1
3713,1,0,32,0,-32
3714,0,0,26,0,-26
3715,0,0,71,0,-71
3716,1,1,38,1340,1302
3717,0,0,118,0,-118
3718,0,0,85,0,-85
3719,0,0,13,0,-13
3720,1,1,226,1638,1412
3721,1,1,191,1820,1629
3722,0,0,37,0,-37
3723,0,0,108,0,-108
3724,1,1,385,1336,951
3725,1,0,74,0,-74
3726,0,0,13,0,-13
3727,1,1,1279,2617,1338
3728,0,0,39,0,-39
3729,0,0,21,0,-21
3730,1,1,1055,1379,324
3731,1,1,54,1350,1296
3732,1,0,0,0,0
3733,1,0,51,0,-51
3734,1,1,750,2622,1872
3735,0,0,121,0,-121
3736,1,1,110,1265,1155
3737,0,0,12,0,-12
3738,1,1,231,1263,1032
3739,0,0,13,0,-13
3740,0,0,12,0,-12
3741,0,0,45,0,-45
3742,0,0,135,0,-135
3743,0,0,4,0,-4
3744,1,1,295,1262,967
3745,0,0,44,0,-44
3746,0,0,7,0,-7
3747,1,0,62,0,-62
3748,1,1,1657,1272,-385
3749,0,0,99,0,-99
3750,1,1,17,1630,1613
3751,1,1,355,1465,1110
3752,0,0,41,0,-41
3753,0,0,53,0,-53
3754,0,0,0,0,0
3755,1,1,117,1626,1509
3756,1,0,129,0,-129
3757,1,1,989,1226,237
3758,0,0,32,0,-32
3759,0,0,264,0,-264
3760,0,0,90,0,-90
3761,1,0,93,0,-93
3762,1,0,70,0,-70
3763,1,0,113,0,-113
3764,1,1,81,1348,1267
3765,1,0,96,0,-96
3766,0,0,83,0,-83
3767,1,0,136,0,-136
3768,0,0,90,0,-90
3769,0,0,34,0,-34
3770,1,1,289,1373,1084
3771,1,0,8,0,-8
3772,0,0,11,0,-11
3773,0,0,93,0,-93
3774,1,1,555,1624,1069
3775,1,0,4,0,-4
3776,1,0,3,0,-3
3777,1,1,695,1509,814
3778,1,0,59,0,-59
3779,0,0,9,0,-9
3780,0,0,8,0,-8
3781,1,0,111,0,-111
3782,1,0,57,0,-57
3783,0,0,118,0,-118
3784,0,0,5,0,-5
3785,1,1,447,1785,1338
3786,1,0,21,0,-21
3787,1,0,9,0,-9
3788,0,0,4,0,-4
3789,0,0,245,0,-245
3790,1,1,247,1591,1344
3791,1,1,288,2337,2049
3792,0,0,36,0,-36
3793,0,0,70,0,-70
3794,1,0,24,0,-24
3795,1,0,67,0,-67
3796,1,1,245,1293,1048
3797,1,1,503,2250,1747
3798,1,1,115,1453,1338
3799,0,0,26,0,-26
3800,1,0,28,0,-28
3801,1,0,7,0,-7
3802,1,0,59,0,-59
3803,1,0,67,0,-67
3804,1,0,98,0,-98
3805,0,0,3,0,-3
3806,1,1,1219,1411,192
3807,0,0,74,0,-74
3808,1,1,701,2354,1653
3809,0,0,150,0,-150
3810,0,0,97,0,-97
3811,1,1,342,1496,1154
3812,0,0,29,0,-29
3813,1,0,100,0,-100
3814,1,0,48,0,-48
3815,0,0,71,0,-71
3816,1,1,800,1459,659
3817,1,0,7,0,-7
3818,1,1,26,1657,1631
3819,1,1,425,1409,984
3820,1,1,831,1332,501
3821,0,0,5,0,-5
3822,0,0,26,0,-26
3823,1,0,16,0,-16
3824,1,0,17,0,-17
3825,1,0,70,0,-70
3826,1,1,1250,1331,81
3827,1,0,50,0,-50
3828,0,0,18,0,-18
3829,1,1,543,1289,746
3830,1,1,958,1506,548
3831,1,0,8,0,-8
3832,1,1,501,1259,758
3833,1,1,543,1751,1208
3834,0,0,6,0,-6
3835,0,0,18,0,-18
3836,1,1,1155,1446,291
3837,1,0,64,0,-64
3838,0,0,31,0,-31
3839,1,0,15,0,-15
3840,1,0,3,0,-3
3841,0,0,77,0,-77
3842,0,0,19,0,-19
3843,0,0,30,0,-30
3844,1,1,129,1677,1548
3845,0,0,25,0,-25
3846,1,0,12,0,-12
3847,1,0,81,0,-81
3848,1,1,584,2159,1575
3849,1,0,118,0,-118
3850,0,0,4,0,-4
3851,1,1,500,2648,2148
3852,1,0,78,0,-78
3853,0,0,34,0,-34
3854,1,1,110,1994,1884
3855,1,1,258,1269,1011
3856,0,0,13,0,-13
3857,0,0,70,0,-70
3858,1,0,64,0,-64
3859,1,1,564,1705,1141
3860,1,0,3,0,-3
3861,0,0,87,0,-87
3862,1,0,19,0,-19
3863,1,0,2,0,-2
3864,1,1,210,2132,1922
3865,0,0,53,0,-53
3866,0,0,150,0,-150
3867,0,0,197,0,-197
3868,1,1,403,1565,1162
3869,0,0,5,0,-5
3870,0,0,151,0,-151
3871,0,0,31,0,-31
3872,0,0,8,0,-8
3873,0,0,7,0,-7
3874,1,1,955,1616,661
3875,1,0,5,0,-5
3876,1,1,617,1411,794
3877,1,1,872,1561,689
3878,1,0,11,0,-11
3879,1,0,66,0,-66
3880,0,0,63,0,-63
3881,1,0,70,0,-70
3882,0,0,81,0,-81
3883,1,1,425,1815,1390
3884,0,0,8,0,-8
3885,1,1,793,2005,1212
3886,0,0,157,0,-157
3887,1,1,17,1747,1730
3888,1,1,1014,1482,468
3889,0,0,51,0,-51
3890,1,0,43,0,-43
3891,1,1,992,1656,664
3892,0,0,12,0,-12
3893,0,0,24,0,-24
3894,1,0,53,0,-53
3895,0,0,1,0,-1
3896,1,1,1442,1510,68
3897,1,0,7,0,-7
3898,0,0,48,0,-48
3899,0,0,232,0,-232
3900,1,1,273,1886,1613
3901,1,1,218,1762,1544
3902,1,0,65,0,-65
3903,1,0,34,0,-34
3904,1,0,115,0,-115
3905,1,1,84,3261,3177
3906,0,0,5,0,-5
3907,1,1,89,3509,3420
3908,0,0,29,0,-29
3909,0,0,80,0,-80
3910,0,0,12,0,-12
3911,0,0,173,0,-173
3912,0,0,73,0,-73
3913,1,0,233,0,-233
3914,1,1,117,1703,1586
3915,0,0,30,0,-30
3916,1,1,308,1517,1209
3917,0,0,120,0,-120
3918,1,0,57,0,-57
3919,1,0,11,0,-11
3920,0,0,5,0,-5
3921,0,0,0,0,0
3922,1,1,200,1323,1123
3923,0,0,34,0,-34
3924,1,1,267,2110,1843
3925,1,0,89,0,-89
3926,1,1,230,1281,1051
3927,1,1,428,1583,1155
3928,1,1,466,1441,975
3929,1,0,0,0,0
3930,0,0,14,0,-14
3931,1,1,827,1984,1157
3932,1,1,206,1552,1346
3933,0,0,216,0,-216
3934,0,0,28,0,-28
3935,0,0,6,0,-6
3936,1,1,1815,1352,-463
3937,1,1,239,1600,1361
3938,1,1,860,1488,628
3939,0,0,77,0,-77
3940,0,0,36,0,-36
3941,0,0,5,0,-5
3942,0,0,1,0,-1
3943,0,0,33,0,-33
3944,0,0,13,0,-13
3945,1,1,1406,1246,-160
3946,0,0,55,0,-55
3947,1,0,71,0,-71
3948,1,0,21,0,-21
3949,1,1,65,2075,2010
3950,1,0,15,0,-15
3951,0,0,55,0,-55
3952,1,0,7,0,-7
3953,1,1,624,1565,941
3954,1,1,266,1343,1077
3955,0,0,23,0,-23
3956,1,1,157,1266,1109
3957,1,1,151,7730,7579
3958,0,0,68,0,-68
3959,0,0,7,0,-7
3960,0,0,122,0,-122
3961,1,1,184,1660,1476
3962,1,1,268,1578,1310
3963,1,0,75,0,-75
3964,1,0,4,0,-4
3965,1,1,61,1545,1484
3966,1,1,194,1462,1268
3967,1,1,276,1281,1005
3968,1,0,14,0,-14
3969,0,0,60,0,-60
3970,1,1,302,1347,1045
3971,1,1,674,1270,596
3972,0,0,45,0,-45
3973,1,0,10,0,-10
3974,1,0,3,0,-3
3975,1,0,67,0,-67
3976,1,0,15,0,-15
3977,1,0,48,0,-48
3978,0,0,85,0,-85
3979,0,0,115,0,-115
3980,0,0,3,0,-3
3981,1,0,17,0,-17
3982,1,0,20,0,-20
3983,1,1,617,1977,1360
3984,1,0,10,0,-10
3985,0,0,17,0,-17
3986,0,0,25,0,-25
3987,0,0,110,0,-110
3988,1,1,371,1221,850
3989,1,0,4,0,-4
3990,1,1,400,1638,1238
3991,1,0,26,0,-26
3992,0,0,20,0,-20
3993,0,0,54,0,-54
3994,0,0,49,0,-49
3995,1,1,363,1280,917
3996,1,0,30,0,-30
3997,1,0,77,0,-77
3998,1,1,470,1607,1137
3999,1,0,41,0,-41
4000,0,0,83,0,-83
4001,1,0,27,0,-27
4002,1,1,118,1262,1144
4003,1,1,1085,1514,429
4004,0,0,1,0,-1
4005,0,0,19,0,-19
4006,1,1,157,2744,2587
4007,1,1,71,1299,1228
4008,1,1,247,1687,1440
4009,0,0,7,0,-7
4010,0,0,54,0,-54
4011,1,0,6,0,-6
4012,0,0,0,0,0
4013,0,0,262,0,-262
4014,0,0,9,0,-9
4015,1,0,102,0,-102
4016,1,1,124,1341,1217
4017,1,1,818,1239,421
4018,1,0,10,0,-10
4019,1,0,0,0,0
4020,0,0,9,0,-9
4021,1,1,227,2439,2212
4022,0,0,26,0,-26
4023,1,0,24,0,-24
4024,0,0,17,0,-17
4025,1,1,609,1481,872
4026,1,1,187,1201,1014
4027,1,1,541,1713,1172
4028,0,0,8,0,-8
4029,1,1,986,1209,223
4030,0,0,135,0,-135
4031,1,1,152,1248,1096
4032,1,1,961,1461,500
4033,0,0,17,0,-17
4034,1,0,19,0,-19
4035,1,1,248,1581,1333
4036,0,0,0,0,0
4037,1,0,94,0,-94
4038,1,1,1502,2041,539
4039,1,0,4,0,-4
4040,1,1,1876,1863,-13
4041,0,0,78,0,-78
4042,0,0,60,0,-60
4043,1,1,546,1517,971
4044,0,0,19,0,-19
4045,1,1,405,1289,884
4046,1,0,48,0,-48
4047,1,0,15,0,-15
4048,0,0,8,0,-8
4049,0,0,25,0,-25
4050,0,0,2,0,-2
4051,1,0,107,0,-107
4052,0,0,2,0,-2
4053,1,1,286,1277,991
4054,1,1,79,1407,1328
4055,0,0,181,0,-181
4056,0,0,109,0,-109
4057,0,0,8,0,-8
4058,0,0,42,0,-42
4059,1,0,1,0,-1
4060,1,1,318,1765,1447
4061,0,0,45,0,-45
4062,0,0,5,0,-5
4063,0,0,48,0,-48
4064,0,0,36,0,-36
4065,1,0,62,0,-62
4066,1,0,31,0,-31
4067,0,0,51,0,-51
4068,0,0,40,0,-40
4069,0,0,6,0,-6
4070,1,1,189,1380,1191
4071,0,0,7,0,-7
4072,1,1,40,1412,1372
4073,0,0,2,0,-2
4074,1,0,76,0,-76
4075,0,0,74,0,-74
4076,0,0,136,0,-136
4077,1,1,119,1393,1274
4078,0,0,122,0,-122
4079,0,0,48,0,-48
4080,0,0,74,0,-74
4081,0,0,63,0,-63
4082,1,0,28,0,-28
4083,1,1,501,2007,1506
4084,0,0,28,0,-28
4085,0,0,50,0,-50
4086,1,1,693,1430,737
4087,1,0,30,0,-30
4088,1,0,30,0,-30
4089,1,1,83,1469,1386
4090,1,0,85,0,-85
4091,0,0,10,0,-10
4092,1,0,150,0,-150
4093,1,0,78,0,-78
4094,0,0,0,0,0
4095,1,0,17,0,-17
4096,1,0,5,0,-5
4097,1,0,29,0,-29
4098,1,0,7,0,-7
4099,0,0,10,0,-10
4100,1,1,429,1216,787
4101,1,0,5,0,-5
4102,1,1,134,1445,1311
4103,0,0,37,0,-37
4104,1,0,43,0,-43
4105,1,0,52,0,-52
4106,0,0,10,0,-10
4107,0,0,23,0,-23
4108,1,0,71,0,-71
4109,1,0,28,0,-28
4110,0,0,35,0,-35
4111,1,1,441,1211,770
4112,1,0,2,0,-2
4113,0,0,6,0,-6
4114,1,1,709,3047,2338
4115,1,0,83,0,-83
4116,1,1,465,1204,739
4117,0,0,25,0,-25
4118,1,1,561,1316,755
4119,0,0,110,0,-110
4120,1,0,9,0,-9
4121,1,1,594,1695,1101
4122,0,0,20,0,-20
4123,1,1,27,1476,1449
4124,0,0,44,0,-44
4125,1,0,4,0,-4
4126,1,0,66,0,-66
4127,1,1,124,7585,7461
4128,1,0,18,0,-18
4129,1,1,1122,1420,298
4130,0,0,85,0,-85
4131,1,0,28,0,-28
4132,0,0,11,0,-11
4133,1,1,379,2697,2318
4134,0,0,29,0,-29
4135,1,1,164,1268,1104
4136,0,0,50,0,-50
4137,1,0,165,0,-165
4138,1,1,416,1844,1428
4139,1,1,311,1250,939
4140,1,1,53,1640,1587
4141,1,1,473,1448,975
4142,0,0,13,0,-13
4143,1,1,434,1564,1130
4144,1,1,1744,1935,191
4145,0,0,3,0,-3
4146,1,1,750,1414,664
4147,0,0,211,0,-211
4148,1,1,358,2072,1714
4149,1,0,48,0,-48
4150,1,0,18,0,-18
4151,0,0,3,0,-3
4152,0,0,33,0,-33
4153,0,0,7,0,-7
4154,1,1,1334,1836,502
4155,1,1,297,1829,1532
4156,1,0,27,0,-27
4157,0,0,110,0,-110
4158,0,0,171,0,-171
4159,1,1,375,1352,977
4160,1,0,150,0,-150
4161,1,1,143,2528,2385
4162,1,0,15,0,-15
4163,1,1,50,1536,1486
4164,1,0,5,0,-5
4165,1,1,748,1203,455
4166,0,0,53,0,-53
4167,1,0,29,0,-29
4168,1,0,23,0,-23
4169,1,0,61,0,-61
4170,1,1,245,1848,1603
4171,1,0,15,0,-15
4172,0,0,5,0,-5
4173,1,1,850,1395,545
4174,1,0,54,0,-54
4175,1,0,11,0,-11
4176,0,0,20,0,-20
4177,0,0,33,0,-33
4178,1,1,477,1916,1439
4179,0,0,16,0,-16
4180,0,0,14,0,-14
4181,0,0,191,0,-191
4182,0,0,60,0,-60
4183,1,1,280,1338,1058
4184,1,1,451,1586,1135
4185,1,0,46,0,-46
4186,1,0,106,0,-106
4187,1,0,105,0,-105
4188,1,1,1283,1428,145
4189,0,0,5,0,-5
4190,1,0,54,0,-54
4191,1,1,1480,2445,965
4192,1,0,37,0,-37
4193,0,0,2,0,-2
4194,1,1,238,1539,1301
4195,1,1,605,1387,782
4196,1,0,2,0,-2
4197,1,0,26,0,-26
4198,0,0,103,0,-103
4199,1,0,23,0,-23
4200,1,1,258,1243,985
4201,0,0,21,0,-21
4202,1,0,104,0,-104
4203,0,0,1,0,-1
4204,0,0,6,0,-6
4205,0,0,88,0,-88
4206,1,0,44,0,-44
4207,0,0,58,0,-58
4208,1,1,194,1477,1283
4209,1,1,122,1279,1157
4210,1,0,31,0,-31
4211,1,1,264,2731,2467
4212,0,0,112,0,-112
4213,0,0,1,0,-1
4214,1,1,1259,2351,1092
4215,1,1,1988,1322,-666
4216,1,1,662,1418,756
4217,0,0,37,0,-37
4218,0,0,59,0,-59
4219,0,0,25,0,-25
4220,1,1,132,1214,1082
4221,1,0,30,0,-30
4222,0,0,19,0,-19
4223,1,1,176,2355,2179
4224,1,1,615,1424,809
4225,1,0,110,0,-110
4226,1,0,149,0,-149
4227,1,0,173,0,-173
4228,1,1,810,2031,1221
4229,0,0,202,0,-202
4230,1,1,293,1274,981
4231,1,1,328,1391,1063
4232,1,0,88,0,-88
4233,0,0,20,0,-20
4234,1,0,12,0,-12
4235,1,1,455,1711,1256
4236,0,0,55,0,-55
4237,1,0,55,0,-55
4238,1,0,1,0,-1
4239,1,0,92,0,-92
4240,1,1,542,1899,1357
4241,0,0,78,0,-78
4242,1,1,469,1454,985
4243,0,0,111,0,-111
4244,1,0,1,0,-1
4245,1,0,133,0,-133
4246,0,0,40,0,-40
4247,1,0,61,0,-61
4248,0,0,26,0,-26
4249,0,0,17,0,-17
4250,0,0,134,0,-134
4251,0,0,76,0,-76
4252,1,0,60,0,-60
4253,0,0,17,0,-17
4254,1,1,235,1467,1232
4255,1,1,268,1268,1000
4256,0,0,42,0,-42
4257,1,1,471,1307,836
4258,1,1,255,1670,1415
4259,1,1,1704,1701,-3
4260,0,0,30,0,-30
4261,1,0,38,0,-38
4262,1,1,519,1669,1150
4263,0,0,15,0,-15
4264,0,0,3,0,-3
4265,0,0,21,0,-21
4266,0,0,65,0,-65
4267,1,0,92,0,-92
4268,0,0,4,0,-4
4269,0,0,3,0,-3
4270,1,0,45,0,-45
4271,0,0,33,0,-33
4272,1,1,352,1204,852
4273,1,0,57,0,-57
4274,0,0,45,0,-45
4275,1,1,427,1876,1449
4276,1,0,208,0,-208
4277,0,0,20,0,-20
4278,0,0,8,0,-8
4279,0,0,50,0,-50
4280,0,0,89,0,-89
4281,1,0,72,0,-72
4282,0,0,31,0,-31
4283,1,0,2,0,-2
4284,0,0,1,0,-1
4285,1,0,39,0,-39
4286,0,0,16,0,-16
4287,0,0,9,0,-9
4288,0,0,43,0,-43
4289,0,0,10,0,-10
4290,0,0,132,0,-132
4291,0,0,71,0,-71
4292,1,1,1210,1267,57
4293,0,0,2,0,-2
4294,1,0,15,0,-15
4295,0,0,119,0,-119
4296,1,1,581,1336,755
4297,1,1,193,1498,1305
4298,0,0,19,0,-19
4299,1,0,125,0,-125
4300,1,0,58,0,-58
4301,0,0,19,0,-19
4302,1,0,94,0,-94
4303,0,0,13,0,-13
4304,1,1,98,1482,1384
4305,1,0,66,0,-66
4306,0,0,15,0,-15
4307,1,0,34,0,-34
4308,1,1,418,1971,1553
4309,1,1,354,3476,3122
4310,1,1,361,1721,1360
4311,1,1,177,3287,3110
4312,0,0,259,0,-259
4313,1,1,3405,1423,-1982
4314,1,1,402,1503,1101
4315,0,0,11,0,-11
4316,0,0,67,0,-67
4317,1,0,8,0,-8
4318,1,1,41,1282,1241
4319,1,0,25,0,-25
4320,1,0,23,0,-23
4321,1,0,102,0,-102
4322,0,0,0,0,0
4323,1,1,350,1466,1116
4324,1,0,96,0,-96
4325,1,1,2185,1207,-978
4326,0,0,12,0,-12
4327,1,1,209,1253,1044
4328,1,1,314,1283,969
4329,0,0,66,0,-66
4330,0,0,204,0,-204
4331,0,0,0,0,0
4332,1,0,84,0,-84
4333,0,0,14,0,-14
4334,0,0,58,0,-58
4335,1,1,530,1205,675
4336,1,1,426,1373,947
4337,0,0,61,0,-61
4338,1,1,279,2190,1911
4339,1,1,366,1253,887
4340,1,1,184,1241,1057
4341,1,0,40,0,-40
4342,0,0,15,0,-15
4343,0,0,37,0,-37
4344,0,0,18,0,-18
4345,0,0,27,0,-27
4346,1,1,523,1889,1366
4347,1,0,67,0,-67
4348,1,0,49,0,-49
4349,1,1,884,1418,534
4350,1,1,73,1209,1136
4351,0,0,20,0,-20
4352,1,0,121,0,-121
4353,0,0,31,0,-31
4354,0,0,28,0,-28
4355,1,1,45,3102,3057
4356,1,0,9,0,-9
4357,1,1,2688,1431,-1257
4358,1,1,272,1230,958
4359,0,0,188,0,-188
4360,0,0,74,0,-74
4361,0,0,47,0,-47
4362,0,0,53,0,-53
4363,1,1,1272,1351,79
4364,1,0,19,0,-19
4365,0,0,202,0,-202
4366,1,0,38,0,-38
4367,1,0,57,0,-57
4368,1,1,20,1227,1207
4369,0,0,186,0,-186
4370,1,0,75,0,-75
4371,0,0,13,0,-13
4372,1,1,1169,1980,811
4373,1,0,17,0,-17
4374,0,0,87,0,-87
4375,1,0,40,0,-40
4376,1,1,1472,1315,-157
4377,0,0,51,0,-51
4378,0,0,21,0,-21
4379,1,0,7,0,-7
4380,0,0,131,0,-131
4381,1,0,19,0,-19
4382,0,0,44,0,-44
4383,1,1,741,1201,460
4384,0,0,26,0,-26
4385,0,0,25,0,-25
4386,0,0,9,0,-9
4387,1,0,36,0,-36
4388,1,1,674,2665,1991
4389,0,0,39,0,-39
4390,0,0,52,0,-52
4391,1,0,48,0,-48
4392,1,0,42,0,-42
4393,1,1,525,1233,708
4394,1,0,18,0,-18
4395,0,0,219,0,-219
4396,0,0,134,0,-134
4397,0,0,238,0,-238
4398,1,0,129,0,-129
4399,0,0,51,0,-51
4400,0,0,4,0,-4
4401,1,0,45,0,-45
4402,0,0,66,0,-66
4403,1,1,494,3485,2991
4404,1,1,231,1283,1052
4405,1,0,46,0,-46
4406,1,0,65,0,-65
4407,0,0,18,0,-18
4408,0,0,9,0,-9
4409,0,0,5,0,-5
4410,0,0,35,0,-35
4411,1,0,33,0,-33
4412,0,0,74,0,-74
4413,0,0,52,0,-52
4414,1,0,8,0,-8
4415,1,1,121,1731,1610
4416,0,0,111,0,-111
4417,0,0,21,0,-21
4418,1,1,119,1435,1316
4419,1,0,29,0,-29
4420,1,1,237,1249,1012
4421,1,1,46,1281,1235
4422,0,0,23,0,-23
4423,0,0,104,0,-104
4424,1,1,678,1403,725
4425,1,1,714,1407,693
4426,1,1,203,1216,1013
4427,0,0,0,0,0
4428,1,1,1175,2698,1523
4429,0,0,179,0,-179
4430,1,1,580,1251,671
4431,0,0,15,0,-15
4432,1,0,11,0,-11
4433,0,0,41,0,-41
4434,1,0,70,0,-70
4435,1,1,74,1257,1183
4436,0,0,57,0,-57
4437,1,0,64,0,-64
4438,1,0,13,0,-13
4439,1,0,199,0,-199
4440,1,1,1105,1566,461
4441,1,0,62,0,-62
4442,1,0,2,0,-2
4443,1,1,518,1401,883
4444,1,0,0,0,0
4445,1,1,228,2259,2031
4446,1,0,81,0,-81
4447,0,0,14,0,-14
4448,1,0,48,0,-48
4449,1,1,173,1604,1431
4450,1,0,67,0,-67
4451,1,1,579,3598,3019
4452,1,0,23,0,-23
4453,1,0,55,0,-55
4454,1,1,642,1497,855
4455,1,0,84,0,-84
4456,0,0,35,0,-35
4457,0,0,61,0,-61
4458,1,0,20,0,-20
4459,0,0,31,0,-31
4460,0,0,11,0,-11
4461,0,0,21,0,-21
4462,0,0,4,0,-4
4463,1,1,406,1280,874
4464,1,0,15,0,-15
4465,0,0,127,0,-127
4466,1,1,68,1518,1450
4467,1,0,22,0,-22
4468,1,1,790,1646,856
4469,1,0,42,0,-42
4470,0,0,16,0,-16
4471,0,0,23,0,-23
4472,0,0,24,0,-24
4473,1,1,241,1930,1689
4474,1,1,1043,1295,252
4475,0,0,22,0,-22
4476,1,0,61,0,-61
4477,0,0,16,0,-16
4478,1,1,1340,1200,-140
4479,0,0,38,0,-38
4480,0,0,89,0,-89
4481,1,1,803,1407,604
4482,1,1,36,1313,1277
4483,0,0,15,0,-15
4484,1,0,21,0,-21
4485,1,0,78,0,-78
4486,1,0,17,0,-17
4487,0,0,9,0,-9
4488,1,0,98,0,-98
4489,0,0,54,0,-54
4490,1,0,39,0,-39
4491,1,0,56,0,-56
4492,1,0,55,0,-55
4493,0,0,9,0,-9
4494,1,0,5,0,-5
4495,0,0,24,0,-24
4496,0,0,8,0,-8
4497,1,0,71,0,-71
4498,1,1,139,1445,1306
4499,0,0,47,0,-47
4500,1,0,25,0,-25
4501,0,0,3,0,-3
4502,1,1,1542,1447,-95
4503,1,1,199,1549,1350
4504,1,0,177,0,-177
4505,1,1,135,1244,1109
4506,1,1,966,1494,528
4507,0,0,175,0,-175
4508,1,0,4,0,-4
4509,0,0,125,0,-125
4510,1,0,72,0,-72
4511,1,1,23,1259,1236
4512,1,0,80,0,-80
4513,1,1,545,1211,666
4514,0,0,10,0,-10
4515,0,0,12,0,-12
4516,1,0,21,0,-21
4517,1,1,413,1511,1098
4518,1,1,337,1733,1396
4519,0,0,91,0,-91
4520,1,1,235,1957,1722
4521,0,0,136,0,-136
4522,1,0,48,0,-48
4523,1,1,997,1563,566
4524,1,1,1100,2269,1169
4525,0,0,125,0,-125
4526,1,0,11,0,-11
4527,1,0,17,0,-17
4528,1,1,766,1363,597
4529,1,1,928,2127,1199
4530,1,0,58,0,-58
4531,0,0,96,0,-96
4532,1,1,791,3383,2592
4533,1,0,76,0,-76
4534,0,0,43,0,-43
4535,1,1,383,1201,818
4536,0,0,37,0,-37
4537,0,0,52,0,-52
4538,1,1,968,1670,702
4539,1,0,103,0,-103
4540,0,0,174,0,-174
4541,1,1,1240,1291,51
4542,0,0,40,0,-40
4543,0,0,71,0,-71
4544,1,0,18,0,-18
4545,0,0,49,0,-49
4546,1,0,23,0,-23
4547,1,0,3,0,-3
4548,0,0,11,0,-11
4549,1,1,1224,1634,410
4550,1,1,643,1415,772
4551,1,0,26,0,-26
4552,1,1,300,1314,1014
4553,1,1,88,1573,1485
4554,1,1,518,1218,700
4555,1,0,223,0,-223
4556,1,1,335,1859,1524
4557,0,0,30,0,-30
4558,0,0,15,0,-15
4559,1,0,65,0,-65
4560,1,1,158,1213,1055
4561,0,0,41,0,-41
4562,0,0,0,0,0
4563,1,1,627,1214,587
4564,1,0,91,0,-91
4565,1,1,1109,1218,109
4566,0,0,24,0,-24
4567,1,0,212,0,-212
4568,1,0,40,0,-40
4569,1,0,6,0,-6
4570,1,0,22,0,-22
4571,1,1,2031,2087,56
4572,1,0,6,0,-6
4573,0,0,110,0,-110
4574,1,0,43,0,-43
4575,1,0,75,0,-75
4576,0,0,16,0,-16
4577,1,0,3,0,-3
4578,1,0,30,0,-30
4579,1,1,677,1243,566
4580,0,0,7,0,-7
4581,0,0,67,0,-67
4582,1,1,516,1342,826
4583,1,0,78,0,-78
4584,0,0,14,0,-14
4585,1,1,1815,1205,-610
4586,1,1,1098,1412,314
4587,1,0,58,0,-58
4588,1,0,29,0,-29
4589,1,1,414,1476,1062
4590,0,0,23,0,-23
4591,1,0,93,0,-93
4592,0,0,28,0,-28
4593,0,0,23,0,-23
4594,1,1,793,1211,418
4595,1,1,1153,5939,4786
4596,0,0,24,0,-24
4597,1,1,798,1566,768
4598,0,0,34,0,-34
4599,0,0,188,0,-188
4600,1,1,163,1266,1103
4601,0,0,96,0,-96
4602,0,0,12,0,-12
4603,0,0,16,0,-16
4604,0,0,35,0,-35
4605,0,0,8,0,-8
4606,0,0,25,0,-25
4607,1,1,165,1322,1157
4608,1,0,1,0,-1
4609,1,0,34,0,-34
4610,1,0,15,0,-15
4611,0,0,131,0,-131
4612,1,0,110,0,-110
4613,0,0,3,0,-3
4614,0,0,136,0,-136
4615,1,1,50,1485,1435
4616,1,0,167,0,-167
4617,0,0,16,0,-16
4618,1,0,160,0,-160
4619,0,0,34,0,-34
4620,1,1,1382,1580,198
4621,1,0,58,0,-58
4622,1,1,829,1434,605
4623,0,0,41,0,-41
4624,0,0,40,0,-40
4625,1,0,27,0,-27
4626,0,0,13,0,-13
4627,1,0,11,0,-11
4628,1,1,459,1377,918
4629,0,0,110,0,-110
4630,1,0,14,0,-14
4631,1,1,419,1553,1134
4632,0,0,23,0,-23
4633,0,0,35,0,-35
4634,1,0,75,0,-75
4635,1,1,1671,1264,-407
4636,0,0,16,0,-16
4637,1,0,13,0,-13
4638,1,1,811,1294,483
4639,0,0,1,0,-1
4640,0,0,54,0,-54
4641,0,0,60,0,-60
4642,0,0,42,0,-42
4643,1,1,245,1518,1273
4644,1,0,11,0,-11
4645,0,0,78,0,-78
4646,0,0,173,0,-173
4647,1,0,3,0,-3
4648,0,0,21,0,-21
4649,1,1,234,1576,1342
4650,0,0,184,0,-184
4651,1,0,66,0,-66
4652,0,0,62,0,-62
4653,1,0,0,0,0
4654,1,1,253,1256,1003
4655,0,0,17,0,-17
4656,0,0,117,0,-117
4657,1,0,14,0,-14
4658,1,0,17,0,-17
4659,1,1,104,1264,1160
4660,0,0,41,0,-41
4661,1,1,106,1846,1740
4662,1,1,974,1321,347
4663,1,1,815,1480,665
4664,1,1,40,1365,1325
4665,0,0,141,0,-141
4666,0,0,16,0,-16
4667,1,1,286,1261,975
4668,0,0,84,0,-84
4669,1,1,367,1526,1159
4670,1,0,92,0,-92
4671,1,1,486,1434,948
4672,0,0,17,0,-17
4673,1,1,130,1436,1306
4674,1,1,207,1452,1245
4675,0,0,184,0,-184
4676,1,1,874,1220,346
4677,0,0,42,0,-42
4678,0,0,39,0,-39
4679,1,0,91,0,-91
4680,1,1,192,1600,1408
4681,0,0,22,0,-22
4682,1,1,389,1275,886
4683,1,1,1024,1407,383
4684,0,0,26,0,-26
4685,1,0,23,0,-23
4686,1,0,10,0,-10
4687,0,0,24,0,-24
4688,0,0,15,0,-15
4689,1,0,79,0,-79
4690,1,0,26,0,-26
4691,1,0,37,0,-37
4692,1,0,15,0,-15
4693,0,0,40,0,-40
4694,1,0,34,0,-34
4695,0,0,16,0,-16
4696,1,1,681,1425,744
4697,1,0,107,0,-107
4698,0,0,67,0,-67
4699,1,1,221,1213,992
4700,1,1,458,1643,1185
4701,0,0,21,0,-21
4702,1,1,212,1306,1094
4703,0,0,82,0,-82
4704,1,0,51,0,-51
4705,0,0,8,0,-8
4706,0,0,1,0,-1
4707,1,0,3,0,-3
4708,1,1,1168,1300,132
4709,1,0,47,0,-47
4710,1,1,549,1375,826
4711,1,0,6,0,-6
4712,0,0,1,0,-1
4713,1,0,186,0,-186
4714,0,0,1,0,-1
4715,0,0,10,0,-10
4716,1,1,434,1308,874
4717,1,1,1194,1533,339
4718,1,1,234,1601,1367
4719,1,0,10,0,-10
4720,0,0,73,0,-73
4721,1,0,51,0,-51
4722,1,1,356,2226,1870
4723,0,0,58,0,-58
4724,0,0,93,0,-93
4725,1,1,1942,1319,-623
4726,1,1,251,5159,4908
4727,0,0,140,0,-140
4728,0,0,1,0,-1
4729,0,0,67,0,-67
4730,0,0,7,0,-7
4731,0,0,36,0,-36
4732,1,0,9,0,-9
4733,1,0,2,0,-2
4734,1,0,34,0,-34
4735,1,1,165,1280,1115
4736,0,0,117,0,-117
4737,1,0,16,0,-16
4738,1,1,895,3457,2562
4739,0,0,15,0,-15
4740,0,0,59,0,-59
4741,0,0,48,0,-48
4742,0,0,22,0,-22
4743,1,1,383,1213,830
4744,1,0,9,0,-9
4745,1,1,107,1904,1797
4746,0,0,69,0,-69
4747,1,0,31,0,-31
4748,0,0,95,0,-95
4749,1,0,132,0,-132
4750,0,0,0,0,0
4751,1,1,1091,1331,240
4752,1,1,1262,1437,175
4753,0,0,15,0,-15
4754,1,1,16,1215,1199
4755,0,0,87,0,-87
4756,0,0,5,0,-5
4757,0,0,38,0,-38
4758,1,1,356,1310,954
4759,1,1,68,1651,1583
4760,1,0,8,0,-8
4761,1,0,9,0,-9
4762,1,1,544,1433,889
4763,1,0,35,0,-35
4764,1,0,28,0,-28
4765,0,0,147,0,-147
4766,1,1,1099,2278,1179
4767,1,0,45,0,-45
4768,0,0,56,0,-56
4769,0,0,62,0,-62
4770,1,1,892,1461,569
4771,1,1,1477,1344,-133
4772,1,1,501,1272,771
4773,1,1,96,1344,1248
4774,1,0,15,0,-15
4775,1,0,5,0,-5
4776,1,0,78,0,-78
4777,0,0,27,0,-27
4778,1,0,55,0,-55
4779,0,0,38,0,-38
4780,0,0,3,0,-3
4781,1,0,115,0,-115
4782,1,0,18,0,-18
4783,0,0,38,0,-38
4784,1,1,44,1480,1436
4785,1,0,15,0,-15
4786,1,0,4,0,-4
4787,1,1,253,1432,1179
4788,1,1,377,1266,889
4789,1,0,47,0,-47
4790,0,0,29,0,-29
4791,1,0,98,0,-98
4792,1,0,13,0,-13
4793,0,0,57,0,-57
4794,1,0,101,0,-101
4795,0,0,9,0,-9
4796,0,0,56,0,-56
4797,1,0,38,0,-38
4798,0,0,18,0,-18
4799,1,1,754,1230,476
4800,1,0,6,0,-6
4801,1,0,80,0,-80
4802,1,0,85,0,-85
4803,1,1,221,1218,997
4804,1,0,0,0,0
4805,1,0,20,0,-20
4806,1,0,35,0,-35
4807,0,0,21,0,-21
4808,0,0,31,0,-31
4809,1,1,490,1290,800
4810,1,0,6,0,-6
4811,1,0,29,0,-29
4812,0,0,27,0,-27
4813,0,0,6,0,-6
4814,0,0,4,0,-4
4815,1,1,677,1918,1241
4816,1,0,50,0,-50
4817,1,0,25,0,-25
4818,0,0,13,0,-13
4819,1,1,335,1337,1002
4820,1,0,68,0,-68
4821,1,0,38,0,-38
4822,1,0,14,0,-14
4823,1,0,1,0,-1
4824,1,1,1293,1364,71
4825,0,0,5,0,-5
4826,0,0,6,0,-6
4827,0,0,137,0,-137
4828,0,0,6,0,-6
4829,0,0,99,0,-99
4830,0,0,147,0,-147
4831,1,0,63,0,-63
4832,1,0,6,0,-6
4833,0,0,9,0,-9
4834,1,1,864,1800,936
4835,1,1,419,1338,919
4836,1,0,66,0,-66
4837,1,1,178,1467,1289
4838,1,1,147,1382,1235
4839,0,0,2,0,-2
4840,1,0,14,0,-14
4841,1,0,1,0,-1
4842,0,0,39,0,-39
4843,0,0,18,0,-18
4844,1,1,56,1626,1570
4845,0,0,80,0,-80
4846,1,0,66,0,-66
4847,0,0,10,0,-10
4848,1,0,50,0,-50
4849,0,0,24,0,-24
4850,0,0,207,0,-207
4851,1,1,294,1241,947
4852,1,1,422,1790,1368
4853,1,0,62,0,-62
4854,0,0,64,0,-64
4855,1,0,13,0,-13
4856,1,1,2673,1494,-1179
4857,1,1,467,2077,1610
4858,1,0,269,0,-269
4859,0,0,18,0,-18
4860,0,0,116,0,-116
4861,1,1,796,1553,757
4862,0,0,35,0,-35
4863,0,0,7,0,-7
4864,1,1,874,1379,505
4865,1,0,70,0,-70
4866,0,0,31,0,-31
4867,0,0,67,0,-67
4868,0,0,44,0,-44
4869,1,1,321,1643,1322
4870,0,0,17,0,-17
4871,0,0,91,0,-91
4872,0,0,69,0,-69
4873,1,0,85,0,-85
4874,0,0,20,0,-20
4875,1,0,115,0,-115
4876,1,1,240,1903,1663
4877,1,1,103,1234,1131
4878,1,1,15,1400,1385
4879,1,0,30,0,-30
4880,1,1,1054,1951,897
4881,0,0,3,0,-3
4882,0,0,7,0,-7
4883,1,0,89,0,-89
4884,0,0,83,0,-83
4885,0,0,6,0,-6
4886,1,0,36,0,-36
4887,1,1,403,1326,923
4888,1,0,96,0,-96
4889,1,0,7,0,-7
4890,1,1,286,1455,1169
4891,1,1,240,1283,1043
4892,0,0,74,0,-74
4893,1,0,9,0,-9
4894,1,1,251,1628,1377
4895,1,1,445,2640,2195
4896,1,0,1,0,-1
4897,1,1,315,2980,2665
4898,1,0,21,0,-21
4899,0,0,4,0,-4
4900,0,0,6,0,-6
4901,0,0,78,0,-78
4902,0,0,17,0,-17
4903,1,1,455,1392,937
4904,0,0,11,0,-11
4905,0,0,42,0,-42
4906,0,0,32,0,-32
4907,1,0,6,0,-6
4908,1,0,58,0,-58
4909,1,0,39,0,-39
4910,0,0,1,0,-1
4911,1,0,3,0,-3
4912,1,1,699,1248,549
4913,0,0,114,0,-114
4914,1,0,1,0,-1
4915,1,1,351,1561,1210
4916,1,0,1,0,-1
4917,1,1,47,2015,1968
4918,1,0,21,0,-21
4919,1,1,273,1681,1408
4920,0,0,59,0,-59
4921,1,0,45,0,-45
4922,1,1,390,1422,1032
4923,1,0,3,0,-3
4924,0,0,6,0,-6
4925,0,0,8,0,-8
4926,1,0,21,0,-21
4927,0,0,109,0,-109
4928,0,0,26,0,-26
4929,1,0,41,0,-41
4930,0,0,42,0,-42
4931,1,1,924,1492,568
4932,1,0,13,0,-13
4933,1,1,1555,2013,458
4934,1,0,24,0,-24
4935,1,0,34,0,-34
4936,1,0,41,0,-41
4937,0,0,22,0,-22
4938,0,0,18,0,-18
4939,1,0,6,0,-6
4940,0,0,92,0,-92
4941,0,0,114,0,-114
4942,0,0,21,0,-21
4943,0,0,80,0,-80
4944,1,1,237,1470,1233
4945,1,0,43,0,-43
4946,1,1,210,2389,2179
4947,1,1,283,1485,1202
4948,0,0,19,0,-19
4949,1,0,22,0,-22
4950,0,0,27,0,-27
4951,1,1,519,1233,714
4952,1,0,157,0,-157
4953,0,0,72,0,-72
4954,0,0,9,0,-9
4955,0,0,10,0,-10
4956,0,0,18,0,-18
4957,1,1,143,1212,1069
4958,0,0,4,0,-4
4959,1,1,214,1232,1018
4960,0,0,90,0,-90
4961,1,0,25,0,-25
4962,1,1,572,2268,1696
4963,0,0,16,0,-16
4964,0,0,102,0,-102
4965,1,0,42,0,-42
4966,1,0,32,0,-32
4967,0,0,22,0,-22
4968,0,0,41,0,-41
4969,1,0,1,0,-1
4970,1,1,1159,1558,399
4971,1,1,1020,2484,1464
4972,1,1,159,1526,1367
4973,0,0,8,0,-8
4974,0,0,42,0,-42
4975,1,0,47,0,-47
4976,1,1,256,2574,2318
4977,1,0,8,0,-8
4978,1,1,368,1895,1527
4979,0,0,7,0,-7
4980,1,1,429,1361,932
4981,0,0,36,0,-36
4982,1,1,1301,1568,267
4983,1,1,1525,1263,-262
4984,1,0,27,0,-27
4985,0,0,3,0,-3
4986,1,1,352,1846,1494
4987,0,0,102,0,-102
4988,1,1,395,1212,817
4989,1,0,78,0,-78
4990,1,0,78,0,-78
4991,1,0,10,0,-10
4992,0,0,21,0,-21
4993,0,0,8,0,-8
4994,1,1,535,1722,1187
4995,0,0,7,0,-7
4996,0,0,77,0,-77
4997,1,0,2,0,-2
4998,1,1,1572,1279,-293
4999,1,0,116,0,-116
5000,1,1,291,1259,968
5001,1,0,72,0,-72
5002,0,0,47,0,-47
5003,0,0,80,0,-80
5004,1,1,551,1424,873
5005,1,0,8,0,-8
5006,1,1,1178,1294,116
5007,0,0,106,0,-106
5008,1,0,22,0,-22
5009,1,1,789,2555,1766
5010,0,0,13,0,-13
5011,1,1,3127,1492,-1635
5012,0,0,41,0,-41
5013,1,0,33,0,-33
5014,1,1,153,1434,1281
5015,0,0,33,0,-33
5016,0,0,3,0,-3
5017,1,1,654,1266,612
5018,0,0,32,0,-32
5019,1,0,39,0,-39
5020,0,0,7,0,-7
5021,0,0,4,0,-4
5022,0,0,68,0,-68
5023,0,0,17,0,-17
5024,1,1,438,1383,945
5025,0,0,2,0,-2
5026,0,0,80,0,-80
5027,1,1,240,1530,1290
5028,1,1,595,1749,1154
5029,1,1,288,1317,1029
5030,1,1,149,1479,1330
5031,0,0,4,0,-4
5032,1,0,72,0,-72
5033,1,1,118,1625,1507
5034,1,1,1483,1512,29
5035,1,0,213,0,-213
5036,0,0,43,0,-43
5037,0,0,16,0,-16
5038,1,1,734,1682,948
5039,0,0,28,0,-28
5040,1,1,1707,1237,-470
5041,1,1,405,1644,1239
5042,0,0,1,0,-1
5043,1,1,1686,1427,-259
5044,0,0,1,0,-1
5045,1,1,308,1494,1186
5046,1,1,277,1286,1009
5047,1,0,43,0,-43
5048,1,1,1633,4485,2852
5049,1,0,2,0,-2
5050,0,0,78,0,-78
5051,0,0,78,0,-78
5052,0,0,84,0,-84
5053,0,0,12,0,-12
5054,1,1,555,1355,800
5055,1,1,1304,2008,704
5056,0,0,86,0,-86
5057,1,1,450,1399,949
5058,1,1,60,1269,1209
5059,0,0,24,0,-24
5060,0,0,63,0,-63
5061,1,1,564,1558,994
5062,0,0,126,0,-126
5063,1,1,1497,1511,14
5064,0,0,80,0,-80
5065,1,1,264,1325,1061
5066,1,1,298,2496,2198
5067,1,1,21,1257,1236
5068,1,0,21,0,-21
5069,1,0,39,0,-39
5070,1,0,75,0,-75
5071,0,0,6,0,-6
5072,1,0,16,0,-16
5073,1,1,551,1339,788
5074,0,0,112,0,-112
5075,1,0,59,0,-59
5076,1,1,638,2234,1596
5077,0,0,55,0,-55
5078,1,1,674,1343,669
5079,1,0,68,0,-68
5080,1,0,11,0,-11
5081,1,1,293,1223,930
5082,1,0,83,0,-83
5083,1,0,87,0,-87
5084,1,1,176,1707,1531
5085,1,1,350,1259,909
5086,0,0,93,0,-93
5087,0,0,41,0,-41
5088,1,0,35,0,-35
5089,0,0,31,0,-31
5090,0,0,151,0,-151
5091,1,0,149,0,-149
5092,1,1,241,1825,1584
5093,1,1,352,2047,1695
5094,0,0,31,0,-31
5095,0,0,36,0,-36
5096,1,0,14,0,-14
5097,1,0,92,0,-92
5098,1,0,18,0,-18
5099,0,0,5,0,-5
5100,0,0,109,0,-109
5101,1,0,28,0,-28
5102,1,0,50,0,-50
5103,1,1,959,4104,3145
5104,1,0,21,0,-21
5105,0,0,39,0,-39
5106,1,0,50,0,-50
5107,1,1,146,1373,1227
5108,0,0,58,0,-58
5109,0,0,48,0,-48
5110,0,0,48,0,-48
5111,1,0,122,0,-122
5112,1,1,439,1564,1125
5113,1,1,145,1774,1629
5114,1,0,1,0,-1
5115,1,1,44,1590,1546
5116,1,1,132,1836,1704
5117,1,1,1091,1330,239
5118,0,0,5,0,-5
5119,1,0,57,0,-57
5120,0,0,9,0,-9
5121,0,0,3,0,-3
5122,1,0,58,0,-58
5123,1,1,283,1333,1050
5124,1,1,1252,1526,274
5125,0,0,7,0,-7
5126,1,1,392,1429,1037
5127,0,0,190,0,-190
5128,1,0,18,0,-18
5129,0,0,45,0,-45
5130,0,0,20,0,-20
5131,1,1,702,1477,775
5132,0,0,3,0,-3
5133,1,0,23,0,-23
5134,0,0,5,0,-5
5135,0,0,36,0,-36
5136,1,0,29,0,-29
5137,0,0,36,0,-36
5138,1,0,52,0,-52
5139,1,0,2,0,-2
5140,0,0,19,0,-19
5141,0,0,15,0,-15
5142,0,0,8,0,-8
5143,1,1,57,5728,5671
5144,1,1,612,1329,717
5145,1,1,506,1473,967
5146,1,1,650,1446,796
5147,1,1,955,1736,781
5148,1,1,1462,1245,-217
5149,1,1,200,1350,1150
5150,1,1,34,1299,1265
5151,1,0,117,0,-117
5152,0,0,92,0,-92
5153,0,0,0,0,0
5154,0,0,33,0,-33
5155,1,0,33,0,-33
5156,0,0,60,0,-60
5157,1,1,116,1297,1181
5158,0,0,35,0,-35
5159,0,0,56,0,-56
5160,1,0,0,0,0
5161,0,0,15,0,-15
5162,0,0,43,0,-43
5163,1,0,241,0,-241
5164,1,1,341,1458,1117
5165,1,1,458,2298,1840
5166,1,0,61,0,-61
5167,1,0,19,0,-19
5168,1,1,115,4441,4326
5169,1,0,56,0,-56
5170,0,0,47,0,-47
5171,0,0,13,0,-13
5172,1,1,1458,1224,-234
5173,1,0,9,0,-9
5174,0,0,25,0,-25
5175,1,1,1404,1368,-36
5176,0,0,9,0,-9
5177,1,1,658,1462,804
5178,1,1,652,1564,912
5179,1,1,1355,1246,-109
5180,0,0,4,0,-4
5181,1,0,17,0,-17
5182,1,0,35,0,-35
5183,1,1,56,1515,1459
5184,1,1,144,1942,1798
5185,1,1,33,1226,1193
5186,0,0,61,0,-61
5187,0,0,98,0,-98
5188,0,0,39,0,-39
5189,0,0,53,0,-53
5190,0,0,0,0,0
5191,1,1,482,1209,727
5192,1,1,938,1219,281
5193,0,0,16,0,-16
5194,0,0,12,0,-12
5195,1,0,9,0,-9
5196,1,1,941,1255,314
5197,1,0,31,0,-31
5198,0,0,48,0,-48
5199,1,1,568,1228,660
5200,1,0,10,0,-10
5201,0,0,70,0,-70
5202,1,1,224,1209,985
5203,0,0,16,0,-16
5204,1,1,944,1287,343
5205,1,0,36,0,-36
5206,0,0,32,0,-32
5207,1,1,495,1232,737
5208,0,0,73,0,-73
5209,1,1,1818,1236,-582
5210,1,1,275,1470,1195
5211,1,0,16,0,-16
5212,0,0,24,0,-24
5213,1,0,41,0,-41
5214,0,0,1,0,-1
5215,1,0,62,0,-62
5216,1,1,417,1407,990
5217,0,0,12,0,-12
5218,1,1,1299,1703,404
5219,1,0,50,0,-50
5220,1,1,309,1587,1278
5221,1,0,15,0,-15
5222,1,1,77,1796,1719
5223,1,0,61,0,-61
5224,1,0,31,0,-31
5225,1,0,65,0,-65
5226,0,0,141,0,-141
5227,1,1,53,1409,1356
5228,1,1,472,1374,902
5229,1,0,9,0,-9
5230,1,1,816,2123,1307
5231,0,0,88,0,-88
5232,0,0,202,0,-202
5233,0,0,23,0,-23
5234,1,0,52,0,-52
5235,1,1,619,1331,712
5236,1,0,1,0,-1
5237,1,0,58,0,-58
5238,1,0,49,0,-49
5239,1,0,17,0,-17
5240,1,0,4,0,-4
5241,1,0,19,0,-19
5242,0,0,29,0,-29
5243,1,0,146,0,-146
5244,1,0,21,0,-21
5245,1,0,0,0,0
5246,0,0,14,0,-14
5247,1,1,281,1225,944
5248,1,0,31,0,-31
5249,1,1,267,1279,1012
5250,1,1,151,1529,1378
5251,0,0,74,0,-74
5252,1,1,99,1319,1220
5253,1,0,18,0,-18
5254,0,0,198,0,-198
5255,0,0,0,0,0
5256,0,0,59,0,-59
5257,0,0,58,0,-58
5258,1,0,80,0,-80
5259,1,0,10,0,-10
5260,0,0,18,0,-18
5261,0,0,33,0,-33
5262,1,1,286,2599,2313
5263,1,0,90,0,-90
5264,1,0,45,0,-45
5265,0,0,42,0,-42
5266,0,0,25,0,-25
5267,1,1,118,2062,1944
5268,1,1,160,1767,1607
5269,1,1,277,3336,3059
5270,1,1,473,1224,751
5271,0,0,0,0,0
5272,0,0,41,0,-41
5273,1,0,13,0,-13
5274,1,1,360,2106,1746
5275,0,0,36,0,-36
5276,1,1,2184,1332,-852
5277,1,1,241,1311,1070
5278,1,0,82,0,-82
5279,1,1,692,1896,1204
5280,1,1,356,1679,1323
5281,0,0,4,0,-4
5282,1,0,65,0,-65
5283,1,1,155,1228,1073
5284,0,0,29,0,-29
5285,1,1,1178,1209,31
5286,1,1,839,1234,395
5287,1,0,7,0,-7
5288,1,1,809,1536,727
5289,1,0,0,0,0
5290,0,0,37,0,-37
5291,1,1,87,1364,1277
5292,1,0,47,0,-47
5293,1,0,5,0,-5
5294,1,1,148,1295,1147
5295,1,0,62,0,-62
5296,1,0,6,0,-6
5297,1,0,39,0,-39
5298,0,0,31,0,-31
5299,0,0,39,0,-39
5300,0,0,117,0,-117
5301,0,0,79,0,-79
5302,1,0,2,0,-2
5303,1,0,51,0,-51
5304,0,0,29,0,-29
5305,1,0,64,0,-64
5306,1,0,38,0,-38
5307,1,1,285,1201,916
5308,1,1,458,1353,895
5309,0,0,53,0,-53
5310,1,0,20,0,-20
5311,1,0,30,0,-30
5312,0,0,211,0,-211
5313,0,0,92,0,-92
5314,0,0,23,0,-23
5315,0,0,18,0,-18
5316,0,0,2,0,-2
5317,0,0,6,0,-6
5318,1,0,12,0,-12
5319,0,0,24,0,-24
5320,1,1,135,1317,1182
5321,1,0,71,0,-71
5322,0,0,71,0,-71
5323,0,0,15,0,-15
5324,0,0,66,0,-66
5325,1,1,2039,1264,-775
5326,0,0,26,0,-26
5327,0,0,35,0,-35
5328,1,1,340,3078,2738
5329,1,1,67,12724,12657
5330,0,0,1,0,-1
5331,0,0,50,0,-50
5332,0,0,18,0,-18
5333,1,1,68,1311,1243
5334,1,1,576,2102,1526
5335,1,1,241,1584,1343
5336,1,0,38,0,-38
5337,1,0,4,0,-4
5338,1,0,22,0,-22
5339,0,0,15,0,-15
5340,0,0,110,0,-110
5341,0,0,83,0,-83
5342,0,0,14,0,-14
5343,1,0,5,0,-5
5344,1,1,418,1544,1126
5345,0,0,1,0,-1
5346,1,0,135,0,-135
5347,0,0,96,0,-96
5348,0,0,28,0,-28
5349,0,0,47,0,-47
5350,0,0,45,0,-45
5351,1,0,56,0,-56
5352,1,0,4,0,-4
5353,1,1,818,6075,5257
5354,0,0,125,0,-125
5355,0,0,32,0,-32
5356,0,0,15,0,-15
5357,1,1,178,1414,1236
5358,1,1,64,3430,3366
5359,0,0,91,0,-91
5360,1,1,425,1723,1298
5361,0,0,25,0,-25
5362,1,0,80,0,-80
5363,1,1,949,5266,4317
5364,0,0,63,0,-63
5365,1,0,95,0,-95
5366,1,0,54,0,-54
5367,0,0,28,0,-28
5368,0,0,26,0,-26
5369,1,0,91,0,-91
5370,1,0,1,0,-1
5371,0,0,69,0,-69
5372,1,1,377,1249,872
5373,1,0,28,0,-28
5374,0,0,33,0,-33
5375,1,0,3,0,-3
5376,0,0,119,0,-119
5377,1,0,97,0,-97
5378,0,0,12,0,-12
5379,1,0,55,0,-55
5380,0,0,32,0,-32
5381,0,0,80,0,-80
5382,1,0,71,0,-71
5383,1,1,321,1341,1020
5384,1,1,312,1373,1061
5385,1,0,3,0,-3
5386,0,0,157,0,-157
5387,1,0,1,0,-1
5388,0,0,130,0,-130
5389,1,1,200,1766,1566
5390,0,0,62,0,-62
5391,1,0,6,0,-6
5392,1,1,78,1309,1231
5393,0,0,8,0,-8
5394,1,0,20,0,-20
5395,1,0,127,0,-127
5396,0,0,4,0,-4
5397,0,0,1,0,-1
5398,1,1,425,1515,1090
5399,0,0,1,0,-1
5400,0,0,151,0,-151
5401,1,1,1757,1215,-542
5402,0,0,86,0,-86
5403,0,0,36,0,-36
5404,1,0,22,0,-22
5405,0,0,27,0,-27
5406,1,1,212,1426,1214
5407,1,1,185,1406,1221
5408,0,0,62,0,-62
5409,1,0,66,0,-66
5410,0,0,100,0,-100
5411,1,1,237,1299,1062
5412,0,0,1,0,-1
5413,1,1,279,1202,923
5414,0,0,229,0,-229
5415,1,0,26,0,-26
5416,1,0,84,0,-84
5417,1,1,394,1253,859
5418,0,0,12,0,-12
5419,1,0,177,0,-177
5420,0,0,32,0,-32
5421,1,0,7,0,-7
5422,1,1,174,1365,1191
5423,0,0,68,0,-68
5424,1,0,33,0,-33
5425,1,0,53,0,-53
5426,1,0,102,0,-102
5427,0,0,32,0,-32
5428,0,0,18,0,-18
5429,1,0,52,0,-52
5430,1,1,620,2553,1933
5431,1,0,93,0,-93
5432,1,0,4,0,-4
5433,1,0,36,0,-36
5434,0,0,76,0,-76
5435,1,0,35,0,-35
5436,1,0,56,0,-56
5437,1,0,46,0,-46
5438,1,1,375,1368,993
5439,1,1,136,1617,1481
5440,1,0,298,0,-298
5441,0,0,7,0,-7
5442,1,1,236,1815,1579
5443,1,0,141,0,-141
5444,1,0,57,0,-57
5445,0,0,59,0,-59
5446,0,0,51,0,-51
5447,0,0,28,0,-28
5448,0,0,1,0,-1
5449,1,0,154,0,-154
5450,1,1,259,2020,1761
5451,0,0,13,0,-13
5452,0,0,152,0,-152
5453,1,0,21,0,-21
5454,0,0,63,0,-63
5455,1,0,83,0,-83
5456,1,0,98,0,-98
5457,0,0,126,0,-126
5458,1,1,193,1453,1260
5459,0,0,24,0,-24
5460,0,0,47,0,-47
5461,1,1,120,1347,1227
5462,1,1,915,2313,1398
5463,1,0,2,0,-2
5464,1,0,60,0,-60
5465,1,1,520,1522,1002
5466,1,1,1040,1457,417
5467,0,0,84,0,-84
5468,0,0,98,0,-98
5469,0,0,54,0,-54
5470,0,0,15,0,-15
5471,0,0,13,0,-13
5472,1,1,171,1371,1200
5473,1,1,235,1201,966
5474,1,1,520,1251,731
5475,1,0,36,0,-36
5476,1,0,8,0,-8
5477,0,0,46,0,-46
5478,1,0,8,0,-8
5479,0,0,51,0,-51
5480,0,0,99,0,-99
5481,0,0,132,0,-132
5482,1,0,21,0,-21
5483,1,1,1289,1471,182
5484,0,0,3,0,-3
5485,0,0,172,0,-172
5486,0,0,123,0,-123
5487,1,1,84,1727,1643
5488,0,0,79,0,-79
5489,0,0,31,0,-31
5490,0,0,72,0,-72
5491,1,0,6,0,-6
5492,1,1,481,1600,1119
5493,0,0,6,0,-6
5494,0,0,2,0,-2
5495,1,1,255,1304,1049
5496,0,0,128,0,-128
5497,0,0,13,0,-13
5498,1,0,5,0,-5
5499,0,0,111,0,-111
5500,1,1,1322,1243,-79
5501,1,0,113,0,-113
5502,0,0,15,0,-15
5503,0,0,20,0,-20
5504,0,0,15,0,-15
5505,1,0,16,0,-16
5506,0,0,23,0,-23
5507,0,0,4,0,-4
5508,1,0,45,0,-45
5509,1,1,216,2125,1909
5510,1,0,230,0,-230
5511,1,0,33,0,-33
5512,1,0,3,0,-3
5513,0,0,134,0,-134
5514,0,0,11,0,-11
5515,0,0,52,0,-52
5516,1,0,61,0,-61
5517,1,0,50,0,-50
5518,0,0,34,0,-34
5519,1,0,21,0,-21
5520,1,1,450,2712,2262
5521,1,0,7,0,-7
5522,1,1,892,1621,729
5523,1,1,1070,1240,170
5524,1,0,3,0,-3
5525,0,0,66,0,-66
5526,1,1,659,1712,1053
5527,0,0,180,0,-180
5528,1,1,95,1707,1612
5529,1,1,594,2205,1611
5530,0,0,35,0,-35
5531,1,0,25,0,-25
5532,0,0,139,0,-139
5533,1,1,462,1273,811
5534,1,0,46,0,-46
5535,1,0,27,0,-27
5536,1,0,28,0,-28
5537,0,0,22,0,-22
5538,1,0,183,0,-183
5539,1,0,3,0,-3
5540,1,0,31,0,-31
5541,1,0,150,0,-150
5542,1,0,7,0,-7
5543,1,1,323,1211,888
5544,0,0,46,0,-46
5545,1,1,357,2235,1878
5546,1,0,16,0,-16
5547,0,0,37,0,-37
5548,0,0,84,0,-84
5549,1,0,38,0,-38
5550,1,0,20,0,-20
5551,0,0,14,0,-14
5552,0,0,40,0,-40
5553,1,0,82,0,-82
5554,1,0,1,0,-1
5555,1,1,560,2505,1945
5556,0,0,17,0,-17
5557,0,0,3,0,-3
5558,1,1,534,1305,771
5559,1,1,165,1279,1114
5560,0,0,32,0,-32
5561,1,1,385,1361,976
5562,1,0,86,0,-86
5563,0,0,102,0,-102
5564,0,0,58,0,-58
5565,1,0,55,0,-55
5566,1,0,23,0,-23
5567,1,1,358,2506,2148
5568,0,0,85,0,-85
5569,1,1,40,1665,1625
5570,1,1,694,2578,1884
5571,1,1,603,1259,656
5572,1,1,570,1631,1061
5573,1,0,13,0,-13
5574,1,1,1372,1497,125
5575,1,0,0,0,0
5576,1,1,656,1532,876
5577,1,1,285,1381,1096
5578,1,0,104,0,-104
5579,1,0,37,0,-37
5580,1,1,203,1227,1024
5581,1,1,121,1220,1099
5582,1,0,12,0,-12
5583,0,0,2,0,-2
5584,1,0,156,0,-156
5585,0,0,213,0,-213
5586,0,0,93,0,-93
5587,1,1,1414,1324,-90
5588,0,0,28,0,-28
5589,1,0,71,0,-71
5590,1,1,489,1591,1102
5591,1,0,80,0,-80
5592,1,1,843,2082,1239
5593,1,0,127,0,-127
5594,0,0,122,0,-122
5595,0,0,17,0,-17
5596,1,0,38,0,-38
5597,1,1,267,2130,1863
5598,1,1,294,1525,1231
5599,1,1,224,2043,1819
5600,0,0,75,0,-75
5601,1,1,241,1335,1094
5602,0,0,4,0,-4
5603,1,1,629,4137,3508
5604,0,0,71,0,-71
5605,0,0,160,0,-160
5606,0,0,16,0,-16
5607,0,0,21,0,-21
5608,1,0,82,0,-82
5609,1,0,141,0,-141
5610,0,0,8,0,-8
5611,0,0,76,0,-76
5612,0,0,27,0,-27
5613,1,1,405,1402,997
5614,1,0,120,0,-120
5615,1,1,1205,1816,611
5616,0,0,10,0,-10
5617,0,0,22,0,-22
5618,0,0,80,0,-80
5619,0,0,112,0,-112
5620,1,1,295,1559,1264
5621,1,1,549,1706,1157
5622,0,0,10,0,-10
5623,1,1,263,1596,1333
5624,1,1,261,1282,1021
5625,0,0,71,0,-71
5626,1,0,5,0,-5
5627,1,1,467,1504,1037
5628,1,1,250,1232,982
5629,0,0,45,0,-45
5630,0,0,1,0,-1
5631,1,1,194,1216,1022
5632,1,0,84,0,-84
5633,1,1,79,1662,1583
5634,1,1,2271,1389,-882
5635,1,0,62,0,-62
5636,1,0,2,0,-2
5637,1,1,199,1246,1047
5638,1,1,1068,1781,713
5639,1,0,21,0,-21
5640,1,0,42,0,-42
5641,0,0,75,0,-75
5642,0,0,12,0,-12
5643,1,1,703,1448,745
5644,0,0,19,0,-19
5645,1,0,67,0,-67
5646,0,0,22,0,-22
5647,1,0,7,0,-7
5648,1,0,22,0,-22
5649,1,0,34,0,-34
5650,1,1,1630,1635,5
5651,0,0,31,0,-31
5652,0,0,2,0,-2
5653,1,0,13,0,-13
5654,1,1,52,1325,1273
5655,1,1,135,1373,1238
5656,1,1,23,1952,1929
5657,0,0,25,0,-25
5658,1,0,52,0,-52
5659,1,0,64,0,-64
5660,0,0,7,0,-7
5661,0,0,29,0,-29
5662,0,0,28,0,-28
5663,1,1,1207,1567,360
5664,0,0,38,0,-38
5665,1,0,42,0,-42
5666,0,0,66,0,-66
5667,0,0,3,0,-3
5668,1,0,5,0,-5
5669,1,0,54,0,-54
5670,0,0,14,0,-14
5671,1,0,11,0,-11
5672,1,0,50,0,-50
5673,1,0,32,0,-32
5674,0,0,17,0,-17
5675,1,0,39,0,-39
5676,1,0,79,0,-79
5677,1,1,232,1343,1111
5678,0,0,236,0,-236
5679,1,1,370,1233,863
5680,1,1,838,1689,851
5681,1,0,28,0,-28
5682,0,0,13,0,-13
5683,1,0,100,0,-100
5684,1,1,924,1449,525
5685,1,0,2,0,-2
5686,1,0,82,0,-82
5687,0,0,6,0,-6
5688,1,1,1482,1878,396
5689,0,0,2,0,-2
5690,1,0,66,0,-66
5691,1,0,11,0,-11
5692,1,0,114,0,-114
5693,1,1,554,2591,2037
5694,1,0,93,0,-93
5695,0,0,17,0,-17
5696,1,0,14,0,-14
5697,1,1,371,1386,1015
5698,1,0,21,0,-21
5699,1,0,20,0,-20
5700,1,0,16,0,-16
5701,0,0,85,0,-85
5702,1,0,14,0,-14
5703,1,0,30,0,-30
5704,0,0,116,0,-116
5705,0,0,74,0,-74
5706,0,0,94,0,-94
5707,0,0,85,0,-85
5708,0,0,4,0,-4
5709,1,0,43,0,-43
5710,1,1,481,1326,845
5711,1,0,125,0,-125
5712,1,1,105,1208,1103
5713,1,1,1973,1479,-494
5714,1,0,5,0,-5
5715,1,0,33,0,-33
5716,0,0,15,0,-15
5717,1,0,84,0,-84
5718,1,1,683,1534,851
5719,0,0,46,0,-46
5720,1,0,4,0,-4
5721,0,0,22,0,-22
5722,1,1,637,1222,585
5723,1,0,17,0,-17
5724,0,0,52,0,-52
5725,0,0,19,0,-19
5726,0,0,9,0,-9
5727,1,1,2043,1254,-789
5728,1,0,59,0,-59
5729,1,0,37,0,-37
5730,0,0,8,0,-8
5731,1,0,3,0,-3
5732,0,0,20,0,-20
5733,1,1,1446,1234,-212
5734,0,0,16,0,-16
5735,0,0,3,0,-3
5736,1,1,1445,1272,-173
5737,0,0,19,0,-19
5738,1,0,4,0,-4
5739,0,0,30,0,-30
5740,1,1,890,1599,709
5741,1,1,87,2075,1988
5742,1,1,89,1692,1603
5743,0,0,2,0,-2
5744,1,1,158,1237,1079
5745,0,0,71,0,-71
5746,1,0,74,0,-74
5747,0,0,18,0,-18
5748,1,1,1155,1328,173
5749,1,1,313,1373,1060
5750,0,0,64,0,-64
5751,0,0,150,0,-150
5752,1,1,127,1582,1455
5753,1,0,21,0,-21
5754,1,1,382,1510,1128
5755,1,1,222,1230,1008
5756,1,0,9,0,-9
5757,1,0,41,0,-41
5758,1,1,53,1556,1503
5759,0,0,59,0,-59
5760,0,0,18,0,-18
5761,1,1,60,1279,1219
5762,1,1,360,1403,1043
5763,0,0,13,0,-13
5764,0,0,33,0,-33
5765,1,1,1986,1793,-193
5766,1,1,811,1214,403
5767,0,0,44,0,-44
5768,0,0,140,0,-140
5769,0,0,22,0,-22
5770,1,1,373,1334,961
5771,1,0,40,0,-40
5772,0,0,192,0,-192
5773,0,0,1,0,-1
5774,1,1,204,1303,1099
5775,1,1,1493,1351,-142
5776,1,0,175,0,-175
5777,0,0,6,0,-6
5778,1,1,927,1274,347
5779,0,0,77,0,-77
5780,0,0,18,0,-18
5781,1,0,5,0,-5
5782,1,1,1921,1842,-79
5783,1,1,297,1226,929
5784,0,0,75,0,-75
5785,0,0,4,0,-4
5786,1,0,172,0,-172
5787,0,0,44,0,-44
5788,1,0,42,0,-42
5789,0,0,24,0,-24
5790,1,1,527,1750,1223
5791,1,0,161,0,-161
5792,1,0,31,0,-31
5793,1,1,83,1327,1244
5794,1,1,210,1311,1101
5795,1,0,99,0,-99
5796,1,1,553,1426,873
5797,1,1,2617,1214,-1403
5798,1,1,449,1548,1099
5799,1,0,40,0,-40
5800,0,0,239,0,-239
5801,1,0,5,0,-5
5802,0,0,3,0,-3
5803,1,1,601,1247,646
5804,1,0,47,0,-47
5805,0,0,83,0,-83
5806,1,0,71,0,-71
5807,0,0,55,0,-55
5808,1,0,65,0,-65
5809,1,0,1,0,-1
5810,0,0,131,0,-131
5811,1,0,2,0,-2
5812,1,1,154,1761,1607
5813,1,0,9,0,-9
5814,1,0,14,0,-14
5815,1,1,668,1265,597
5816,1,0,14,0,-14
5817,1,1,210,1478,1268
5818,1,0,106,0,-106
5819,1,1,255,1295,1040
5820,0,0,27,0,-27
5821,1,1,148,1237,1089
5822,1,0,32,0,-32
5823,1,1,366,1307,941
5824,1,1,115,1852,1737
5825,0,0,46,0,-46
5826,0,0,137,0,-137
5827,1,0,77,0,-77
5828,1,0,24,0,-24
5829,1,0,0,0,0
5830,1,1,655,1656,1001
5831,1,1,1056,1381,325
5832,1,0,23,0,-23
5833,1,1,1991,1616,-375
5834,1,1,376,1323,947
5835,0,0,12,0,-12
5836,1,0,85,0,-85
5837,0,0,63,0,-63
5838,0,0,113,0,-113
5839,0,0,7,0,-7
5840,0,0,132,0,-132
5841,0,0,69,0,-69
5842,0,0,149,0,-149
5843,0,0,9,0,-9
5844,1,1,229,2466,2237
5845,0,0,20,0,-20
5846,1,0,14,0,-14
5847,0,0,38,0,-38
5848,1,0,37,0,-37
5849,0,0,105,0,-105
5850,0,0,55,0,-55
5851,1,1,190,1661,1471
5852,1,1,145,1560,1415
5853,1,1,2347,1995,-352
5854,1,1,753,2315,1562
5855,0,0,65,0,-65
5856,1,1,488,1297,809
5857,1,0,16,0,-16
5858,0,0,15,0,-15
5859,0,0,70,0,-70
5860,0,0,53,0,-53
5861,0,0,54,0,-54
5862,1,0,10,0,-10
5863,0,0,4,0,-4
5864,1,1,1364,1776,412
5865,0,0,68,0,-68
5866,1,1,346,1474,1128
5867,1,0,3,0,-3
5868,0,0,32,0,-32
5869,0,0,45,0,-45
5870,0,0,92,0,-92
5871,0,0,17,0,-17
5872,0,0,12,0,-12
5873,0,0,2,0,-2
5874,1,0,99,0,-99
5875,1,0,232,0,-232
5876,0,0,24,0,-24
5877,0,0,3,0,-3
5878,1,1,265,1904,1639
5879,1,0,155,0,-155
5880,0,0,43,0,-43
5881,0,0,30,0,-30
5882,0,0,135,0,-135
5883,0,0,37,0,-37
5884,0,0,113,0,-113
5885,1,0,22,0,-22
5886,1,0,50,0,-50
5887,1,0,2,0,-2
5888,1,1,61,1332,1271
5889,0,0,70,0,-70
5890,1,0,47,0,-47
5891,1,0,1,0,-1
5892,1,1,31,1413,1382
5893,1,1,431,1380,949
5894,1,1,42,1562,1520
5895,1,1,612,1203,591
5896,0,0,48,0,-48
5897,1,1,390,1691,1301
5898,1,1,245,2470,2225
5899,1,0,2,0,-2
5900,0,0,26,0,-26
5901,1,1,218,3100,2882
5902,0,0,38,0,-38
5903,0,0,44,0,-44
5904,0,0,10,0,-10
5905,1,1,564,1621,1057
5906,0,0,18,0,-18
5907,1,1,385,1745,1360
5908,0,0,129,0,-129
5909,0,0,50,0,-50
5910,0,0,31,0,-31
5911,0,0,6,0,-6
5912,1,0,54,0,-54
5913,1,1,809,3302,2493
5914,0,0,63,0,-63
5915,1,1,187,1206,1019
5916,0,0,1,0,-1
5917,1,0,65,0,-65
5918,1,1,726,1775,1049
5919,1,1,342,1270,928
5920,0,0,24,0,-24
5921,1,1,241,2570,2329
5922,1,1,71,1321,1250
5923,0,0,77,0,-77
5924,0,0,35,0,-35
5925,1,1,112,1623,1511
5926,1,1,325,1264,939
5927,1,0,108,0,-108
5928,1,0,152,0,-152
5929,0,0,21,0,-21
5930,0,0,19,0,-19
5931,1,1,203,2934,2731
5932,0,0,0,0,0
5933,0,0,16,0,-16
5934,1,1,815,1749,934
5935,0,0,51,0,-51
5936,0,0,65,0,-65
5937,1,0,132,0,-132
5938,0,0,59,0,-59
5939,0,0,45,0,-45
5940,0,0,3,0,-3
5941,1,0,1,0,-1
5942,0,0,55,0,-55
5943,1,1,34,1285,1251
5944,0,0,6,0,-6
5945,1,1,1951,1285,-666
5946,0,0,71,0,-71
5947,1,0,40,0,-40
5948,0,0,62,0,-62
5949,1,1,681,1700,1019
5950,1,1,1290,1340,50
5951,1,0,57,0,-57
5952,0,0,60,0,-60
5953,0,0,32,0,-32
5954,1,0,64,0,-64
5955,0,0,22,0,-22
5956,1,0,97,0,-97
5957,1,1,475,2643,2168
5958,1,0,9,0,-9
5959,1,1,229,1263,1034
5960,1,0,99,0,-99
5961,0,0,11,0,-11
5962,0,0,32,0,-32
5963,1,0,48,0,-48
5964,0,0,16,0,-16
5965,0,0,49,0,-49
5966,0,0,0,0,0
5967,0,0,35,0,-35
5968,1,1,1171,1614,443
5969,0,0,55,0,-55
5970,0,0,9,0,-9
5971,1,0,68,0,-68
5972,0,0,85,0,-85
5973,1,0,33,0,-33
5974,1,0,47,0,-47
5975,1,1,17,1368,1351
5976,0,0,41,0,-41
5977,1,1,218,1257,1039
5978,1,1,820,1295,475
5979,1,0,23,0,-23
5980,0,0,23,0,-23
5981,0,0,83,0,-83
5982,1,1,103,1316,1213
5983,0,0,5,0,-5
5984,1,0,18,0,-18
5985,1,0,81,0,-81
5986,0,0,18,0,-18
5987,1,0,39,0,-39
5988,0,0,55,0,-55
5989,0,0,109,0,-109
5990,0,0,33,0,-33
5991,1,1,181,2397,2216
5992,1,0,130,0,-130
5993,1,1,377,1467,1090
5994,0,0,7,0,-7
5995,0,0,43,0,-43
5996,1,1,183,1228,1045
5997,1,0,34,0,-34
5998,0,0,133,0,-133
5999,1,0,169,0,-169
6000,1,1,171,2210,2039
6001,1,0,80,0,-80
6002,1,1,642,1588,946
6003,1,0,4,0,-4
6004,1,0,0,0,0
6005,1,1,230,1221,991
6006,0,0,3,0,-3
6007,0,0,22,0,-22
6008,0,0,17,0,-17
6009,1,1,265,1211,946
6010,0,0,10,0,-10
6011,1,0,7,0,-7
6012,0,0,30,0,-30
6013,1,0,25,0,-25
6014,0,0,10,0,-10
6015,1,1,146,1755,1609
6016,0,0,61,0,-61
6017,0,0,87,0,-87
6018,1,1,188,1443,1255
6019,1,1,154,1445,1291
6020,1,0,14,0,-14
6021,0,0,23,0,-23
6022,1,1,342,1250,908
6023,1,1,784,1218,434
6024,1,1,262,1580,1318
6025,1,0,4,0,-4
6026,0,0,6,0,-6
6027,1,1,344,1261,917
6028,1,0,117,0,-117
6029,1,1,820,1534,714
6030,0,0,14,0,-14
6031,0,0,28,0,-28
6032,1,0,2,0,-2
6033,1,1,360,1220,860
6034,1,1,402,1209,807
6035,1,1,562,1288,726
6036,0,0,93,0,-93
6037,1,1,440,1339,899
6038,1,0,28,0,-28
6039,1,1,107,2093,1986
6040,1,0,55,0,-55
6041,0,0,2,0,-2
6042,1,1,211,1317,1106
6043,1,1,720,1246,526
6044,1,0,114,0,-114
6045,1,0,143,0,-143
6046,1,1,493,1667,1174
6047,0,0,2,0,-2
6048,1,1,460,1716,1256
6049,0,0,186,0,-186
6050,1,1,296,1243,947
6051,1,0,3,0,-3
6052,1,1,718,1418,700
6053,1,0,14,0,-14
6054,1,0,80,0,-80
6055,0,0,106,0,-106
6056,1,0,22,0,-22
6057,1,0,65,0,-65
6058,0,0,74,0,-74
6059,0,0,0,0,0
6060,0,0,82,0,-82
6061,1,0,92,0,-92
6062,1,0,27,0,-27
6063,1,0,84,0,-84
6064,1,1,414,1580,1166
6065,0,0,11,0,-11
6066,1,0,10,0,-10
6067,0,0,10,0,-10
6068,1,0,84,0,-84
6069,0,0,45,0,-45
6070,0,0,0,0,0
6071,1,0,25,0,-25
6072,1,1,588,1251,663
6073,1,0,49,0,-49
6074,0,0,19,0,-19
6075,0,0,37,0,-37
6076,1,0,12,0,-12
6077,0,0,28,0,-28
6078,1,1,510,1718,1208
6079,0,0,2,0,-2
6080,1,1,246,1981,1735
6081,0,0,157,0,-157
6082,1,1,256,1205,949
6083,1,0,42,0,-42
6084,0,0,12,0,-12
6085,1,0,122,0,-122
6086,0,0,33,0,-33
6087,0,0,8,0,-8
6088,0,0,109,0,-109
6089,0,0,59,0,-59
6090,0,0,17,0,-17
6091,1,0,41,0,-41
6092,1,0,26,0,-26
6093,1,1,791,1202,411
6094,1,0,56,0,-56
6095,1,0,28,0,-28
6096,1,0,17,0,-17
6097,0,0,26,0,-26
6098,1,0,85,0,-85
6099,1,0,147,0,-147
6100,1,0,49,0,-49
6101,0,0,58,0,-58
6102,0,0,29,0,-29
6103,1,0,26,0,-26
6104,0,0,31,0,-31
6105,0,0,37,0,-37
6106,1,1,82,1253,1171
6107,1,1,923,1275,352
6108,1,1,389,1816,1427
6109,0,0,19,0,-19
6110,1,1,175,1547,1372
6111,0,0,2,0,-2
6112,1,0,31,0,-31
6113,1,1,65,2167,2102
6114,0,0,16,0,-16
6115,1,1,1298,1241,-57
6116,1,0,24,0,-24
6117,1,1,1220,1294,74
6118,0,0,15,0,-15
6119,0,0,55,0,-55
6120,1,0,47,0,-47
6121,1,1,801,1205,404
6122,0,0,8,0,-8
6123,0,0,78,0,-78
6124,0,0,29,0,-29
6125,1,1,805,1291,486
6126,0,0,21,0,-21
6127,1,0,1,0,-1
6128,0,0,21,0,-21
6129,1,1,875,1271,396
6130,1,1,393,1546,1153
6131,0,0,79,0,-79
6132,1,0,6,0,-6
6133,1,0,60,0,-60
6134,1,1,304,1346,1042
6135,1,0,3,0,-3
6136,0,0,10,0,-10
6137,1,1,709,2106,1397
6138,0,0,94,0,-94
6139,0,0,46,0,-46
6140,1,1,752,1290,538
6141,0,0,40,0,-40
6142,1,1,1624,1382,-242
6143,1,1,248,1459,1211
6144,1,1,838,1249,411
6145,1,1,201,2150,1949
6146,1,1,322,1467,1145
6147,1,0,45,0,-45
6148,0,0,20,0,-20
6149,1,0,75,0,-75
6150,1,1,126,1508,1382
6151,1,1,528,1513,985
6152,0,0,124,0,-124
6153,1,1,272,1531,1259
6154,1,0,10,0,-10
6155,1,1,3193,2180,-1013
6156,1,1,202,1512,1310
6157,1,0,166,0,-166
6158,0,0,0,0,0
6159,0,0,5,0,-5
6160,1,0,27,0,-27
6161,1,0,58,0,-58
6162,1,0,120,0,-120
6163,0,0,70,0,-70
6164,1,0,45,0,-45
6165,0,0,50,0,-50
6166,1,0,37,0,-37
6167,0,0,21,0,-21
6168,0,0,18,0,-18
6169,1,0,18,0,-18
6170,1,1,892,1298,406
6171,1,0,29,0,-29
6172,0,0,21,0,-21
6173,0,0,7,0,-7
6174,1,1,173,1263,1090
6175,1,0,115,0,-115
6176,1,0,36,0,-36
6177,1,1,429,1219,790
6178,1,0,97,0,-97
6179,1,0,112,0,-112
6180,0,0,119,0,-119
6181,1,0,60,0,-60
6182,0,0,26,0,-26
6183,1,0,49,0,-49
6184,0,0,5,0,-5
6185,1,0,7,0,-7
6186,0,0,3,0,-3
6187,1,0,14,0,-14
6188,0,0,13,0,-13
6189,0,0,11,0,-11
6190,0,0,1,0,-1
6191,0,0,65,0,-65
6192,1,1,341,1448,1107
6193,0,0,29,0,-29
6194,1,0,109,0,-109
6195,0,0,84,0,-84
6196,1,1,381,1419,1038
6197,0,0,139,0,-139
6198,0,0,157,0,-157
6199,1,1,721,1220,499
6200,1,0,52,0,-52
6201,1,1,264,1847,1583
6202,0,0,30,0,-30
6203,0,0,19,0,-19
6204,0,0,73,0,-73
6205,1,1,382,1363,981
6206,1,0,52,0,-52
6207,0,0,35,0,-35
6208,1,1,268,1223,955
6209,0,0,6,0,-6
6210,1,1,922,2884,1962
6211,0,0,28,0,-28
6212,0,0,55,0,-55
6213,0,0,7,0,-7
6214,0,0,89,0,-89
6215,0,0,99,0,-99
6216,0,0,17,0,-17
6217,1,0,30,0,-30
6218,0,0,91,0,-91
6219,1,0,15,0,-15
6220,0,0,96,0,-96
6221,1,1,715,1734,1019
6222,0,0,9,0,-9
6223,1,1,786,2533,1747
6224,1,0,81,0,-81
6225,1,0,3,0,-3
6226,1,0,58,0,-58
6227,1,0,52,0,-52
6228,1,1,76,1753,1677
6229,0,0,37,0,-37
6230,1,0,4,0,-4
6231,1,0,22,0,-22
6232,0,0,21,0,-21
6233,0,0,235,0,-235
6234,1,0,75,0,-75
6235,1,0,82,0,-82
6236,0,0,47,0,-47
6237,0,0,20,0,-20
6238,1,1,515,1225,710
6239,1,1,166,1485,1319
6240,1,1,1236,1633,397
6241,1,0,30,0,-30
6242,1,1,462,1364,902
6243,1,1,1197,2486,1289
6244,1,1,532,1378,846
6245,0,0,81,0,-81
6246,0,0,94,0,-94
6247,0,0,98,0,-98
6248,1,0,77,0,-77
6249,1,0,21,0,-21
6250,0,0,170,0,-170
6251,1,0,288,0,-288
6252,0,0,73,0,-73
6253,0,0,34,0,-34
6254,1,1,1139,1645,506
6255,0,0,31,0,-31
6256,1,0,25,0,-25
6257,0,0,0,0,0
6258,0,0,137,0,-137
6259,0,0,62,0,-62
6260,1,1,286,1833,1547
6261,1,0,31,0,-31
6262,0,0,46,0,-46
6263,1,0,38,0,-38
6264,0,0,54,0,-54
6265,1,1,269,1539,1270
6266,0,0,2,0,-2
6267,0,0,72,0,-72
6268,1,1,258,1474,1216
6269,0,0,35,0,-35
6270,1,0,40,0,-40
6271,1,1,1346,1344,-2
6272,1,1,2274,1211,-1063
6273,1,0,36,0,-36
6274,0,0,57,0,-57
6275,1,0,78,0,-78
6276,0,0,112,0,-112
6277,1,0,15,0,-15
6278,1,1,1238,1276,38
6279,0,0,18,0,-18
6280,1,1,856,1459,603
6281,0,0,53,0,-53
6282,1,0,72,0,-72
6283,1,1,187,1887,1700
6284,1,0,38,0,-38
6285,0,0,21,0,-21
6286,1,1,452,1469,1017
6287,1,1,418,1399,981
6288,1,1,110,1586,1476
6289,1,0,52,0,-52
6290,0,0,31,0,-31
6291,1,1,22,1429,1407
6292,1,1,645,1218,573
6293,0,0,53,0,-53
6294,1,1,444,1437,993
6295,0,0,130,0,-130
6296,1,1,711,1336,625
6297,1,0,30,0,-30
6298,1,0,143,0,-143
6299,1,0,2,0,-2
6300,0,0,19,0,-19
6301,0,0,20,0,-20
6302,0,0,6,0,-6
6303,1,0,24,0,-24
6304,1,1,2040,2720,680
6305,1,1,188,1843,1655
6306,0,0,28,0,-28
6307,1,1,299,1664,1365
6308,0,0,61,0,-61
6309,1,0,52,0,-52
6310,1,0,118,0,-118
6311,1,0,114,0,-114
6312,0,0,4,0,-4
6313,1,0,13,0,-13
6314,1,0,82,0,-82
6315,1,0,61,0,-61
6316,0,0,249,0,-249
6317,1,0,56,0,-56
6318,0,0,143,0,-143
6319,1,0,48,0,-48
6320,1,0,39,0,-39
6321,1,1,500,2392,1892
6322,1,1,29,1723,1694
6323,1,0,23,0,-23
6324,1,0,20,0,-20
6325,0,0,7,0,-7
6326,1,0,3,0,-3
6327,1,0,11,0,-11
6328,0,0,11,0,-11
6329,1,0,24,0,-24
6330,1,0,31,0,-31
6331,1,0,9,0,-9
6332,1,0,163,0,-163
6333,1,1,191,1281,1090
6334,1,1,285,1354,1069
6335,1,0,14,0,-14
6336,1,0,51,0,-51
6337,0,0,36,0,-36
6338,1,1,102,1594,1492
6339,1,1,92,1229,1137
6340,1,0,59,0,-59
6341,0,0,82,0,-82
6342,1,0,24,0,-24
6343,0,0,7,0,-7
6344,1,0,187,0,-187
6345,1,1,950,1810,860
6346,0,0,1,0,-1
6347,0,0,47,0,-47
6348,0,0,11,0,-11
6349,1,0,105,0,-105
6350,1,0,56,0,-56
6351,1,0,42,0,-42
6352,1,1,163,1270,1107
6353,0,0,38,0,-38
6354,0,0,146,0,-146
6355,1,0,145,0,-145
6356,1,1,278,1215,937
6357,0,0,36,0,-36
6358,0,0,77,0,-77
6359,0,0,92,0,-92
6360,1,1,692,2778,2086
6361,1,1,527,1623,1096
6362,1,0,8,0,-8
6363,1,0,39,0,-39
6364,1,1,277,1342,1065
6365,1,0,29,0,-29
6366,1,0,2,0,-2
6367,0,0,5,0,-5
6368,1,1,500,1490,990
6369,0,0,60,0,-60
6370,1,1,776,3054,2278
6371,0,0,109,0,-109
6372,0,0,3,0,-3
6373,0,0,41,0,-41
6374,1,0,267,0,-267
6375,1,0,109,0,-109
6376,0,0,123,0,-123
6377,1,0,130,0,-130
6378,0,0,33,0,-33
6379,0,0,23,0,-23
6380,0,0,36,0,-36
6381,1,1,378,1685,1307
6382,1,0,40,0,-40
6383,1,1,67,1248,1181
6384,1,1,359,1292,933
6385,0,0,96,0,-96
6386,0,0,25,0,-25
6387,0,0,0,0,0
6388,0,0,43,0,-43
6389,1,1,403,1209,806
6390,0,0,0,0,0
6391,1,1,732,1218,486
6392,0,0,104,0,-104
6393,1,1,342,1514,1172
6394,0,0,8,0,-8
6395,0,0,71,0,-71
6396,1,1,90,1592,1502
6397,0,0,34,0,-34
6398,1,0,101,0,-101
6399,1,0,60,0,-60
6400,1,0,24,0,-24
6401,0,0,3,0,-3
6402,1,1,1006,1668,662
6403,1,0,18,0,-18
6404,1,1,197,1638,1441
6405,0,0,124,0,-124
6406,1,1,404,2293,1889
6407,1,0,36,0,-36
6408,0,0,224,0,-224
6409,1,0,22,0,-22
6410,1,1,255,2417,2162
6411,1,1,262,1382,1120
6412,0,0,79,0,-79
6413,0,0,5,0,-5
6414,1,0,40,0,-40
6415,1,0,7,0,-7
6416,0,0,21,0,-21
6417,1,1,247,2447,2200
6418,1,0,4,0,-4
6419,0,0,5,0,-5
6420,1,0,37,0,-37
6421,1,1,634,1443,809
6422,0,0,24,0,-24
6423,0,0,68,0,-68
6424,0,0,21,0,-21
6425,1,1,95,1585,1490
6426,0,0,75,0,-75
6427,0,0,180,0,-180
6428,1,1,519,1361,842
6429,0,0,22,0,-22
6430,1,0,0,0,0
6431,0,0,40,0,-40
6432,1,0,7,0,-7
6433,0,0,69,0,-69
6434,0,0,67,0,-67
6435,1,0,54,0,-54
6436,1,0,86,0,-86
6437,1,0,42,0,-42
6438,0,0,6,0,-6
6439,1,0,68,0,-68
6440,0,0,4,0,-4
6441,1,0,11,0,-11
6442,1,0,46,0,-46
6443,1,1,131,1363,1232
6444,0,0,48,0,-48
6445,1,0,18,0,-18
6446,0,0,103,0,-103
6447,0,0,44,0,-44
6448,0,0,29,0,-29
6449,0,0,11,0,-11
6450,1,1,124,1226,1102
6451,0,0,9,0,-9
6452,1,0,61,0,-61
6453,1,1,100,1532,1432
6454,1,1,131,1222,1091
6455,1,1,1325,1248,-77
6456,0,0,29,0,-29
6457,0,0,12,0,-12
6458,0,0,54,0,-54
6459,1,0,16,0,-16
6460,0,0,101,0,-101
6461,1,0,1,0,-1
6462,1,0,7,0,-7
6463,0,0,3,0,-3
6464,0,0,5,0,-5
6465,1,0,158,0,-158
6466,1,0,7,0,-7
6467,1,0,62,0,-62
6468,1,1,134,1456,1322
6469,0,0,51,0,-51
6470,0,0,58,0,-58
6471,1,0,3,0,-3
6472,1,1,1872,1598,-274
6473,0,0,27,0,-27
6474,0,0,6,0,-6
6475,0,0,215,0,-215
6476,0,0,162,0,-162
6477,1,1,162,1620,1458
6478,0,0,102,0,-102
6479,1,1,559,1368,809
6480,1,0,6,0,-6
6481,1,0,4,0,-4
6482,1,1,104,1656,1552
6483,0,0,100,0,-100
6484,1,1,559,1234,675
6485,0,0,7,0,-7
6486,1,1,263,1825,1562
6487,0,0,15,0,-15
6488,0,0,16,0,-16
6489,0,0,12,0,-12
6490,1,0,81,0,-81
6491,1,1,728,1277,549
6492,1,0,48,0,-48
6493,1,0,94,0,-94
6494,1,0,11,0,-11
6495,1,0,7,0,-7
6496,0,0,17,0,-17
6497,1,0,74,0,-74
6498,1,1,658,1887,1229
6499,1,1,874,1289,415
6500,0,0,72,0,-72
6501,1,1,163,1247,1084
6502,0,0,34,0,-34
6503,1,1,1340,1453,113
6504,0,0,23,0,-23
6505,0,0,29,0,-29
6506,1,0,57,0,-57
6507,1,1,655,1400,745
6508,1,0,132,0,-132
6509,0,0,5,0,-5
6510,1,0,49,0,-49
6511,1,1,405,1287,882
6512,1,1,678,1202,524
6513,1,1,1630,1205,-425
6514,1,0,77,0,-77
6515,1,0,28,0,-28
6516,1,0,25,0,-25
6517,1,0,55,0,-55
6518,1,1,612,1587,975
6519,0,0,29,0,-29
6520,1,0,4,0,-4
6521,1,0,18,0,-18
6522,0,0,2,0,-2
6523,1,0,27,0,-27
6524,1,0,15,0,-15
6525,0,0,79,0,-79
6526,1,0,3,0,-3
6527,1,0,1,0,-1
6528,0,0,12,0,-12
6529,1,1,108,2970,2862
6530,0,0,20,0,-20
6531,0,0,34,0,-34
6532,1,0,24,0,-24
6533,1,1,286,1357,1071
6534,1,1,812,1380,568
6535,0,0,95,0,-95
6536,0,0,80,0,-80
6537,0,0,4,0,-4
6538,0,0,9,0,-9
6539,1,0,50,0,-50
6540,1,0,22,0,-22
6541,0,0,11,0,-11
6542,0,0,0,0,0
6543,1,1,123,1664,1541
6544,1,1,68,2995,2927
6545,1,0,33,0,-33
6546,1,1,72,2031,1959
6547,1,1,446,4136,3690
6548,1,1,369,1238,869
6549,1,0,30,0,-30
6550,0,0,27,0,-27
6551,1,1,756,1241,485
6552,0,0,44,0,-44
6553,0,0,0,0,0
6554,0,0,120,0,-120
6555,1,1,571,1562,991
6556,1,0,18,0,-18
6557,1,0,28,0,-28
6558,0,0,26,0,-26
6559,1,0,2,0,-2
6560,1,1,104,1291,1187
6561,0,0,28,0,-28
6562,1,1,71,1653,1582
6563,1,0,25,0,-25
6564,1,0,90,0,-90
6565,1,0,79,0,-79
6566,1,0,62,0,-62
6567,1,1,664,1704,1040
6568,1,1,294,1205,911
6569,1,0,123,0,-123
6570,1,1,270,1263,993
6571,0,0,71,0,-71
6572,1,1,249,1345,1096
6573,1,0,75,0,-75
6574,0,0,39,0,-39
6575,0,0,30,0,-30
6576,0,0,23,0,-23
6577,0,0,103,0,-103
6578,0,0,53,0,-53
6579,1,1,1231,1245,14
6580,0,0,93,0,-93
6581,1,0,113,0,-113
6582,1,0,60,0,-60
6583,1,1,887,1803,916
6584,1,0,4,0,-4
6585,0,0,38,0,-38
6586,1,1,466,1526,1060
6587,1,0,11,0,-11
6588,1,0,23,0,-23
6589,1,0,41,0,-41
6590,1,0,37,0,-37
6591,0,0,4,0,-4
6592,1,0,136,0,-136
6593,0,0,7,0,-7
6594,1,0,39,0,-39
6595,1,0,41,0,-41
6596,1,0,21,0,-21
6597,0,0,88,0,-88
6598,0,0,11,0,-11
6599,1,0,43,0,-43
6600,0,0,34,0,-34
6601,0,0,21,0,-21
6602,1,1,1280,1252,-28
6603,1,0,0,0,0
6604,1,0,13,0,-13
6605,1,0,23,0,-23
6606,0,0,3,0,-3
6607,0,0,58,0,-58
6608,0,0,114,0,-114
6609,1,1,1906,1447,-459
6610,0,0,31,0,-31
6611,1,0,101,0,-101
6612,1,0,8,0,-8
6613,1,1,106,1707,1601
6614,1,1,197,1368,1171
6615,1,0,53,0,-53
6616,1,0,46,0,-46
6617,1,1,1776,1258,-518
6618,0,0,20,0,-20
6619,1,1,218,1890,1672
6620,1,1,808,1286,478
6621,0,0,70,0,-70
6622,0,0,46,0,-46
6623,0,0,61,0,-61
6624,0,0,13,0,-13
6625,0,0,115,0,-115
6626,1,0,80,0,-80
6627,0,0,132,0,-132
6628,1,0,10,0,-10
6629,1,0,9,0,-9
6630,1,1,402,1420,1018
6631,1,1,348,1415,1067
6632,1,0,12,0,-12
6633,1,1,257,2293,2036
6634,1,1,160,1239,1079
6635,1,0,49,0,-49
6636,1,1,814,1361,547
6637,0,0,20,0,-20
6638,0,0,1,0,-1
6639,0,0,56,0,-56
6640,1,1,101,1834,1733
6641,0,0,21,0,-21
6642,1,0,11,0,-11
6643,0,0,31,0,-31
6644,0,0,32,0,-32
6645,1,1,222,1435,1213
6646,1,0,9,0,-9
6647,0,0,25,0,-25
6648,0,0,52,0,-52
6649,1,1,54,1230,1176
6650,1,0,57,0,-57
6651,1,1,253,1611,1358
6652,1,1,238,1316,1078
6653,0,0,25,0,-25
6654,0,0,27,0,-27
6655,0,0,40,0,-40
6656,1,0,1,0,-1
6657,1,1,855,1356,501
6658,0,0,91,0,-91
6659,1,0,6,0,-6
6660,0,0,83,0,-83
6661,1,0,7,0,-7
6662,1,0,43,0,-43
6663,0,0,41,0,-41
6664,0,0,49,0,-49
6665,0,0,8,0,-8
6666,0,0,13,0,-13
6667,1,0,7,0,-7
6668,0,0,61,0,-61
6669,1,1,149,1277,1128
6670,0,0,79,0,-79
6671,0,0,1,0,-1
6672,1,1,698,1235,537
6673,0,0,28,0,-28
6674,1,0,4,0,-4
6675,0,0,133,0,-133
6676,1,1,334,1299,965
6677,1,1,96,1320,1224
6678,1,1,2260,1452,-808
6679,0,0,3,0,-3
6680,0,0,108,0,-108
6681,0,0,36,0,-36
6682,1,1,410,1266,856
6683,1,0,2,0,-2
6684,0,0,9,0,-9
6685,0,0,106,0,-106
6686,1,1,292,1521,1229
6687,1,0,7,0,-7
6688,1,1,141,2119,1978
6689,1,0,29,0,-29
6690,1,1,163,1577,1414
6691,0,0,72,0,-72
6692,0,0,56,0,-56
6693,1,1,16,1416,1400
6694,1,0,60,0,-60
6695,0,0,48,0,-48
6696,1,0,79,0,-79
6697,1,1,38,1277,1239
6698,0,0,13,0,-13
6699,1,0,15,0,-15
6700,1,1,355,1756,1401
6701,0,0,5,0,-5
6702,1,1,417,1270,853
6703,1,1,213,1301,1088
6704,1,0,64,0,-64
6705,1,0,79,0,-79
6706,0,0,1,0,-1
6707,0,0,13,0,-13
6708,1,1,724,4206,3482
6709,0,0,22,0,-22
6710,0,0,1,0,-1
6711,0,0,106,0,-106
6712,1,1,975,1387,412
6713,1,1,895,1498,603
6714,0,0,269,0,-269
6715,1,1,204,1273,1069
6716,1,0,33,0,-33
6717,0,0,42,0,-42
6718,1,1,478,1809,1331
6719,0,0,103,0,-103
6720,0,0,35,0,-35
6721,0,0,9,0,-9
6722,1,0,42,0,-42
6723,1,1,113,1994,1881
6724,0,0,65,0,-65
6725,1,1,2414,1349,-1065
6726,1,1,43,1375,1332
6727,1,0,13,0,-13
6728,0,0,14,0,-14
6729,1,1,2076,1777,-299
6730,1,0,40,0,-40
6731,0,0,85,0,-85
6732,0,0,9,0,-9
6733,1,1,397,2580,2183
6734,0,0,72,0,-72
6735,1,1,336,1589,1253
6736,1,0,10,0,-10
6737,1,0,25,0,-25
6738,1,0,9,0,-9
6739,0,0,140,0,-140
6740,1,1,228,1406,1178
6741,0,0,0,0,0
6742,1,1,149,1228,1079
6743,1,0,55,0,-55
6744,1,0,36,0,-36
6745,1,0,145,0,-145
6746,1,0,63,0,-63
6747,1,1,650,1250,600
6748,0,0,1,0,-1
6749,0,0,58,0,-58
6750,1,0,2,0,-2
6751,0,0,108,0,-108
6752,0,0,19,0,-19
6753,1,0,42,0,-42
6754,0,0,9,0,-9
6755,0,0,65,0,-65
6756,1,1,313,1675,1362
6757,0,0,116,0,-116
6758,0,0,40,0,-40
6759,1,1,998,1374,376
6760,0,0,12,0,-12
6761,0,0,22,0,-22
6762,1,1,491,1489,998
6763,1,0,187,0,-187
6764,1,0,7,0,-7
6765,1,0,24,0,-24
6766,1,0,7,0,-7
6767,0,0,23,0,-23
6768,1,1,1541,1889,348
6769,1,0,24,0,-24
6770,1,0,48,0,-48
6771,1,0,24,0,-24
6772,1,0,34,0,-34
6773,1,1,69,2498,2429
6774,1,0,4,0,-4
6775,0,0,123,0,-123
6776,1,0,25,0,-25
6777,0,0,12,0,-12
6778,1,0,22,0,-22
6779,1,1,25,1546,1521
6780,0,0,112,0,-112
6781,1,0,10,0,-10
6782,1,1,235,1965,1730
6783,1,0,26,0,-26
6784,0,0,24,0,-24
6785,0,0,0,0,0
6786,1,0,26,0,-26
6787,1,0,28,0,-28
6788,1,1,179,1244,1065
6789,0,0,53,0,-53
6790,1,1,1067,1346,279
6791,1,1,376,1237,861
6792,1,1,14,1862,1848
6793,1,0,74,0,-74
6794,0,0,37,0,-37
6795,1,1,613,1767,1154
6796,0,0,114,0,-114
6797,1,1,581,1262,681
6798,0,0,35,0,-35
6799,1,1,116,1669,1553
6800,1,1,475,1935,1460
6801,0,0,37,0,-37
6802,0,0,86,0,-86
6803,1,0,12,0,-12
6804,1,1,290,1487,1197
6805,1,0,47,0,-47
6806,0,0,19,0,-19
6807,0,0,34,0,-34
6808,1,1,552,1580,1028
6809,0,0,72,0,-72
6810,0,0,19,0,-19
6811,0,0,151,0,-151
6812,1,1,1202,1230,28
6813,1,0,63,0,-63
6814,0,0,52,0,-52
6815,1,1,214,1652,1438
6816,0,0,52,0,-52
6817,1,1,108,1622,1514
6818,0,0,18,0,-18
6819,1,1,1492,1450,-42
6820,1,0,170,0,-170
6821,1,0,61,0,-61
6822,0,0,3,0,-3
6823,1,1,398,1539,1141
6824,1,1,477,1248,771
6825,0,0,32,0,-32
6826,1,0,46,0,-46
6827,1,1,275,2659,2384
6828,1,0,47,0,-47
6829,1,1,644,1217,573
6830,0,0,57,0,-57
6831,0,0,39,0,-39
6832,0,0,28,0,-28
6833,0,0,102,0,-102
6834,1,0,18,0,-18
6835,0,0,53,0,-53
6836,1,0,22,0,-22
6837,1,1,90,1333,1243
6838,0,0,42,0,-42
6839,0,0,99,0,-99
6840,1,1,31,1505,1474
6841,0,0,21,0,-21
6842,1,0,9,0,-9
6843,0,0,36,0,-36
6844,1,1,195,1387,1192
6845,1,0,11,0,-11
6846,0,0,169,0,-169
6847,1,0,3,0,-3
6848,1,1,734,1240,506
6849,1,1,641,2016,1375
6850,1,0,127,0,-127
6851,0,0,22,0,-22
6852,0,0,21,0,-21
6853,0,0,66,0,-66
6854,1,0,97,0,-97
6855,1,0,94,0,-94
6856,1,0,53,0,-53
6857,1,1,445,1356,911
6858,1,1,247,2103,1856
6859,1,1,469,1793,1324
6860,1,1,182,1243,1061
6861,0,0,40,0,-40
6862,0,0,14,0,-14
6863,1,1,404,1282,878
6864,0,0,128,0,-128
6865,1,1,78,1213,1135
6866,0,0,43,0,-43
6867,0,0,40,0,-40
6868,1,1,314,1220,906
6869,0,0,243,0,-243
6870,1,1,478,2875,2397
6871,0,0,9,0,-9
6872,1,0,32,0,-32
6873,0,0,1,0,-1
6874,1,0,10,0,-10
6875,0,0,7,0,-7
6876,1,1,203,1399,1196
6877,0,0,22,0,-22
6878,1,0,64,0,-64
6879,1,1,767,1314,547
6880,0,0,171,0,-171
6881,0,0,31,0,-31
6882,1,0,57,0,-57
6883,1,0,0,0,0
6884,1,1,227,1330,1103
6885,1,1,404,1424,1020
6886,0,0,162,0,-162
6887,1,0,36,0,-36
6888,0,0,8,0,-8
6889,1,1,1681,1341,-340
6890,0,0,9,0,-9
6891,0,0,124,0,-124
6892,1,1,63,2004,1941
6893,1,0,28,0,-28
6894,0,0,52,0,-52
6895,0,0,12,0,-12
6896,0,0,25,0,-25
6897,0,0,8,0,-8
6898,1,0,30,0,-30
6899,1,1,890,1417,527
6900,1,1,101,1831,1730
6901,1,1,1152,1672,520
6902,1,1,523,1953,1430
6903,0,0,28,0,-28
6904,1,1,105,1294,1189
6905,1,0,21,0,-21
6906,0,0,0,0,0
6907,1,1,201,1741,1540
6908,0,0,31,0,-31
6909,1,1,223,1351,1128
6910,1,1,478,2855,2377
6911,1,0,87,0,-87
6912,1,1,17,2118,2101
6913,1,0,1,0,-1
6914,0,0,42,0,-42
6915,0,0,27,0,-27
6916,1,1,2002,1233,-769
6917,1,0,13,0,-13
6918,1,0,120,0,-120
6919,1,1,1820,1487,-333
6920,0,0,56,0,-56
6921,1,0,5,0,-5
6922,1,0,44,0,-44
6923,0,0,104,0,-104
6924,1,0,10,0,-10
6925,1,1,1587,1654,67
6926,0,0,28,0,-28
6927,1,1,564,2095,1531
6928,1,0,23,0,-23
6929,1,1,122,1409,1287
6930,1,1,136,1370,1234
6931,0,0,50,0,-50
6932,1,1,363,1245,882
6933,0,0,11,0,-11
6934,0,0,212,0,-212
6935,0,0,22,0,-22
6936,0,0,175,0,-175
6937,1,0,43,0,-43
6938,0,0,7,0,-7
6939,1,1,509,1364,855
6940,1,0,21,0,-21
6941,0,0,72,0,-72
6942,0,0,2,0,-2
6943,0,0,18,0,-18
6944,0,0,24,0,-24
6945,0,0,13,0,-13
6946,1,0,115,0,-115
6947,1,0,32,0,-32
6948,1,1,295,1229,934
6949,0,0,59,0,-59
6950,1,1,140,1499,1359
6951,1,1,231,2376,2145
6952,1,1,790,1473,683
6953,1,1,264,1821,1557
6954,0,0,56,0,-56
6955,0,0,18,0,-18
6956,1,1,189,1492,1303
6957,0,0,96,0,-96
6958,1,0,24,0,-24
6959,0,0,51,0,-51
6960,1,0,42,0,-42
6961,0,0,53,0,-53
6962,1,1,353,1944,1591
6963,0,0,43,0,-43
6964,0,0,152,0,-152
6965,0,0,19,0,-19
6966,0,0,20,0,-20
6967,0,0,116,0,-116
6968,1,1,345,2297,1952
6969,1,0,8,0,-8
6970,1,1,544,1331,787
6971,1,1,168,1683,1515
6972,0,0,3,0,-3
6973,0,0,10,0,-10
6974,0,0,30,0,-30
6975,0,0,39,0,-39
6976,0,0,100,0,-100
6977,0,0,29,0,-29
6978,1,0,107,0,-107
6979,0,0,0,0,0
6980,0,0,100,0,-100
6981,0,0,32,0,-32
6982,0,0,55,0,-55
6983,0,0,25,0,-25
6984,0,0,36,0,-36
6985,1,0,15,0,-15
6986,0,0,25,0,-25
6987,0,0,54,0,-54
6988,0,0,58,0,-58
6989,0,0,113,0,-113
6990,1,0,5,0,-5
6991,1,1,1551,1646,95
6992,0,0,18,0,-18
6993,1,0,6,0,-6
6994,0,0,184,0,-184
6995,1,1,959,2633,1674
6996,1,0,181,0,-181
6997,1,1,456,1602,1146
6998,0,0,90,0,-90
6999,1,1,1021,1234,213
7000,0,0,4,0,-4
7001,1,1,2342,1219,-1123
7002,1,0,21,0,-21
7003,1,0,13,0,-13
7004,1,1,2507,1318,-1189
7005,0,0,58,0,-58
7006,1,0,91,0,-91
7007,1,1,330,1394,1064
7008,1,0,180,0,-180
7009,1,1,119,1432,1313
7010,1,0,7,0,-7
7011,0,0,15,0,-15
7012,0,0,56,0,-56
7013,1,1,1259,1219,-40
7014,0,0,120,0,-120
7015,1,1,387,1209,822
7016,0,0,5,0,-5
7017,1,1,298,1222,924
7018,1,1,426,1371,945
7019,0,0,74,0,-74
7020,0,0,78,0,-78
7021,1,1,148,1312,1164
7022,0,0,30,0,-30
7023,1,1,578,1746,1168
7024,0,0,45,0,-45
7025,1,0,157,0,-157
7026,1,1,2062,1914,-148
7027,1,1,499,1424,925
7028,0,0,13,0,-13
7029,0,0,167,0,-167
7030,0,0,84,0,-84
7031,1,0,119,0,-119
7032,1,0,10,0,-10
7033,1,1,1181,1431,250
7034,1,0,8,0,-8
7035,0,0,0,0,0
7036,0,0,9,0,-9
7037,0,0,0,0,0
7038,1,0,34,0,-34
7039,1,1,13,2470,2457
7040,0,0,102,0,-102
7041,1,0,9,0,-9
7042,1,0,33,0,-33
7043,1,0,40,0,-40
7044,0,0,10,0,-10
7045,0,0,3,0,-3
7046,1,1,670,1865,1195
7047,1,1,619,3281,2662
7048,1,0,57,0,-57
7049,0,0,89,0,-89
7050,1,0,70,0,-70
7051,1,0,82,0,-82
7052,1,0,22,0,-22
7053,0,0,75,0,-75
7054,1,1,120,1798,1678
7055,0,0,9,0,-9
7056,1,0,27,0,-27
7057,0,0,76,0,-76
7058,0,0,75,0,-75
7059,0,0,32,0,-32
7060,1,0,32,0,-32
7061,1,1,91,1746,1655
7062,1,1,439,1705,1266
7063,0,0,3,0,-3
7064,1,1,442,1576,1134
7065,0,0,31,0,-31
7066,0,0,67,0,-67
7067,0,0,9,0,-9
7068,1,0,96,0,-96
7069,1,0,60,0,-60
7070,1,0,45,0,-45
7071,1,0,104,0,-104
7072,0,0,27,0,-27
7073,1,0,15,0,-15
7074,0,0,107,0,-107
7075,1,0,3,0,-3
7076,0,0,5,0,-5
7077,1,1,499,1342,843
7078,1,0,8,0,-8
7079,1,0,76,0,-76
7080,1,0,28,0,-28
7081,0,0,151,0,-151
7082,0,0,6,0,-6
7083,0,0,22,0,-22
7084,1,0,147,0,-147
7085,0,0,27,0,-27
7086,1,0,41,0,-41
7087,1,1,74,1900,1826
7088,0,0,129,0,-129
7089,0,0,16,0,-16
7090,0,0,4,0,-4
7091,1,1,226,1238,1012
7092,1,1,520,1472,952
7093,0,0,74,0,-74
7094,0,0,150,0,-150
7095,1,0,25,0,-25
7096,1,1,336,1353,1017
7097,1,0,64,0,-64
7098,1,1,461,1944,1483
7099,1,0,33,0,-33
7100,1,1,436,1315,879
7101,1,1,117,1256,1139
7102,0,0,2,0,-2
7103,0,0,50,0,-50
7104,1,0,24,0,-24
7105,0,0,46,0,-46
7106,1,1,1541,1339,-202
7107,0,0,39,0,-39
7108,1,0,30,0,-30
7109,1,0,28,0,-28
7110,0,0,169,0,-169
7111,1,0,44,0,-44
7112,0,0,1,0,-1
7113,1,0,13,0,-13
7114,0,0,0,0,0
7115,1,0,2,0,-2
7116,0,0,0,0,0
7117,1,1,169,1218,1049
7118,1,0,13,0,-13
7119,0,0,7,0,-7
7120,0,0,38,0,-38
7121,1,1,183,1454,1271
7122,1,1,595,1234,639
7123,1,1,288,1522,1234
7124,1,1,207,1460,1253
7125,0,0,45,0,-45
7126,0,0,61,0,-61
7127,1,0,27,0,-27
7128,1,1,214,1236,1022
7129,1,1,446,1264,818
7130,1,1,528,1223,695
7131,0,0,19,0,-19
7132,1,0,8,0,-8
7133,1,1,217,2080,1863
7134,1,1,117,1469,1352
7135,1,1,501,1811,1310
7136,1,1,103,1258,1155
7137,0,0,206,0,-206
7138,1,0,34,0,-34
7139,0,0,21,0,-21
7140,0,0,59,0,-59
7141,0,0,63,0,-63
7142,1,1,283,1383,1100
7143,1,0,56,0,-56
7144,1,1,625,1331,706
7145,0,0,7,0,-7
7146,0,0,4,0,-4
7147,1,1,1725,1328,-397
7148,1,1,1354,1329,-25
7149,0,0,5,0,-5
7150,1,1,403,1298,895
7151,1,0,37,0,-37
7152,1,0,25,0,-25
7153,1,0,48,0,-48
7154,0,0,37,0,-37
7155,1,1,1210,1513,303
7156,0,0,50,0,-50
7157,1,0,26,0,-26
7158,1,0,91,0,-91
7159,1,0,44,0,-44
7160,1,0,30,0,-30
7161,0,0,241,0,-241
7162,1,1,559,3184,2625
7163,1,0,264,0,-264
7164,0,0,114,0,-114
7165,0,0,176,0,-176
7166,1,0,26,0,-26
7167,0,0,51,0,-51
7168,0,0,109,0,-109
7169,1,0,32,0,-32
7170,0,0,13,0,-13
7171,0,0,32,0,-32
7172,0,0,8,0,-8
7173,0,0,39,0,-39
7174,0,0,7,0,-7
7175,0,0,0,0,0
7176,0,0,51,0,-51
7177,0,0,27,0,-27
7178,0,0,36,0,-36
7179,0,0,4,0,-4
7180,0,0,15,0,-15
7181,1,0,74,0,-74
7182,1,1,991,1304,313
7183,1,1,252,1226,974
7184,0,0,70,0,-70
7185,0,0,30,0,-30
7186,0,0,67,0,-67
7187,1,0,18,0,-18
7188,0,0,25,0,-25
7189,0,0,0,0,0
7190,1,1,427,2114,1687
7191,1,1,81,1367,1286
7192,0,0,11,0,-11
7193,0,0,15,0,-15
7194,1,1,993,1528,535
7195,1,1,134,1307,1173
7196,0,0,17,0,-17
7197,1,1,283,1292,1009
7198,0,0,30,0,-30
7199,1,1,223,1268,1045
7200,1,0,15,0,-15
7201,1,0,12,0,-12
7202,0,0,52,0,-52
7203,1,0,21,0,-21
7204,0,0,25,0,-25
7205,0,0,7,0,-7
7206,1,1,76,1319,1243
7207,1,0,0,0,0
7208,1,1,266,2648,2382
7209,1,1,54,1634,1580
7210,1,1,187,1219,1032
7211,1,1,125,1321,1196
7212,1,1,65,1897,1832
7213,1,1,384,4414,4030
7214,1,0,96,0,-96
7215,0,0,89,0,-89
7216,0,0,5,0,-5
7217,0,0,0,0,0
7218,1,1,345,1339,994
7219,0,0,12,0,-12
7220,1,0,16,0,-16
7221,1,1,364,1272,908
7222,0,0,23,0,-23
7223,1,0,99,0,-99
7224,0,0,25,0,-25
7225,1,0,130,0,-130
7226,0,0,55,0,-55
7227,1,0,11,0,-11
7228,0,0,33,0,-33
7229,1,1,189,1567,1378
7230,0,0,77,0,-77
7231,0,0,123,0,-123
7232,1,0,139,0,-139
7233,0,0,15,0,-15
7234,1,1,793,1385,592
7235,1,1,311,1506,1195
7236,1,1,489,1533,1044
7237,1,0,54,0,-54
7238,1,0,83,0,-83
7239,0,0,48,0,-48
7240,1,1,409,1985,1576
7241,1,0,8,0,-8
7242,1,1,508,1228,720
7243,1,1,79,8382,8303
7244,1,0,9,0,-9
7245,0,0,149,0,-149
7246,1,0,31,0,-31
7247,0,0,57,0,-57
7248,0,0,189,0,-189
7249,0,0,19,0,-19
7250,0,0,19,0,-19
7251,0,0,37,0,-37
7252,0,0,51,0,-51
7253,0,0,163,0,-163
7254,0,0,40,0,-40
7255,1,0,32,0,-32
7256,1,0,54,0,-54
7257,1,0,79,0,-79
7258,0,0,0,0,0
7259,1,1,1104,2657,1553
7260,1,0,92,0,-92
7261,0,0,43,0,-43
7262,0,0,27,0,-27
7263,0,0,81,0,-81
7264,0,0,56,0,-56
7265,1,0,16,0,-16
7266,1,1,777,1530,753
7267,1,1,2125,1594,-531
7268,1,1,1215,1202,-13
7269,1,0,114,0,-114
7270,1,0,41,0,-41
7271,1,0,22,0,-22
7272,0,0,200,0,-200
7273,1,0,84,0,-84
7274,0,0,6,0,-6
7275,0,0,23,0,-23
7276,1,0,12,0,-12
7277,1,0,46,0,-46
7278,1,0,116,0,-116
7279,0,0,57,0,-57
7280,1,1,54,2350,2296
7281,1,1,685,1528,843
7282,0,0,42,0,-42
7283,0,0,81,0,-81
7284,1,1,274,1303,1029
7285,0,0,40,0,-40
7286,0,0,27,0,-27
7287,0,0,20,0,-20
7288,0,0,85,0,-85
7289,1,0,39,0,-39
7290,1,0,5,0,-5
7291,1,1,101,1543,1442
7292,1,0,12,0,-12
7293,1,1,424,1551,1127
7294,1,1,138,1275,1137
7295,1,0,2,0,-2
7296,1,1,2338,2129,-209
7297,0,0,34,0,-34
7298,0,0,112,0,-112
7299,1,0,140,0,-140
7300,0,0,72,0,-72
7301,1,1,207,1762,1555
7302,0,0,0,0,0
7303,0,0,70,0,-70
7304,1,1,123,1340,1217
7305,1,1,807,1899,1092
7306,0,0,255,0,-255
7307,0,0,24,0,-24
7308,1,1,115,1227,1112
7309,0,0,67,0,-67
7310,0,0,38,0,-38
7311,1,1,137,1922,1785
7312,1,1,410,1424,1014
7313,1,1,192,1962,1770
7314,1,0,92,0,-92
7315,0,0,6,0,-6
7316,0,0,118,0,-118
7317,0,0,4,0,-4
7318,1,1,782,1299,517
7319,0,0,78,0,-78
7320,1,0,0,0,0
7321,0,0,99,0,-99
7322,1,1,302,1689,1387
7323,0,0,37,0,-37
7324,0,0,4,0,-4
7325,1,1,149,1284,1135
7326,1,1,558,1362,804
7327,0,0,37,0,-37
7328,0,0,201,0,-201
7329,0,0,45,0,-45
7330,1,1,376,2693,2317
7331,0,0,224,0,-224
7332,0,0,31,0,-31
7333,1,0,25,0,-25
7334,1,1,953,2896,1943
7335,0,0,44,0,-44
7336,0,0,7,0,-7
7337,0,0,94,0,-94
7338,0,0,121,0,-121
7339,0,0,51,0,-51
7340,1,0,28,0,-28
7341,1,1,725,1242,517
7342,0,0,7,0,-7
7343,1,1,106,1289,1183
7344,1,1,75,1669,1594
7345,0,0,99,0,-99
7346,1,0,30,0,-30
7347,1,1,159,1209,1050
7348,1,1,108,1583,1475
7349,0,0,1,0,-1
7350,1,1,231,1378,1147
7351,0,0,32,0,-32
7352,1,0,42,0,-42
7353,0,0,18,0,-18
7354,0,0,82,0,-82
7355,1,0,114,0,-114
7356,0,0,11,0,-11
7357,1,0,27,0,-27
7358,0,0,92,0,-92
7359,0,0,53,0,-53
7360,0,0,82,0,-82
7361,1,0,23,0,-23
7362,1,1,155,1643,1488
7363,1,0,54,0,-54
7364,1,1,553,1606,1053
7365,0,0,22,0,-22
7366,1,0,23,0,-23
7367,1,0,0,0,0
7368,1,0,128,0,-128
7369,1,1,225,2596,2371
7370,1,1,112,1282,1170
7371,1,0,28,0,-28
7372,1,1,239,1251,1012
7373,0,0,18,0,-18
7374,1,0,6,0,-6
7375,1,0,23,0,-23
7376,1,1,583,1233,650
7377,1,0,3,0,-3
7378,1,0,7,0,-7
7379,0,0,74,0,-74
7380,1,0,110,0,-110
7381,1,0,16,0,-16
7382,1,0,63,0,-63
7383,0,0,80,0,-80
7384,1,1,954,1333,379
7385,0,0,91,0,-91
7386,0,0,23,0,-23
7387,0,0,82,0,-82
7388,1,1,885,1217,332
7389,0,0,123,0,-123
7390,1,0,20,0,-20
7391,0,0,38,0,-38
7392,0,0,5,0,-5
7393,1,1,580,1230,650
7394,0,0,26,0,-26
7395,1,1,361,2390,2029
7396,0,0,59,0,-59
7397,0,0,18,0,-18
7398,0,0,81,0,-81
7399,1,0,52,0,-52
7400,1,1,347,1252,905
7401,0,0,45,0,-45
7402,0,0,21,0,-21
7403,0,0,0,0,0
7404,0,0,25,0,-25
7405,1,0,64,0,-64
7406,0,0,56,0,-56
7407,0,0,214,0,-214
7408,0,0,19,0,-19
7409,1,1,77,1202,1125
7410,0,0,126,0,-126
7411,0,0,2,0,-2
7412,1,1,100,1410,1310
7413,1,0,59,0,-59
7414,1,1,711,2060,1349
7415,0,0,179,0,-179
7416,1,1,1101,1406,305
7417,1,1,86,1222,1136
7418,0,0,139,0,-139
7419,1,1,262,1509,1247
7420,1,1,598,2125,1527
7421,0,0,22,0,-22
7422,1,0,65,0,-65
7423,1,1,336,1517,1181
7424,1,1,1144,1615,471
7425,0,0,6,0,-6
7426,0,0,32,0,-32
7427,0,0,35,0,-35
7428,1,1,662,1623,961
7429,0,0,37,0,-37
7430,1,1,67,1337,1270
7431,0,0,48,0,-48
7432,1,1,502,1558,1056
7433,1,1,1206,1625,419
7434,0,0,80,0,-80
7435,1,0,94,0,-94
7436,1,0,65,0,-65
7437,0,0,38,0,-38
7438,1,1,898,1261,363
7439,1,1,1790,1547,-243
7440,0,0,3,0,-3
7441,1,0,19,0,-19
7442,1,0,151,0,-151
7443,1,1,668,2676,2008
7444,1,1,810,2017,1207
7445,1,0,25,0,-25
7446,0,0,14,0,-14
7447,1,1,1503,1973,470
7448,0,0,4,0,-4
7449,1,0,54,0,-54
7450,1,0,29,0,-29
7451,1,0,50,0,-50
7452,1,1,1239,1323,84
7453,0,0,8,0,-8
7454,1,0,8,0,-8
7455,0,0,56,0,-56
7456,0,0,55,0,-55
7457,1,1,1315,1214,-101
7458,1,0,27,0,-27
7459,1,1,8,1258,1250
7460,1,1,239,1317,1078
7461,1,1,523,1428,905
7462,1,0,17,0,-17
7463,0,0,12,0,-12
7464,1,1,826,2268,1442
7465,1,0,10,0,-10
7466,1,0,75,0,-75
7467,0,0,1,0,-1
7468,1,1,844,1858,1014
7469,1,0,0,0,0
7470,1,1,54,1348,1294
7471,1,0,4,0,-4
7472,1,0,132,0,-132
7473,1,0,100,0,-100
7474,1,0,151,0,-151
7475,0,0,110,0,-110
7476,1,0,33,0,-33
7477,1,0,32,0,-32
7478,1,1,414,2627,2213
7479,0,0,37,0,-37
7480,0,0,2,0,-2
7481,1,1,69,2150,2081
7482,0,0,41,0,-41
7483,1,1,707,1435,728
7484,1,1,129,1585,1456
7485,1,1,499,2524,2025
7486,0,0,33,0,-33
7487,1,0,76,0,-76
7488,0,0,63,0,-63
7489,0,0,57,0,-57
7490,0,0,39,0,-39
7491,1,1,237,1359,1122
7492,0,0,12,0,-12
7493,0,0,6,0,-6
7494,0,0,109,0,-109
7495,1,1,260,1848,1588
7496,0,0,62,0,-62
7497,1,0,83,0,-83
7498,1,1,100,1331,1231
7499,0,0,78,0,-78
7500,0,0,88,0,-88
7501,0,0,36,0,-36
7502,0,0,128,0,-128
7503,0,0,23,0,-23
7504,1,0,91,0,-91
7505,1,0,136,0,-136
7506,1,1,52,1348,1296
7507,1,1,1170,1386,216
7508,1,0,21,0,-21
7509,1,1,469,1440,971
7510,1,0,21,0,-21
7511,0,0,23,0,-23
7512,1,1,19,1688,1669
7513,0,0,119,0,-119
7514,1,0,42,0,-42
7515,1,0,8,0,-8
7516,0,0,91,0,-91
7517,1,1,152,1645,1493
7518,1,0,42,0,-42
7519,0,0,45,0,-45
7520,1,0,78,0,-78
7521,1,0,68,0,-68
7522,1,0,16,0,-16
7523,1,1,1100,1301,201
7524,0,0,44,0,-44
7525,1,1,1577,1366,-211
7526,1,0,143,0,-143
7527,0,0,60,0,-60
7528,0,0,29,0,-29
7529,0,0,6,0,-6
7530,1,1,2042,1503,-539
7531,1,0,0,0,0
7532,0,0,16,0,-16
7533,0,0,125,0,-125
7534,0,0,31,0,-31
7535,1,0,65,0,-65
7536,1,0,37,0,-37
7537,0,0,33,0,-33
7538,0,0,25,0,-25
7539,0,0,45,0,-45
7540,1,1,280,1735,1455
7541,1,1,863,1312,449
7542,1,0,96,0,-96
7543,1,0,9,0,-9
7544,0,0,80,0,-80
7545,0,0,53,0,-53
7546,0,0,30,0,-30
7547,1,0,55,0,-55
7548,0,0,2,0,-2
7549,1,1,410,1202,792
7550,1,1,368,1300,932
7551,1,1,124,2327,2203
7552,1,1,310,1564,1254
7553,1,1,690,1264,574
7554,1,1,843,2077,1234
7555,1,0,5,0,-5
7556,1,1,430,1217,787
7557,1,0,10,0,-10
7558,1,1,299,1217,918
7559,0,0,21,0,-21
7560,1,0,30,0,-30
7561,1,1,184,1236,1052
7562,0,0,8,0,-8
7563,1,0,53,0,-53
7564,0,0,2,0,-2
7565,1,1,512,1497,985
7566,1,1,128,5296,5168
7567,1,0,24,0,-24
7568,1,1,897,1200,303
7569,1,0,2,0,-2
7570,1,1,2018,1862,-156
7571,1,0,77,0,-77
7572,1,1,372,1507,1135
7573,0,0,25,0,-25
7574,1,0,39,0,-39
7575,1,0,240,0,-240
7576,1,1,1537,1427,-110
7577,0,0,40,0,-40
7578,1,0,13,0,-13
7579,1,1,325,1759,1434
7580,0,0,135,0,-135
7581,1,1,372,1452,1080
7582,1,1,418,2357,1939
7583,0,0,15,0,-15
7584,1,1,231,1339,1108
7585,1,1,151,1466,1315
7586,0,0,49,0,-49
7587,0,0,83,0,-83
7588,0,0,104,0,-104
7589,0,0,14,0,-14
7590,1,0,61,0,-61
7591,1,0,17,0,-17
7592,1,1,686,1405,719
7593,0,0,13,0,-13
7594,1,1,284,1334,1050
7595,0,0,22,0,-22
7596,1,1,409,1379,970
7597,1,1,431,1799,1368
7598,0,0,101,0,-101
7599,0,0,43,0,-43
7600,0,0,160,0,-160
7601,1,0,119,0,-119
7602,1,1,593,1667,1074
7603,1,1,1302,1355,53
7604,0,0,197,0,-197
7605,1,0,28,0,-28
7606,1,0,210,0,-210
7607,1,0,27,0,-27
7608,1,0,25,0,-25
7609,1,1,56,1664,1608
7610,1,1,3460,1725,-1735
7611,0,0,21,0,-21
7612,0,0,11,0,-11
7613,1,1,2130,1360,-770
7614,1,1,977,1567,590
7615,0,0,14,0,-14
7616,1,0,6,0,-6
7617,1,0,3,0,-3
7618,1,0,10,0,-10
7619,0,0,35,0,-35
7620,1,1,130,1301,1171
7621,1,1,797,1269,472
7622,1,0,1,0,-1
7623,0,0,12,0,-12
7624,1,0,5,0,-5
7625,0,0,29,0,-29
7626,0,0,63,0,-63
7627,1,1,655,2098,1443
7628,0,0,25,0,-25
7629,1,1,278,1306,1028
7630,1,1,534,1280,746
7631,0,0,112,0,-112
7632,1,1,436,1674,1238
7633,0,0,32,0,-32
7634,1,1,520,2316,1796
7635,0,0,18,0,-18
7636,0,0,139,0,-139
7637,0,0,87,0,-87
7638,0,0,17,0,-17
7639,1,1,299,1209,910
7640,1,0,129,0,-129
7641,0,0,73,0,-73
7642,0,0,0,0,0
7643,1,0,30,0,-30
7644,0,0,100,0,-100
7645,0,0,78,0,-78
7646,1,0,31,0,-31
7647,0,0,16,0,-16
7648,0,0,30,0,-30
7649,1,1,299,1759,1460
7650,1,1,306,1570,1264
7651,1,1,104,2628,2524
7652,1,1,249,2193,1944
7653,0,0,80,0,-80
7654,1,1,1143,1212,69
7655,0,0,1,0,-1
7656,0,0,0,0,0
7657,1,1,93,1839,1746
7658,0,0,62,0,-62
7659,1,0,87,0,-87
7660,1,1,589,1862,1273
7661,1,1,412,1540,1128
7662,1,0,16,0,-16
7663,1,1,452,1285,833
7664,0,0,55,0,-55
7665,0,0,5,0,-5
7666,1,1,156,1251,1095
7667,1,0,67,0,-67
7668,1,0,18,0,-18
7669,1,0,1,0,-1
7670,0,0,87,0,-87
7671,0,0,103,0,-103
7672,1,1,824,1398,574
7673,0,0,56,0,-56
7674,1,0,125,0,-125
7675,0,0,29,0,-29
7676,1,1,63,1435,1372
7677,1,0,5,0,-5
7678,1,0,155,0,-155
7679,1,1,33,1758,1725
7680,0,0,126,0,-126
7681,1,1,131,1779,1648
7682,0,0,102,0,-102
7683,1,1,759,2478,1719
7684,1,1,73,1959,1886
7685,1,1,585,1711,1126
7686,0,0,63,0,-63
7687,0,0,15,0,-15
7688,1,1,188,1773,1585
7689,0,0,22,0,-22
7690,1,1,278,1264,986
7691,1,0,33,0,-33
7692,1,0,22,0,-22
7693,1,1,680,1241,561
7694,0,0,31,0,-31
7695,0,0,10,0,-10
7696,0,0,19,0,-19
7697,1,0,10,0,-10
7698,0,0,55,0,-55
7699,1,0,91,0,-91
7700,1,0,8,0,-8
7701,0,0,93,0,-93
7702,0,0,2,0,-2
7703,1,1,286,1237,951
7704,1,0,87,0,-87
7705,1,0,75,0,-75
7706,0,0,128,0,-128
7707,1,1,835,1519,684
7708,1,1,210,1367,1157
7709,1,0,1,0,-1
7710,1,1,151,1574,1423
7711,1,0,156,0,-156
7712,1,0,31,0,-31
7713,0,0,119,0,-119
7714,0,0,22,0,-22
7715,1,1,1106,1340,234
7716,1,1,2091,1277,-814
7717,1,0,16,0,-16
7718,0,0,46,0,-46
7719,1,0,194,0,-194
7720,0,0,46,0,-46
7721,1,0,65,0,-65
7722,0,0,34,0,-34
7723,0,0,103,0,-103
7724,1,1,194,1287,1093
7725,1,0,4,0,-4
7726,0,0,56,0,-56
7727,0,0,29,0,-29
7728,1,1,437,1311,874
7729,1,1,169,1557,1388
7730,1,0,114,0,-114
7731,1,0,1,0,-1
7732,1,0,2,0,-2
7733,1,0,139,0,-139
7734,1,1,285,1222,937
7735,1,1,156,1730,1574
7736,1,1,322,1572,1250
7737,1,1,398,1551,1153
7738,0,0,54,0,-54
7739,0,0,4,0,-4
7740,1,1,1735,1955,220
7741,1,1,1151,1257,106
7742,1,1,252,1847,1595
7743,0,0,59,0,-59
7744,1,1,621,1219,598
7745,1,0,2,0,-2
7746,1,1,337,1205,868
7747,0,0,1,0,-1
7748,0,0,67,0,-67
7749,1,0,27,0,-27
7750,0,0,13,0,-13
7751,1,0,70,0,-70
7752,1,0,5,0,-5
7753,0,0,22,0,-22
7754,0,0,10,0,-10
7755,1,0,25,0,-25
7756,1,1,594,1207,613
7757,1,0,42,0,-42
7758,1,1,626,1748,1122
7759,1,0,9,0,-9
7760,1,0,15,0,-15
7761,0,0,7,0,-7
7762,1,0,8,0,-8
7763,1,1,83,2114,2031
7764,0,0,39,0,-39
7765,1,1,2224,1293,-931
7766,1,0,21,0,-21
7767,0,0,24,0,-24
7768,0,0,29,0,-29
7769,1,1,20,1859,1839
7770,0,0,25,0,-25
7771,1,0,33,0,-33
7772,1,1,800,1757,957
7773,1,1,473,1529,1056
7774,0,0,30,0,-30
7775,1,0,177,0,-177
7776,1,1,208,1262,1054
7777,0,0,0,0,0
7778,0,0,0,0,0
7779,0,0,6,0,-6
7780,1,1,97,1291,1194
7781,0,0,7,0,-7
7782,0,0,1,0,-1
7783,1,1,657,1463,806
7784,1,1,238,2958,2720
7785,0,0,1,0,-1
7786,0,0,174,0,-174
7787,1,1,943,2531,1588
7788,1,1,327,1497,1170
7789,0,0,35,0,-35
7790,0,0,0,0,0
7791,1,0,42,0,-42
7792,1,0,56,0,-56
7793,0,0,18,0,-18
7794,0,0,49,0,-49
7795,1,0,19,0,-19
7796,1,0,46,0,-46
7797,1,1,189,1537,1348
7798,1,1,2682,1286,-1396
7799,0,0,139,0,-139
7800,1,1,1628,1212,-416
7801,1,0,52,0,-52
7802,1,0,23,0,-23
7803,1,1,54,1370,1316
7804,1,1,64,1350,1286
7805,0,0,3,0,-3
7806,1,1,404,1281,877
7807,1,1,42,2012,1970
7808,1,0,78,0,-78
7809,1,0,10,0,-10
7810,0,0,40,0,-40
7811,1,1,790,1767,977
7812,0,0,71,0,-71
7813,1,1,790,2576,1786
7814,0,0,20,0,-20
7815,1,1,244,1465,1221
7816,1,0,0,0,0
7817,0,0,44,0,-44
7818,1,0,97,0,-97
7819,1,1,162,1207,1045
7820,0,0,102,0,-102
7821,0,0,34,0,-34
7822,1,0,80,0,-80
7823,1,0,22,0,-22
7824,1,1,1575,1206,-369
7825,1,1,483,1389,906
7826,1,1,1024,1295,271
7827,0,0,95,0,-95
7828,0,0,18,0,-18
7829,1,0,9,0,-9
7830,0,0,8,0,-8
7831,1,1,657,1712,1055
7832,1,1,1131,1592,461
7833,1,1,34,1539,1505
7834,1,1,681,1293,612
7835,1,1,769,1293,524
7836,1,0,5,0,-5
7837,1,0,14,0,-14
7838,0,0,9,0,-9
7839,0,0,52,0,-52
7840,1,0,4,0,-4
7841,0,0,54,0,-54
7842,1,1,439,1279,840
7843,0,0,0,0,0
7844,0,0,25,0,-25
7845,1,0,8,0,-8
7846,1,0,10,0,-10
7847,0,0,45,0,-45
7848,1,0,64,0,-64
7849,0,0,59,0,-59
7850,1,0,4,0,-4
7851,0,0,45,0,-45
7852,0,0,54,0,-54
7853,0,0,44,0,-44
7854,0,0,93,0,-93
7855,1,1,303,1366,1063
7856,0,0,58,0,-58
7857,1,0,0,0,0
7858,1,1,69,1284,1215
7859,1,0,27,0,-27
7860,0,0,46,0,-46
7861,1,1,430,1377,947
7862,0,0,23,0,-23
7863,0,0,29,0,-29
7864,0,0,10,0,-10
7865,1,1,1022,1322,300
7866,1,1,154,1735,1581
7867,0,0,7,0,-7
7868,1,1,2824,1860,-964
7869,1,0,3,0,-3
7870,1,0,5,0,-5
7871,1,1,158,1336,1178
7872,0,0,25,0,-25
7873,1,0,33,0,-33
7874,1,0,13,0,-13
7875,0,0,56,0,-56
7876,1,1,703,1299,596
7877,1,0,89,0,-89
7878,1,1,558,2917,2359
7879,0,0,13,0,-13
7880,1,0,114,0,-114
7881,1,0,94,0,-94
7882,1,1,2065,1231,-834
7883,0,0,94,0,-94
7884,1,1,124,1253,1129
7885,1,0,67,0,-67
7886,0,0,20,0,-20
7887,1,0,10,0,-10
7888,1,1,74,2441,2367
7889,1,0,26,0,-26
7890,0,0,6,0,-6
7891,0,0,28,0,-28
7892,1,0,43,0,-43
7893,0,0,77,0,-77
7894,1,0,16,0,-16
7895,1,0,16,0,-16
7896,1,0,100,0,-100
7897,0,0,67,0,-67
7898,0,0,63,0,-63
7899,1,1,90,1206,1116
7900,0,0,58,0,-58
7901,1,0,79,0,-79
7902,1,0,13,0,-13
7903,1,1,406,1540,1134
7904,1,0,67,0,-67
7905,1,1,743,1917,1174
7906,1,0,107,0,-107
7907,1,0,33,0,-33
7908,0,0,16,0,-16
7909,1,0,68,0,-68
7910,1,1,154,2077,1923
7911,1,1,473,1235,762
7912,0,0,31,0,-31
7913,1,1,1969,1424,-545
7914,1,0,65,0,-65
7915,0,0,9,0,-9
7916,1,0,53,0,-53
7917,0,0,67,0,-67
7918,0,0,19,0,-19
7919,1,1,236,1294,1058
7920,0,0,28,0,-28
7921,0,0,56,0,-56
7922,0,0,1,0,-1
7923,1,1,233,1445,1212
7924,0,0,4,0,-4
7925,0,0,98,0,-98
7926,1,1,377,1671,1294
7927,0,0,14,0,-14
7928,0,0,143,0,-143
7929,1,0,17,0,-17
7930,1,0,40,0,-40
7931,0,0,98,0,-98
7932,1,0,3,0,-3
7933,1,0,94,0,-94
7934,1,0,0,0,0
7935,1,0,24,0,-24
7936,0,0,14,0,-14
7937,1,1,424,2099,1675
7938,1,1,172,1277,1105
7939,1,0,141,0,-141
7940,1,0,13,0,-13
7941,1,1,167,2541,2374
7942,1,0,9,0,-9
7943,1,0,11,0,-11
7944,0,0,105,0,-105
7945,0,0,50,0,-50
7946,0,0,47,0,-47
7947,1,0,9,0,-9
7948,1,0,51,0,-51
7949,0,0,60,0,-60
7950,0,0,68,0,-68
7951,1,1,165,1258,1093
7952,0,0,21,0,-21
7953,0,0,16,0,-16
7954,1,1,762,1413,651
7955,1,1,142,1266,1124
7956,1,0,26,0,-26
7957,1,1,903,1236,333
7958,0,0,41,0,-41
7959,1,0,39,0,-39
7960,0,0,7,0,-7
7961,1,1,345,1337,992
7962,1,1,81,1453,1372
7963,0,0,15,0,-15
7964,1,0,30,0,-30
7965,1,1,60,2000,1940
7966,0,0,22,0,-22
7967,0,0,70,0,-70
7968,1,0,83,0,-83
7969,1,0,30,0,-30
7970,0,0,15,0,-15
7971,1,1,528,2049,1521
7972,1,1,1480,1689,209
7973,0,0,0,0,0
7974,0,0,17,0,-17
7975,0,0,58,0,-58
7976,1,1,1233,1295,62
7977,1,0,22,0,-22
7978,0,0,35,0,-35
7979,0,0,59,0,-59
7980,1,1,702,1289,587
7981,1,1,128,2380,2252
7982,0,0,5,0,-5
7983,1,1,35,1434,1399
7984,0,0,38,0,-38
7985,1,1,79,1601,1522
7986,1,1,214,1395,1181
7987,0,0,42,0,-42
7988,1,0,24,0,-24
7989,0,0,2,0,-2
7990,1,1,424,1560,1136
7991,0,0,66,0,-66
7992,1,0,61,0,-61
7993,1,0,68,0,-68
7994,1,1,226,1361,1135
7995,1,0,12,0,-12
7996,0,0,37,0,-37
7997,1,0,68,0,-68
7998,0,0,26,0,-26
7999,1,1,982,1260,278
8000,0,0,44,0,-44
8001,1,0,25,0,-25
8002,1,1,60,1255,1195
8003,1,0,13,0,-13
8004,0,0,4,0,-4
8005,1,1,937,2658,1721
8006,1,0,69,0,-69
8007,1,0,15,0,-15
8008,0,0,2,0,-2
8009,1,0,15,0,-15
8010,1,1,1340,1905,565
8011,1,0,34,0,-34
8012,1,1,762,1809,1047
8013,0,0,8,0,-8
8014,0,0,41,0,-41
8015,0,0,9,0,-9
8016,0,0,7,0,-7
8017,1,1,150,1336,1186
8018,1,1,1323,1289,-34
8019,1,1,579,1360,781
8020,1,0,20,0,-20
8021,1,1,921,2623,1702
8022,0,0,11,0,-11
8023,1,0,20,0,-20
8024,1,1,402,1202,800
8025,1,1,682,2432,1750
8026,1,0,32,0,-32
8027,1,0,16,0,-16
8028,0,0,31,0,-31
8029,1,0,64,0,-64
8030,1,1,357,1267,910
8031,0,0,21,0,-21
8032,1,0,75,0,-75
8033,1,1,397,1525,1128
8034,1,0,9,0,-9
8035,1,1,375,1519,1144
8036,1,0,196,0,-196
8037,1,0,61,0,-61
8038,1,0,7,0,-7
8039,1,0,110,0,-110
8040,0,0,7,0,-7
8041,1,0,18,0,-18
8042,1,0,53,0,-53
8043,0,0,44,0,-44
8044,1,1,64,1559,1495
8045,1,0,16,0,-16
8046,0,0,14,0,-14
8047,1,0,10,0,-10
8048,0,0,118,0,-118
8049,0,0,169,0,-169
8050,1,0,29,0,-29
8051,1,1,1695,1741,46
8052,1,1,57,2277,2220
8053,0,0,1,0,-1
8054,1,0,8,0,-8
8055,1,1,441,1749,1308
8056,1,1,269,1271,1002
8057,1,0,2,0,-2
8058,1,0,99,0,-99
8059,0,0,6,0,-6
8060,1,1,1447,1693,246
8061,1,1,657,1254,597
8062,0,0,289,0,-289
8063,0,0,41,0,-41
8064,1,0,5,0,-5
8065,0,0,92,0,-92
8066,0,0,68,0,-68
8067,0,0,48,0,-48
8068,0,0,23,0,-23
8069,1,0,27,0,-27
8070,1,0,6,0,-6
8071,1,1,260,1272,1012
8072,1,1,755,1282,527
8073,0,0,21,0,-21
8074,0,0,32,0,-32
8075,1,1,101,1404,1303
8076,0,0,22,0,-22
8077,0,0,83,0,-83
8078,0,0,135,0,-135
8079,1,0,86,0,-86
8080,0,0,53,0,-53
8081,1,1,2007,1228,-779
8082,0,0,113,0,-113
8083,1,0,22,0,-22
8084,0,0,7,0,-7
8085,1,1,388,1264,876
8086,0,0,97,0,-97
8087,1,0,71,0,-71
8088,1,1,1462,1265,-197
8089,1,0,287,0,-287
8090,1,1,289,1971,1682
8091,1,0,14,0,-14
8092,0,0,162,0,-162
8093,0,0,32,0,-32
8094,0,0,36,0,-36
8095,1,0,59,0,-59
8096,1,1,62,1334,1272
8097,1,1,84,1678,1594
8098,1,1,260,1201,941
8099,1,0,16,0,-16
8100,0,0,28,0,-28
8101,1,1,117,1299,1182
8102,1,0,83,0,-83
8103,0,0,31,0,-31
8104,1,1,445,1283,838
8105,0,0,71,0,-71
8106,0,0,29,0,-29
8107,0,0,14,0,-14
8108,0,0,115,0,-115
8109,1,0,12,0,-12
8110,0,0,27,0,-27
8111,1,1,853,1412,559
8112,1,1,858,1304,446
8113,1,1,46,1316,1270
8114,1,1,307,1431,1124
8115,0,0,7,0,-7
8116,1,0,20,0,-20
8117,0,0,3,0,-3
8118,1,1,36,1283,1247
8119,0,0,26,0,-26
8120,0,0,30,0,-30
8121,0,0,26,0,-26
8122,0,0,25,0,-25
8123,1,1,16,1512,1496
8124,1,0,5,0,-5
8125,0,0,88,0,-88
8126,1,0,5,0,-5
8127,1,0,132,0,-132
8128,0,0,28,0,-28
8129,1,0,23,0,-23
8130,1,0,7,0,-7
8131,1,1,1404,1298,-106
8132,1,1,553,1670,1117
8133,0,0,109,0,-109
8134,0,0,2,0,-2
8135,0,0,0,0,0
8136,1,0,9,0,-9
8137,1,1,786,1671,885
8138,0,0,124,0,-124
8139,1,1,1482,1279,-203
8140,0,0,17,0,-17
8141,1,0,82,0,-82
8142,0,0,20,0,-20
8143,1,0,20,0,-20
8144,1,1,347,1395,1048
8145,1,1,353,1382,1029
8146,1,1,620,1668,1048
8147,0,0,11,0,-11
8148,1,1,388,1227,839
8149,0,0,45,0,-45
8150,1,0,106,0,-106
8151,0,0,39,0,-39
8152,1,0,33,0,-33
8153,0,0,55,0,-55
8154,1,1,18,1755,1737
8155,1,0,8,0,-8
8156,1,1,72,1496,1424
8157,0,0,4,0,-4
8158,0,0,7,0,-7
8159,1,1,445,1221,776
8160,1,0,6,0,-6
8161,0,0,48,0,-48
8162,0,0,54,0,-54
8163,1,1,200,1346,1146
8164,0,0,94,0,-94
8165,0,0,63,0,-63
8166,0,0,93,0,-93
8167,0,0,25,0,-25
8168,1,0,43,0,-43
8169,0,0,60,0,-60
8170,1,1,527,1561,1034
8171,1,1,136,1567,1431
8172,0,0,89,0,-89
8173,1,1,200,1231,1031
8174,1,0,50,0,-50
8175,0,0,5,0,-5
8176,1,1,788,2034,1246
8177,0,0,83,0,-83
8178,1,1,548,1627,1079
8179,1,0,83,0,-83
8180,1,1,271,1645,1374
8181,1,1,88,1287,1199
8182,0,0,52,0,-52
8183,1,0,29,0,-29
8184,0,0,34,0,-34
8185,1,0,29,0,-29
8186,0,0,3,0,-3
8187,0,0,8,0,-8
8188,0,0,14,0,-14
8189,0,0,30,0,-30
8190,1,0,9,0,-9
8191,1,1,681,1275,594
8192,0,0,59,0,-59
8193,0,0,88,0,-88
8194,0,0,9,0,-9
8195,1,0,64,0,-64
8196,0,0,62,0,-62
8197,1,1,58,1315,1257
8198,1,1,149,2353,2204
8199,1,0,60,0,-60
8200,1,0,116,0,-116
8201,1,1,488,2185,1697
8202,0,0,15,0,-15
8203,0,0,12,0,-12
8204,0,0,67,0,-67
8205,1,0,22,0,-22
8206,1,1,2891,1874,-1017
8207,0,0,13,0,-13
8208,0,0,17,0,-17
8209,0,0,35,0,-35
8210,0,0,124,0,-124
8211,1,0,87,0,-87
8212,1,1,711,1353,642
8213,1,0,8,0,-8
8214,1,0,70,0,-70
8215,0,0,12,0,-12
8216,0,0,36,0,-36
8217,0,0,134,0,-134
8218,1,0,107,0,-107
8219,1,1,485,1220,735
8220,0,0,86,0,-86
8221,1,1,370,1223,853
8222,1,0,55,0,-55
8223,1,0,13,0,-13
8224,1,0,20,0,-20
8225,1,0,0,0,0
8226,0,0,24,0,-24
8227,0,0,8,0,-8
8228,1,0,38,0,-38
8229,1,0,18,0,-18
8230,0,0,29,0,-29
8231,1,0,65,0,-65
8232,0,0,29,0,-29
8233,0,0,85,0,-85
8234,1,0,12,0,-12
8235,1,1,334,1310,976
8236,1,1,658,1218,560
8237,1,1,416,1369,953
8238,1,1,291,3069,2778
8239,1,1,432,1256,824
8240,1,1,421,1669,1248
8241,1,1,1700,1618,-82
8242,1,1,180,1217,1037
8243,1,0,127,0,-127
8244,1,1,1323,1919,596
8245,1,0,39,0,-39
8246,0,0,26,0,-26
8247,0,0,106,0,-106
8248,1,1,558,1215,657
8249,1,1,475,2109,1634
8250,1,1,807,1287,480
8251,0,0,260,0,-260
8252,1,0,2,0,-2
8253,1,0,18,0,-18
8254,0,0,38,0,-38
8255,1,0,16,0,-16
8256,1,0,110,0,-110
8257,1,0,79,0,-79
8258,1,1,93,1240,1147
8259,0,0,96,0,-96
8260,1,1,656,1310,654
8261,1,0,48,0,-48
8262,1,0,3,0,-3
8263,0,0,32,0,-32
8264,1,1,745,1262,517
8265,0,0,44,0,-44
8266,0,0,19,0,-19
8267,1,0,25,0,-25
8268,0,0,119,0,-119
8269,0,0,62,0,-62
8270,1,1,522,1220,698
8271,0,0,43,0,-43
8272,0,0,125,0,-125
8273,1,1,377,1743,1366
8274,1,1,415,1484,1069
8275,0,0,24,0,-24
8276,0,0,30,0,-30
8277,0,0,23,0,-23
8278,1,0,75,0,-75
8279,0,0,2,0,-2
8280,1,0,79,0,-79
8281,0,0,16,0,-16
8282,0,0,180,0,-180
8283,0,0,127,0,-127
8284,0,0,55,0,-55
8285,1,1,162,1330,1168
8286,1,1,1080,1697,617
8287,0,0,31,0,-31
8288,1,0,1,0,-1
8289,0,0,23,0,-23
8290,0,0,6,0,-6
8291,1,0,11,0,-11
8292,1,0,10,0,-10
8293,0,0,15,0,-15
8294,0,0,26,0,-26
8295,1,1,270,1313,1043
8296,0,0,20,0,-20
8297,0,0,93,0,-93
8298,1,0,120,0,-120
8299,0,0,98,0,-98
8300,0,0,108,0,-108
8301,0,0,109,0,-109
8302,0,0,30,0,-30
8303,1,0,2,0,-2
8304,1,0,65,0,-65
8305,1,0,2,0,-2
8306,1,1,530,1257,727
8307,1,0,180,0,-180
8308,1,1,1143,1489,346
8309,0,0,183,0,-183
8310,1,0,2,0,-2
8311,1,1,478,1372,894
8312,1,1,244,1285,1041
8313,0,0,21,0,-21
8314,1,1,76,1200,1124
8315,1,0,37,0,-37
8316,0,0,59,0,-59
8317,0,0,62,0,-62
8318,1,0,92,0,-92
8319,1,0,186,0,-186
8320,1,1,274,1379,1105
8321,0,0,34,0,-34
8322,1,0,71,0,-71
8323,0,0,93,0,-93
8324,1,1,761,1337,576
8325,1,1,846,1951,1105
8326,1,1,240,1475,1235
8327,0,0,17,0,-17
8328,0,0,4,0,-4
8329,1,0,145,0,-145
8330,1,0,44,0,-44
8331,1,0,120,0,-120
8332,0,0,26,0,-26
8333,1,0,105,0,-105
8334,1,0,67,0,-67
8335,0,0,4,0,-4
8336,1,0,132,0,-132
8337,1,1,367,1290,923
8338,0,0,30,0,-30
8339,1,0,71,0,-71
8340,0,0,110,0,-110
8341,1,1,408,1433,1025
8342,0,0,13,0,-13
8343,1,1,279,1733,1454
8344,0,0,4,0,-4
8345,1,0,59,0,-59
8346,1,0,8,0,-8
8347,0,0,1,0,-1
8348,0,0,11,0,-11
8349,0,0,18,0,-18
8350,1,1,602,1319,717
8351,1,1,380,1868,1488
8352,1,1,453,2613,2160
8353,0,0,32,0,-32
8354,1,1,734,1313,579
8355,0,0,24,0,-24
8356,1,0,90,0,-90
8357,1,1,371,2875,2504
8358,0,0,6,0,-6
8359,0,0,14,0,-14
8360,1,1,788,1267,479
8361,0,0,5,0,-5
8362,0,0,2,0,-2
8363,1,1,413,1488,1075
8364,0,0,39,0,-39
8365,0,0,27,0,-27
8366,1,0,57,0,-57
8367,1,0,13,0,-13
8368,1,0,19,0,-19
8369,0,0,73,0,-73
8370,1,1,153,1216,1063
8371,1,0,22,0,-22
8372,1,0,27,0,-27
8373,1,1,1994,1514,-480
8374,1,0,195,0,-195
8375,0,0,17,0,-17
8376,0,0,84,0,-84
8377,1,1,268,2648,2380
8378,1,0,0,0,0
8379,1,1,237,1278,1041
8380,1,1,671,1290,619
8381,0,0,3,0,-3
8382,1,0,49,0,-49
8383,1,0,10,0,-10
8384,0,0,45,0,-45
8385,0,0,50,0,-50
8386,1,1,346,1284,938
8387,0,0,56,0,-56
8388,1,0,77,0,-77
8389,0,0,4,0,-4
8390,1,0,32,0,-32
8391,0,0,0,0,0
8392,1,0,11,0,-11
8393,1,1,117,1227,1110
8394,1,0,107,0,-107
8395,0,0,27,0,-27
8396,1,1,221,1296,1075
8397,1,1,1296,1284,-12
8398,1,1,409,1492,1083
8399,1,0,68,0,-68
8400,0,0,17,0,-17
8401,0,0,40,0,-40
8402,0,0,81,0,-81
8403,1,0,29,0,-29
8404,0,0,20,0,-20
8405,0,0,14,0,-14
8406,1,1,1369,1533,164
8407,0,0,64,0,-64
8408,1,1,1449,2390,941
8409,1,1,722,1436,714
8410,0,0,23,0,-23
8411,1,0,8,0,-8
8412,0,0,71,0,-71
8413,1,0,102,0,-102
8414,1,0,88,0,-88
8415,0,0,6,0,-6
8416,1,1,50,1219,1169
8417,1,1,3652,1258,-2394
8418,1,1,321,1369,1048
8419,1,1,113,1993,1880
8420,0,0,38,0,-38
8421,1,0,36,0,-36
8422,1,0,92,0,-92
8423,1,0,72,0,-72
8424,1,1,244,1212,968
8425,0,0,110,0,-110
8426,1,1,1043,1658,615
8427,0,0,28,0,-28
8428,1,0,19,0,-19
8429,0,0,70,0,-70
8430,1,0,28,0,-28
8431,1,1,255,1318,1063
8432,1,0,40,0,-40
8433,1,0,53,0,-53
8434,1,1,318,2067,1749
8435,0,0,31,0,-31
8436,0,0,12,0,-12
8437,1,0,261,0,-261
8438,1,0,151,0,-151
8439,1,1,172,1845,1673
8440,0,0,9,0,-9
8441,1,0,112,0,-112
8442,1,0,6,0,-6
8443,1,1,141,1354,1213
8444,0,0,26,0,-26
8445,0,0,138,0,-138
8446,1,1,890,1621,731
8447,1,1,159,1445,1286
8448,1,1,594,1648,1054
8449,1,0,42,0,-42
8450,0,0,7,0,-7
8451,1,1,539,1243,704
8452,0,0,38,0,-38
8453,1,1,875,1443,568
8454,1,0,3,0,-3
8455,1,1,1291,1212,-79
8456,1,1,1252,1917,665
8457,0,0,15,0,-15
8458,1,1,261,1420,1159
8459,1,1,668,1251,583
8460,1,0,98,0,-98
8461,0,0,60,0,-60
8462,1,1,494,1227,733
8463,0,0,83,0,-83
8464,1,1,349,2256,1907
8465,0,0,78,0,-78
8466,0,0,0,0,0
8467,1,0,12,0,-12
8468,0,0,22,0,-22
8469,0,0,26,0,-26
8470,0,0,57,0,-57
8471,1,0,144,0,-144
8472,1,0,29,0,-29
8473,1,0,38,0,-38
8474,0,0,19,0,-19
8475,1,0,11,0,-11
8476,0,0,7,0,-7
8477,0,0,52,0,-52
8478,1,0,61,0,-61
8479,1,0,55,0,-55
8480,0,0,82,0,-82
8481,1,0,20,0,-20
8482,0,0,23,0,-23
8483,1,0,181,0,-181
8484,1,1,264,1562,1298
8485,1,0,198,0,-198
8486,1,0,59,0,-59
8487,0,0,64,0,-64
8488,0,0,66,0,-66
8489,1,1,74,1637,1563
8490,1,0,57,0,-57
8491,0,0,35,0,-35
8492,1,1,743,1248,505
8493,1,0,18,0,-18
8494,1,1,186,2199,2013
8495,0,0,20,0,-20
8496,0,0,40,0,-40
8497,0,0,16,0,-16
8498,0,0,13,0,-13
8499,1,0,61,0,-61
8500,0,0,91,0,-91
8501,1,1,247,1560,1313
8502,1,0,6,0,-6
8503,0,0,51,0,-51
8504,0,0,15,0,-15
8505,0,0,122,0,-122
8506,1,0,8,0,-8
8507,1,0,41,0,-41
8508,1,0,95,0,-95
8509,1,1,349,1607,1258
8510,0,0,52,0,-52
8511,0,0,23,0,-23
8512,0,0,85,0,-85
8513,1,0,19,0,-19
8514,1,0,389,0,-389
8515,1,1,298,2966,2668
8516,1,1,1043,2957,1914
8517,1,0,24,0,-24
8518,1,0,5,0,-5
8519,0,0,34,0,-34
8520,1,1,245,1450,1205
8521,1,0,63,0,-63
8522,1,1,577,1299,722
8523,0,0,9,0,-9
8524,0,0,33,0,-33
8525,0,0,101,0,-101
8526,0,0,159,0,-159
8527,1,1,264,1298,1034
8528,0,0,3,0,-3
8529,1,1,329,1304,975
8530,0,0,115,0,-115
8531,0,0,28,0,-28
8532,0,0,35,0,-35
8533,1,0,209,0,-209
8534,1,0,5,0,-5
8535,1,1,2265,1623,-642
8536,1,0,17,0,-17
8537,1,0,43,0,-43
8538,0,0,19,0,-19
8539,1,1,1600,1881,281
8540,1,0,28,0,-28
8541,0,0,25,0,-25
8542,1,0,15,0,-15
8543,0,0,39,0,-39
8544,1,1,528,1263,735
8545,0,0,3,0,-3
8546,0,0,36,0,-36
8547,1,0,69,0,-69
8548,0,0,5,0,-5
8549,1,1,1033,1586,553
8550,1,1,1740,1843,103
8551,1,0,51,0,-51
8552,1,1,447,1234,787
8553,0,0,0,0,0
8554,0,0,11,0,-11
8555,0,0,6,0,-6
8556,1,0,99,0,-99
8557,0,0,5,0,-5
8558,1,1,55,1455,1400
8559,0,0,19,0,-19
8560,1,1,608,1467,859
8561,1,0,120,0,-120
8562,1,1,177,2761,2584
8563,1,0,9,0,-9
8564,1,1,710,1700,990
8565,1,1,119,1518,1399
8566,1,0,97,0,-97
8567,1,1,1045,1201,156
8568,1,1,1014,4442,3428
8569,0,0,17,0,-17
8570,0,0,70,0,-70
8571,0,0,68,0,-68
8572,1,1,52,1307,1255
8573,1,1,63,1270,1207
8574,0,0,18,0,-18
8575,0,0,21,0,-21
8576,1,1,665,1261,596
8577,1,1,185,1671,1486
8578,1,0,51,0,-51
8579,1,0,25,0,-25
8580,0,0,13,0,-13
8581,0,0,2,0,-2
8582,1,1,56,1237,1181
8583,0,0,117,0,-117
8584,1,0,5,0,-5
8585,1,1,153,2244,2091
8586,1,0,15,0,-15
8587,1,0,30,0,-30
8588,1,1,254,1606,1352
8589,1,1,465,1577,1112
8590,0,0,11,0,-11
8591,1,0,77,0,-77
8592,0,0,53,0,-53
8593,1,1,1017,1217,200
8594,1,0,1,0,-1
8595,1,0,9,0,-9
8596,0,0,93,0,-93
8597,1,0,1,0,-1
8598,1,0,46,0,-46
8599,0,0,84,0,-84
8600,1,1,168,1345,1177
8601,1,0,41,0,-41
8602,0,0,42,0,-42
8603,1,0,23,0,-23
8604,1,1,503,1412,909
8605,1,1,711,1366,655
8606,1,1,143,1296,1153
8607,1,0,21,0,-21
8608,1,0,11,0,-11
8609,1,0,16,0,-16
8610,0,0,63,0,-63
8611,1,1,12,1766,1754
8612,1,0,1,0,-1
8613,1,1,436,1581,1145
8614,1,0,73,0,-73
8615,0,0,11,0,-11
8616,0,0,44,0,-44
8617,1,1,207,1431,1224
8618,0,0,1,0,-1
8619,0,0,29,0,-29
8620,1,0,5,0,-5
8621,1,0,49,0,-49
8622,1,1,152,2054,1902
8623,0,0,47,0,-47
8624,0,0,32,0,-32
8625,0,0,107,0,-107
8626,1,0,63,0,-63
8627,0,0,14,0,-14
8628,0,0,339,0,-339
8629,1,1,100,1239,1139
8630,0,0,24,0,-24
8631,1,0,4,0,-4
8632,1,0,11,0,-11
8633,1,1,2583,2347,-236
8634,1,1,83,1317,1234
8635,0,0,33,0,-33
8636,0,0,117,0,-117
8637,1,0,57,0,-57
8638,1,1,90,1370,1280
8639,0,0,29,0,-29
8640,1,0,77,0,-77
8641,1,1,622,1214,592
8642,1,0,9,0,-9
8643,1,1,422,1242,820
8644,1,1,507,1203,696
8645,0,0,157,0,-157
8646,1,1,781,1262,481
8647,1,0,8,0,-8
8648,1,0,90,0,-90
8649,0,0,141,0,-141
8650,0,0,4,0,-4
8651,0,0,14,0,-14
8652,0,0,32,0,-32
8653,1,0,18,0,-18
8654,1,1,861,1219,358
8655,0,0,13,0,-13
8656,0,0,17,0,-17
8657,1,1,115,1497,1382
8658,1,0,68,0,-68
8659,0,0,8,0,-8
8660,0,0,1,0,-1
8661,0,0,110,0,-110
8662,0,0,93,0,-93
8663,1,0,2,0,-2
8664,1,0,44,0,-44
8665,1,0,38,0,-38
8666,1,1,858,1508,650
8667,1,0,52,0,-52
8668,1,0,24,0,-24
8669,1,0,53,0,-53
8670,1,0,21,0,-21
8671,1,1,399,2557,2158
8672,0,0,6,0,-6
8673,1,1,1137,1639,502
8674,0,0,53,0,-53
8675,0,0,0,0,0
8676,0,0,27,0,-27
8677,1,1,199,1726,1527
8678,0,0,11,0,-11
8679,0,0,83,0,-83
8680,1,1,461,1409,948
8681,0,0,107,0,-107
8682,1,1,241,1274,1033
8683,1,1,424,2117,1693
8684,0,0,71,0,-71
8685,1,1,773,1296,523
8686,0,0,4,0,-4
8687,1,0,59,0,-59
8688,0,0,20,0,-20
8689,1,0,52,0,-52
8690,0,0,48,0,-48
8691,1,0,4,0,-4
8692,0,0,10,0,-10
8693,0,0,52,0,-52
8694,1,0,18,0,-18
8695,1,0,54,0,-54
8696,1,0,13,0,-13
8697,1,1,222,1793,1571
8698,1,1,144,1249,1105
8699,1,0,86,0,-86
8700,1,1,174,1323,1149
8701,1,0,84,0,-84
8702,0,0,85,0,-85
8703,1,1,283,1797,1514
8704,0,0,55,0,-55
8705,1,0,94,0,-94
8706,1,1,520,1477,957
8707,0,0,32,0,-32
8708,0,0,94,0,-94
8709,0,0,48,0,-48
8710,1,0,62,0,-62
8711,1,0,7,0,-7
8712,1,1,540,1767,1227
8713,0,0,54,0,-54
8714,1,1,524,1357,833
8715,1,0,1,0,-1
8716,0,0,33,0,-33
8717,0,0,77,0,-77
8718,0,0,29,0,-29
8719,1,0,30,0,-30
8720,1,1,891,1376,485
8721,1,1,173,1493,1320
8722,1,1,178,1495,1317
8723,1,0,10,0,-10
8724,1,0,2,0,-2
8725,1,0,36,0,-36
8726,1,0,0,0,0
8727,1,0,79,0,-79
8728,1,1,1141,2006,865
8729,0,0,132,0,-132
8730,0,0,1,0,-1
8731,0,0,103,0,-103
8732,0,0,2,0,-2
8733,1,0,32,0,-32
8734,1,0,167,0,-167
8735,1,0,3,0,-3
8736,1,0,66,0,-66
8737,0,0,53,0,-53
8738,1,0,32,0,-32
8739,0,0,8,0,-8
8740,0,0,72,0,-72
8741,1,0,80,0,-80
8742,0,0,68,0,-68
8743,1,1,29,4750,4721
8744,1,1,697,1269,572
8745,0,0,12,0,-12
8746,0,0,10,0,-10
8747,1,1,894,1641,747
8748,0,0,4,0,-4
8749,1,1,388,1822,1434
8750,0,0,23,0,-23
8751,1,1,111,1269,1158
8752,0,0,100,0,-100
8753,1,0,84,0,-84
8754,1,0,11,0,-11
8755,1,1,796,1337,541
8756,0,0,17,0,-17
8757,1,1,199,1456,1257
8758,1,0,1,0,-1
8759,0,0,8,0,-8
8760,0,0,7,0,-7
8761,1,0,28,0,-28
8762,1,0,14,0,-14
8763,0,0,4,0,-4
8764,1,0,37,0,-37
8765,1,1,359,1212,853
8766,1,0,77,0,-77
8767,0,0,75,0,-75
8768,0,0,22,0,-22
8769,1,1,672,2145,1473
8770,1,0,111,0,-111
8771,0,0,56,0,-56
8772,1,0,3,0,-3
8773,0,0,21,0,-21
8774,1,0,137,0,-137
8775,0,0,9,0,-9
8776,1,1,301,1531,1230
8777,1,0,3,0,-3
8778,1,0,92,0,-92
8779,1,0,10,0,-10
8780,1,0,19,0,-19
8781,0,0,23,0,-23
8782,0,0,13,0,-13
8783,0,0,6,0,-6
8784,1,0,93,0,-93
8785,1,0,28,0,-28
8786,0,0,49,0,-49
8787,1,0,46,0,-46
8788,0,0,44,0,-44
8789,1,0,0,0,0
8790,1,1,473,1233,760
8791,1,1,61,1638,1577
8792,1,0,31,0,-31
8793,1,1,717,1383,666
8794,0,0,55,0,-55
8795,0,0,21,0,-21
8796,1,0,15,0,-15
8797,1,1,592,2395,1803
8798,0,0,48,0,-48
8799,0,0,117,0,-117
8800,0,0,76,0,-76
8801,1,1,678,1278,600
8802,0,0,12,0,-12
8803,1,0,16,0,-16
8804,0,0,64,0,-64
8805,1,0,74,0,-74
8806,1,0,16,0,-16
8807,0,0,117,0,-117
8808,1,0,56,0,-56
8809,1,1,176,1249,1073
8810,1,1,396,1547,1151
8811,1,0,32,0,-32
8812,1,0,44,0,-44
8813,0,0,21,0,-21
8814,1,1,240,1217,977
8815,1,0,23,0,-23
8816,0,0,77,0,-77
8817,0,0,18,0,-18
8818,1,0,6,0,-6
8819,1,0,194,0,-194
8820,0,0,41,0,-41
8821,1,0,5,0,-5
8822,1,1,336,1359,1023
8823,0,0,99,0,-99
8824,1,0,21,0,-21
8825,1,1,225,1460,1235
8826,1,1,898,1669,771
8827,1,0,29,0,-29
8828,0,0,17,0,-17
8829,0,0,10,0,-10
8830,1,0,25,0,-25
8831,1,1,582,1656,1074
8832,0,0,0,0,0
8833,0,0,21,0,-21
8834,0,0,278,0,-278
8835,0,0,0,0,0
8836,1,0,13,0,-13
8837,0,0,3,0,-3
8838,0,0,15,0,-15
8839,1,0,44,0,-44
8840,1,1,323,1216,893
8841,1,0,16,0,-16
8842,1,0,2,0,-2
8843,0,0,95,0,-95
8844,0,0,23,0,-23
8845,0,0,6,0,-6
8846,1,1,767,1283,516
8847,0,0,26,0,-26
8848,1,0,28,0,-28
8849,1,0,130,0,-130
8850,0,0,36,0,-36
8851,1,1,1227,1264,37
8852,0,0,9,0,-9
8853,1,1,1178,1399,221
8854,1,1,715,2088,1373
8855,0,0,22,0,-22
8856,1,1,295,1410,1115
8857,0,0,108,0,-108
8858,1,1,115,1280,1165
8859,1,0,4,0,-4
8860,1,0,4,0,-4
8861,1,0,33,0,-33
8862,0,0,64,0,-64
8863,0,0,49,0,-49
8864,0,0,9,0,-9
8865,0,0,5,0,-5
8866,0,0,34,0,-34
8867,1,1,105,1225,1120
8868,1,1,204,1206,1002
8869,0,0,179,0,-179
8870,0,0,95,0,-95
8871,0,0,45,0,-45
8872,1,1,976,1296,320
8873,0,0,5,0,-5
8874,1,1,2104,1227,-877
8875,0,0,61,0,-61
8876,1,0,28,0,-28
8877,1,0,17,0,-17
8878,0,0,45,0,-45
8879,1,0,57,0,-57
8880,1,1,300,1590,1290
8881,0,0,6,0,-6
8882,0,0,51,0,-51
8883,0,0,64,0,-64
8884,0,0,25,0,-25
8885,0,0,3,0,-3
8886,0,0,45,0,-45
8887,0,0,6,0,-6
8888,1,0,127,0,-127
8889,0,0,22,0,-22
8890,1,0,51,0,-51
8891,0,0,7,0,-7
8892,0,0,14,0,-14
8893,0,0,10,0,-10
8894,0,0,7,0,-7
8895,1,0,32,0,-32
8896,1,1,93,2191,2098
8897,1,1,673,1303,630
8898,1,1,29,2151,2122
8899,0,0,17,0,-17
8900,1,1,247,1584,1337
8901,1,1,152,1617,1465
8902,1,0,152,0,-152
8903,0,0,106,0,-106
8904,0,0,104,0,-104
8905,1,0,59,0,-59
8906,1,1,1406,3182,1776
8907,0,0,30,0,-30
8908,0,0,73,0,-73
8909,0,0,87,0,-87
8910,0,0,83,0,-83
8911,0,0,12,0,-12
8912,1,0,158,0,-158
8913,0,0,5,0,-5
8914,1,1,378,1205,827
8915,0,0,22,0,-22
8916,1,1,909,1217,308
8917,1,1,487,1283,796
8918,0,0,51,0,-51
8919,0,0,130,0,-130
8920,0,0,200,0,-200
8921,0,0,9,0,-9
8922,0,0,76,0,-76
8923,0,0,80,0,-80
8924,1,1,194,1586,1392
8925,1,1,36,1460,1424
8926,1,1,674,1674,1000
8927,1,0,43,0,-43
8928,0,0,192,0,-192
8929,1,1,922,1226,304
8930,0,0,70,0,-70
8931,1,1,71,2033,1962
8932,1,1,984,1213,229
8933,0,0,29,0,-29
8934,0,0,1,0,-1
8935,1,1,185,1326,1141
8936,1,0,11,0,-11
8937,1,0,17,0,-17
8938,0,0,30,0,-30
8939,1,1,435,1277,842
8940,1,1,403,1482,1079
8941,0,0,24,0,-24
8942,1,0,41,0,-41
8943,0,0,85,0,-85
8944,0,0,119,0,-119
8945,0,0,13,0,-13
8946,0,0,21,0,-21
8947,1,1,436,1469,1033
8948,1,0,12,0,-12
8949,0,0,33,0,-33
8950,0,0,3,0,-3
8951,0,0,44,0,-44
8952,1,1,98,1287,1189
8953,1,1,339,1680,1341
8954,1,1,723,1413,690
8955,1,0,0,0,0
8956,0,0,41,0,-41
8957,1,1,1592,2229,637
8958,0,0,43,0,-43
8959,1,1,388,1483,1095
8960,0,0,13,0,-13
8961,0,0,31,0,-31
8962,1,1,423,2590,2167
8963,1,0,24,0,-24
8964,1,1,147,1764,1617
8965,1,1,562,1302,740
8966,1,1,149,1262,1113
8967,1,1,715,2019,1304
8968,1,0,8,0,-8
8969,0,0,5,0,-5
8970,1,1,726,1318,592
8971,1,1,504,2039,1535
8972,0,0,21,0,-21
8973,0,0,115,0,-115
8974,0,0,15,0,-15
8975,1,1,839,1208,369
8976,0,0,2,0,-2
8977,0,0,65,0,-65
8978,0,0,5,0,-5
8979,0,0,79,0,-79
8980,1,0,75,0,-75
8981,1,0,211,0,-211
8982,1,0,15,0,-15
8983,0,0,7,0,-7
8984,0,0,210,0,-210
8985,0,0,30,0,-30
8986,1,1,243,1251,1008
8987,0,0,152,0,-152
8988,1,0,106,0,-106
8989,1,1,385,1296,911
8990,1,0,11,0,-11
8991,1,1,173,1544,1371
8992,0,0,2,0,-2
8993,1,1,116,2480,2364
8994,0,0,96,0,-96
8995,1,0,45,0,-45
8996,1,0,86,0,-86
8997,1,1,269,1211,942
8998,0,0,116,0,-116
8999,1,1,1842,1710,-132
9000,1,1,1300,1269,-31
9001,1,0,16,0,-16
9002,0,0,171,0,-171
9003,1,0,59,0,-59
9004,0,0,21,0,-21
9005,0,0,1,0,-1
9006,1,0,61,0,-61
9007,1,1,437,1977,1540
9008,1,0,116,0,-116
9009,1,1,103,2984,2881
9010,1,0,45,0,-45
9011,0,0,27,0,-27
9012,1,0,90,0,-90
9013,0,0,58,0,-58
9014,0,0,11,0,-11
9015,1,1,308,1288,980
9016,0,0,32,0,-32
9017,0,0,53,0,-53
9018,1,1,220,1750,1530
9019,1,0,19,0,-19
9020,1,0,52,0,-52
9021,0,0,30,0,-30
9022,1,1,715,1587,872
9023,0,0,29,0,-29
9024,1,1,305,1490,1185
9025,1,1,976,1252,276
9026,0,0,111,0,-111
9027,1,1,457,2124,1667
9028,1,1,592,1278,686
9029,1,1,272,1418,1146
9030,1,1,937,1539,602
9031,1,0,2,0,-2
9032,1,0,36,0,-36
9033,0,0,51,0,-51
9034,0,0,2,0,-2
9035,0,0,44,0,-44
9036,1,1,220,1311,1091
9037,0,0,149,0,-149
9038,1,1,125,1982,1857
9039,0,0,31,0,-31
9040,1,0,2,0,-2
9041,1,1,781,1627,846
9042,0,0,4,0,-4
9043,1,0,85,0,-85
9044,0,0,14,0,-14
9045,1,1,504,1922,1418
9046,0,0,9,0,-9
9047,1,0,13,0,-13
9048,1,1,648,1871,1223
9049,1,0,10,0,-10
9050,1,0,11,0,-11
9051,1,0,101,0,-101
9052,1,1,553,1480,927
9053,0,0,36,0,-36
9054,1,1,66,1240,1174
9055,0,0,102,0,-102
9056,0,0,35,0,-35
9057,1,0,30,0,-30
9058,0,0,117,0,-117
9059,1,0,5,0,-5
9060,0,0,96,0,-96
9061,0,0,23,0,-23
9062,0,0,220,0,-220
9063,1,1,726,1213,487
9064,0,0,28,0,-28
9065,0,0,70,0,-70
9066,1,0,10,0,-10
9067,1,1,278,2902,2624
9068,1,1,212,1897,1685
9069,1,0,0,0,0
9070,0,0,13,0,-13
9071,1,0,2,0,-2
9072,1,0,3,0,-3
9073,0,0,49,0,-49
9074,1,0,53,0,-53
9075,1,1,494,1285,791
9076,1,1,644,1325,681
9077,0,0,3,0,-3
9078,1,1,403,1330,927
9079,1,0,9,0,-9
9080,0,0,105,0,-105
9081,1,0,8,0,-8
9082,1,1,153,1537,1384
9083,1,1,421,1919,1498
9084,1,0,37,0,-37
9085,0,0,9,0,-9
9086,1,0,8,0,-8
9087,1,0,38,0,-38
9088,1,0,14,0,-14
9089,1,0,36,0,-36
9090,0,0,69,0,-69
9091,1,1,690,2046,1356
9092,0,0,65,0,-65
9093,1,1,208,2758,2550
9094,0,0,220,0,-220
9095,0,0,7,0,-7
9096,0,0,77,0,-77
9097,1,0,30,0,-30
9098,1,0,66,0,-66
9099,1,0,74,0,-74
9100,1,0,45,0,-45
9101,0,0,66,0,-66
9102,0,0,71,0,-71
9103,1,0,209,0,-209
9104,0,0,21,0,-21
9105,0,0,77,0,-77
9106,1,1,196,1250,1054
9107,0,0,150,0,-150
9108,1,0,18,0,-18
9109,1,1,600,1517,917
9110,1,1,395,1395,1000
9111,1,1,838,1492,654
9112,1,1,1184,1694,510
9113,0,0,3,0,-3
9114,1,1,272,1283,1011
9115,1,0,107,0,-107
9116,0,0,200,0,-200
9117,0,0,5,0,-5
9118,1,0,11,0,-11
9119,1,1,116,2152,2036
9120,0,0,219,0,-219
9121,1,1,77,1395,1318
9122,0,0,21,0,-21
9123,1,1,23,1258,1235
9124,1,1,247,1263,1016
9125,0,0,12,0,-12
9126,1,0,5,0,-5
9127,1,1,830,2194,1364
9128,0,0,8,0,-8
9129,0,0,51,0,-51
9130,0,0,5,0,-5
9131,0,0,110,0,-110
9132,1,1,1051,1279,228
9133,1,1,739,2969,2230
9134,1,0,7,0,-7
9135,1,1,456,2251,1795
9136,1,1,919,1308,389
9137,1,0,55,0,-55
9138,1,1,150,1229,1079
9139,0,0,71,0,-71
9140,1,1,74,1317,1243
9141,0,0,13,0,-13
9142,0,0,132,0,-132
9143,1,1,1161,1360,199
9144,1,1,349,2010,1661
9145,1,1,446,1378,932
9146,0,0,87,0,-87
9147,0,0,29,0,-29
9148,1,1,154,1657,1503
9149,1,0,11,0,-11
9150,0,0,60,0,-60
9151,1,0,42,0,-42
9152,1,1,123,1242,1119
9153,1,1,388,1519,1131
9154,1,0,42,0,-42
9155,0,0,5,0,-5
9156,1,0,132,0,-132
9157,1,1,233,1551,1318
9158,1,1,1419,1281,-138
9159,1,0,71,0,-71
9160,1,1,308,1309,1001
9161,0,0,7,0,-7
9162,0,0,45,0,-45
9163,1,1,87,1269,1182
9164,1,1,63,3434,3371
9165,0,0,64,0,-64
9166,1,0,107,0,-107
9167,1,1,2965,1321,-1644
9168,1,0,182,0,-182
9169,1,1,1151,1386,235
9170,0,0,50,0,-50
9171,1,0,69,0,-69
9172,1,1,398,1476,1078
9173,1,1,412,1646,1234
9174,0,0,253,0,-253
9175,0,0,4,0,-4
9176,0,0,58,0,-58
9177,0,0,22,0,-22
9178,0,0,114,0,-114
9179,1,0,72,0,-72
9180,0,0,7,0,-7
9181,1,1,137,1288,1151
9182,1,0,260,0,-260
9183,1,0,35,0,-35
9184,0,0,62,0,-62
9185,1,0,14,0,-14
9186,1,0,18,0,-18
9187,0,0,15,0,-15
9188,0,0,156,0,-156
9189,1,1,787,1461,674
9190,1,1,325,1404,1079
9191,0,0,35,0,-35
9192,1,0,12,0,-12
9193,1,1,198,1334,1136
9194,0,0,42,0,-42
9195,1,1,269,1406,1137
9196,0,0,0,0,0
9197,0,0,36,0,-36
9198,0,0,1,0,-1
9199,0,0,13,0,-13
9200,0,0,28,0,-28
9201,0,0,89,0,-89
9202,1,1,342,1254,912
9203,0,0,7,0,-7
9204,0,0,8,0,-8
9205,1,0,26,0,-26
9206,0,0,13,0,-13
9207,1,0,12,0,-12
9208,1,0,119,0,-119
9209,0,0,17,0,-17
9210,0,0,122,0,-122
9211,1,1,259,1205,946
9212,0,0,108,0,-108
9213,1,1,457,1238,781
9214,1,0,47,0,-47
9215,1,0,44,0,-44
9216,0,0,9,0,-9
9217,1,0,48,0,-48
9218,0,0,80,0,-80
9219,1,0,60,0,-60
9220,1,1,50,1464,1414
9221,0,0,3,0,-3
9222,1,0,51,0,-51
9223,0,0,15,0,-15
9224,0,0,156,0,-156
9225,1,1,267,1345,1078
9226,1,0,22,0,-22
9227,1,1,291,1312,1021
9228,1,0,17,0,-17
9229,0,0,63,0,-63
9230,1,1,893,1207,314
9231,1,0,107,0,-107
9232,0,0,49,0,-49
9233,0,0,86,0,-86
9234,1,0,49,0,-49
9235,0,0,30,0,-30
9236,0,0,67,0,-67
9237,1,1,301,1784,1483
9238,1,0,44,0,-44
9239,1,1,57,2280,2223
9240,0,0,69,0,-69
9241,0,0,43,0,-43
9242,0,0,112,0,-112
9243,0,0,57,0,-57
9244,1,1,258,1216,958
9245,1,1,287,3266,2979
9246,0,0,39,0,-39
9247,0,0,87,0,-87
9248,0,0,48,0,-48
9249,1,1,380,1305,925
9250,0,0,9,0,-9
9251,1,1,1103,1220,117
9252,0,0,6,0,-6
9253,1,0,60,0,-60
9254,0,0,79,0,-79
9255,0,0,108,0,-108
9256,1,0,5,0,-5
9257,1,1,484,1411,927
9258,1,1,2939,1279,-1660
9259,0,0,55,0,-55
9260,1,1,3594,1442,-2152
9261,1,0,31,0,-31
9262,1,1,803,1661,858
9263,1,0,33,0,-33
9264,1,1,198,1291,1093
9265,0,0,45,0,-45
9266,1,0,10,0,-10
9267,0,0,32,0,-32
9268,1,1,105,1620,1515
9269,1,0,57,0,-57
9270,1,1,1867,1254,-613
9271,1,1,80,1638,1558
9272,0,0,11,0,-11
9273,1,1,1547,1882,335
9274,0,0,170,0,-170
9275,0,0,90,0,-90
9276,1,0,17,0,-17
9277,0,0,130,0,-130
9278,0,0,45,0,-45
9279,1,0,29,0,-29
9280,1,1,222,1396,1174
9281,1,1,1421,1508,87
9282,1,1,389,1440,1051
9283,1,0,22,0,-22
9284,1,0,34,0,-34
9285,1,1,582,1582,1000
9286,0,0,120,0,-120
9287,0,0,38,0,-38
9288,0,0,319,0,-319
9289,0,0,33,0,-33
9290,1,0,48,0,-48
9291,1,0,4,0,-4
9292,1,0,3,0,-3
9293,1,1,130,1256,1126
9294,1,0,54,0,-54
9295,1,0,20,0,-20
9296,1,1,121,1229,1108
9297,0,0,33,0,-33
9298,1,1,593,2660,2067
9299,1,1,212,1818,1606
9300,0,0,55,0,-55
9301,1,1,282,1460,1178
9302,0,0,27,0,-27
9303,1,1,132,1262,1130
9304,1,0,6,0,-6
9305,1,1,668,3696,3028
9306,1,1,109,1708,1599
9307,1,1,1433,1285,-148
9308,0,0,12,0,-12
9309,1,0,0,0,0
9310,1,0,19,0,-19
9311,1,1,586,1381,795
9312,1,1,1003,1495,492
9313,0,0,14,0,-14
9314,1,1,1664,1395,-269
9315,0,0,56,0,-56
9316,0,0,39,0,-39
9317,0,0,95,0,-95
9318,0,0,32,0,-32
9319,0,0,91,0,-91
9320,0,0,50,0,-50
9321,1,0,85,0,-85
9322,1,0,88,0,-88
9323,1,1,105,2259,2154
9324,1,0,147,0,-147
9325,1,1,1015,1851,836
9326,1,1,1441,1582,141
9327,1,1,434,2274,1840
9328,1,1,162,1640,1478
9329,1,0,11,0,-11
9330,1,1,237,1459,1222
9331,1,0,14,0,-14
9332,1,1,61,1274,1213
9333,0,0,21,0,-21
9334,1,1,865,1559,694
9335,1,0,1,0,-1
9336,0,0,42,0,-42
9337,0,0,5,0,-5
9338,1,0,17,0,-17
9339,1,0,2,0,-2
9340,0,0,55,0,-55
9341,0,0,1,0,-1
9342,1,1,63,1235,1172
9343,0,0,30,0,-30
9344,1,0,73,0,-73
9345,1,0,62,0,-62
9346,0,0,37,0,-37
9347,0,0,7,0,-7
9348,1,1,37,1300,1263
9349,1,0,39,0,-39
9350,1,1,761,1861,1100
9351,1,0,36,0,-36
9352,1,1,100,1689,1589
9353,1,0,12,0,-12
9354,1,0,3,0,-3
9355,1,1,681,1326,645
9356,0,0,34,0,-34
9357,1,0,59,0,-59
9358,1,0,38,0,-38
9359,1,0,16,0,-16
9360,1,0,64,0,-64
9361,1,1,902,1605,703
9362,0,0,46,0,-46
9363,1,1,180,1206,1026
9364,1,1,32,1241,1209
9365,0,0,70,0,-70
9366,1,0,78,0,-78
9367,1,1,800,1682,882
9368,0,0,62,0,-62
9369,0,0,28,0,-28
9370,0,0,36,0,-36
9371,1,0,3,0,-3
9372,1,1,168,1228,1060
9373,0,0,98,0,-98
9374,1,1,1525,2599,1074
9375,1,1,179,1441,1262
9376,1,1,706,1393,687
9377,0,0,42,0,-42
9378,1,0,20,0,-20
9379,0,0,37,0,-37
9380,0,0,3,0,-3
9381,1,0,76,0,-76
9382,1,0,2,0,-2
9383,0,0,38,0,-38
9384,1,1,564,1652,1088
9385,1,1,506,1210,704
9386,0,0,28,0,-28
9387,1,0,11,0,-11
9388,0,0,38,0,-38
9389,1,0,63,0,-63
9390,1,1,2763,1943,-820
9391,1,1,374,1532,1158
9392,0,0,52,0,-52
9393,0,0,11,0,-11
9394,1,0,41,0,-41
9395,1,0,122,0,-122
9396,1,0,14,0,-14
9397,0,0,29,0,-29
9398,0,0,5,0,-5
9399,0,0,134,0,-134
9400,1,1,405,1434,1029
9401,1,0,14,0,-14
9402,0,0,49,0,-49
9403,0,0,15,0,-15
9404,1,1,1101,1566,465
9405,1,1,3411,2041,-1370
9406,1,0,0,0,0
9407,0,0,43,0,-43
9408,0,0,45,0,-45
9409,1,0,54,0,-54
9410,1,0,42,0,-42
9411,0,0,9,0,-9
9412,1,0,21,0,-21
9413,0,0,4,0,-4
9414,1,1,355,1509,1154
9415,1,0,124,0,-124
9416,0,0,27,0,-27
9417,1,1,247,1406,1159
9418,1,0,75,0,-75
9419,0,0,113,0,-113
9420,0,0,273,0,-273
9421,1,0,45,0,-45
9422,1,1,263,1795,1532
9423,1,1,1206,1532,326
9424,0,0,61,0,-61
9425,0,0,27,0,-27
9426,0,0,24,0,-24
9427,1,0,1,0,-1
9428,0,0,3,0,-3
9429,1,0,56,0,-56
9430,1,0,124,0,-124
9431,0,0,37,0,-37
9432,0,0,34,0,-34
9433,1,1,1266,1312,46
9434,0,0,9,0,-9
9435,1,0,15,0,-15
9436,0,0,10,0,-10
9437,1,0,36,0,-36
9438,0,0,22,0,-22
9439,1,1,232,1557,1325
9440,1,1,585,1212,627
9441,0,0,14,0,-14
9442,1,0,46,0,-46
9443,1,1,305,1705,1400
9444,1,0,203,0,-203
9445,1,1,47,1338,1291
9446,0,0,2,0,-2
9447,0,0,51,0,-51
9448,0,0,16,0,-16
9449,0,0,13,0,-13
9450,1,0,69,0,-69
9451,0,0,6,0,-6
9452,1,1,257,1842,1585
9453,1,0,48,0,-48
9454,0,0,44,0,-44
9455,1,0,17,0,-17
9456,0,0,165,0,-165
9457,1,1,307,1788,1481
9458,0,0,48,0,-48
9459,0,0,41,0,-41
9460,0,0,123,0,-123
9461,1,0,76,0,-76
9462,0,0,20,0,-20
9463,1,1,554,1792,1238
9464,0,0,40,0,-40
9465,0,0,21,0,-21
9466,1,1,818,1494,676
9467,1,1,1373,1799,426
9468,0,0,53,0,-53
9469,1,1,244,1725,1481
9470,0,0,2,0,-2
9471,0,0,104,0,-104
9472,1,1,163,3690,3527
9473,0,0,37,0,-37
9474,1,1,333,1622,1289
9475,1,1,793,1256,463
9476,0,0,49,0,-49
9477,0,0,214,0,-214
9478,1,0,56,0,-56
9479,1,0,121,0,-121
9480,1,1,1252,1315,63
9481,0,0,28,0,-28
9482,0,0,164,0,-164
9483,0,0,11,0,-11
9484,1,0,11,0,-11
9485,1,0,16,0,-16
9486,0,0,47,0,-47
9487,1,1,922,1524,602
9488,1,0,3,0,-3
9489,1,0,60,0,-60
9490,1,0,35,0,-35
9491,0,0,21,0,-21
9492,1,1,632,1324,692
9493,0,0,6,0,-6
9494,0,0,26,0,-26
9495,1,0,82,0,-82
9496,1,1,518,2665,2147
9497,0,0,37,0,-37
9498,1,0,35,0,-35
9499,1,0,19,0,-19
9500,0,0,2,0,-2
9501,1,1,401,1318,917
9502,1,0,18,0,-18
9503,0,0,32,0,-32
9504,1,1,768,1382,614
9505,1,1,329,1387,1058
9506,1,0,24,0,-24
9507,1,0,55,0,-55
9508,1,1,63,1338,1275
9509,1,0,28,0,-28
9510,0,0,33,0,-33
9511,1,0,62,0,-62
9512,0,0,104,0,-104
9513,0,0,107,0,-107
9514,1,1,221,1538,1317
9515,0,0,18,0,-18
9516,1,0,63,0,-63
9517,0,0,46,0,-46
9518,0,0,158,0,-158
9519,0,0,225,0,-225
9520,1,0,3,0,-3
9521,1,0,8,0,-8
9522,1,0,23,0,-23
9523,1,0,36,0,-36
9524,1,0,25,0,-25
9525,1,0,72,0,-72
9526,0,0,5,0,-5
9527,0,0,1,0,-1
9528,1,1,130,1870,1740
9529,1,0,6,0,-6
9530,1,1,1119,1364,245
9531,0,0,48,0,-48
9532,1,0,39,0,-39
9533,1,0,9,0,-9
9534,1,0,4,0,-4
9535,1,0,8,0,-8
9536,1,1,728,1224,496
9537,1,0,31,0,-31
9538,1,0,60,0,-60
9539,1,1,363,1778,1415
9540,0,0,50,0,-50
9541,0,0,39,0,-39
9542,0,0,55,0,-55
9543,1,1,131,2149,2018
9544,0,0,20,0,-20
9545,1,0,98,0,-98
9546,1,0,92,0,-92
9547,1,0,17,0,-17
9548,1,1,219,1700,1481
9549,0,0,115,0,-115
9550,0,0,81,0,-81
9551,0,0,3,0,-3
9552,1,1,239,1470,1231
9553,1,1,1739,1309,-430
9554,1,0,86,0,-86
9555,1,0,35,0,-35
9556,0,0,175,0,-175
9557,0,0,75,0,-75
9558,1,1,200,1547,1347
9559,1,0,92,0,-92
9560,0,0,29,0,-29
9561,1,0,100,0,-100
9562,1,1,483,1916,1433
9563,1,1,853,1475,622
9564,1,0,96,0,-96
9565,1,1,266,1587,1321
9566,0,0,51,0,-51
9567,0,0,28,0,-28
9568,0,0,17,0,-17
9569,1,1,76,1273,1197
9570,1,1,1175,1207,32
9571,0,0,141,0,-141
9572,1,0,16,0,-16
9573,0,0,23,0,-23
9574,1,1,215,2127,1912
9575,1,0,73,0,-73
9576,1,0,72,0,-72
9577,1,0,87,0,-87
9578,1,1,292,1295,1003
9579,1,1,182,1514,1332
9580,0,0,19,0,-19
9581,0,0,4,0,-4
9582,1,0,75,0,-75
9583,1,0,41,0,-41
9584,0,0,35,0,-35
9585,1,0,101,0,-101
9586,1,0,26,0,-26
9587,1,1,1165,1483,318
9588,1,0,129,0,-129
9589,1,0,50,0,-50
9590,1,1,392,1213,821
9591,1,0,19,0,-19
9592,0,0,27,0,-27
9593,1,0,19,0,-19
9594,0,0,77,0,-77
9595,0,0,54,0,-54
9596,1,0,1,0,-1
9597,1,1,315,1278,963
9598,1,1,807,1261,454
9599,1,0,59,0,-59
9600,0,0,118,0,-118
9601,0,0,15,0,-15
9602,1,1,593,1860,1267
9603,1,1,630,1609,979
9604,1,0,64,0,-64
9605,1,1,629,3583,2954
9606,1,1,585,1327,742
9607,0,0,22,0,-22
9608,0,0,73,0,-73
9609,0,0,12,0,-12
9610,1,0,65,0,-65
9611,0,0,7,0,-7
9612,0,0,44,0,-44
9613,1,1,552,1683,1131
9614,0,0,28,0,-28
9615,0,0,87,0,-87
9616,1,1,410,1723,1313
9617,0,0,37,0,-37
9618,0,0,159,0,-159
9619,1,1,1252,1531,279
9620,1,0,79,0,-79
9621,1,1,1440,1281,-159
9622,0,0,38,0,-38
9623,1,0,121,0,-121
9624,1,0,9,0,-9
9625,1,1,1583,1239,-344
9626,1,1,235,1653,1418
9627,0,0,48,0,-48
9628,1,1,756,1501,745
9629,1,0,44,0,-44
9630,1,0,76,0,-76
9631,0,0,34,0,-34
9632,0,0,15,0,-15
9633,1,1,696,1208,512
9634,1,1,1269,1517,248
9635,1,1,1107,1228,121
9636,1,0,13,0,-13
9637,1,0,4,0,-4
9638,0,0,39,0,-39
9639,0,0,8,0,-8
9640,1,1,397,1429,1032
9641,0,0,16,0,-16
9642,1,1,134,1663,1529
9643,0,0,49,0,-49
9644,0,0,30,0,-30
9645,1,1,556,1221,665
9646,1,1,925,2364,1439
9647,0,0,8,0,-8
9648,0,0,52,0,-52
9649,0,0,74,0,-74
9650,1,1,896,1641,745
9651,0,0,41,0,-41
9652,1,1,2046,1356,-690
9653,0,0,7,0,-7
9654,1,0,137,0,-137
9655,0,0,41,0,-41
9656,1,1,86,1254,1168
9657,0,0,62,0,-62
9658,1,0,5,0,-5
9659,1,1,151,1841,1690
9660,0,0,14,0,-14
9661,1,0,85,0,-85
9662,0,0,38,0,-38
9663,1,0,3,0,-3
9664,1,0,1,0,-1
9665,1,1,1383,1375,-8
9666,0,0,98,0,-98
9667,1,1,616,1470,854
9668,1,0,57,0,-57
9669,1,1,292,1534,1242
9670,1,0,3,0,-3
9671,1,1,1420,1306,-114
9672,0,0,24,0,-24
9673,1,0,30,0,-30
9674,0,0,68,0,-68
9675,0,0,71,0,-71
9676,1,0,38,0,-38
9677,1,0,64,0,-64
9678,1,1,118,1331,1213
9679,1,1,1575,3920,2345
9680,0,0,25,0,-25
9681,1,0,145,0,-145
9682,0,0,26,0,-26
9683,1,0,3,0,-3
9684,0,0,9,0,-9
9685,0,0,6,0,-6
9686,1,1,73,1259,1186
9687,1,1,758,1582,824
9688,1,0,24,0,-24
9689,1,0,5,0,-5
9690,0,0,175,0,-175
9691,0,0,24,0,-24
9692,0,0,67,0,-67
9693,0,0,0,0,0
9694,1,0,9,0,-9
9695,1,1,1416,2183,767
9696,1,0,1,0,-1
9697,1,0,27,0,-27
9698,0,0,62,0,-62
9699,0,0,12,0,-12
9700,0,0,5,0,-5
9701,0,0,16,0,-16
9702,0,0,143,0,-143
9703,0,0,22,0,-22
9704,0,0,33,0,-33
9705,0,0,26,0,-26
9706,0,0,5,0,-5
9707,1,0,17,0,-17
9708,1,0,6,0,-6
9709,1,1,107,1520,1413
9710,1,0,4,0,-4
9711,1,1,148,1300,1152
9712,1,1,269,1377,1108
9713,1,1,307,1296,989
9714,0,0,28,0,-28
9715,1,0,10,0,-10
9716,1,1,407,1467,1060
9717,0,0,68,0,-68
9718,0,0,4,0,-4
9719,1,1,359,1662,1303
9720,1,0,15,0,-15
9721,0,0,79,0,-79
9722,0,0,52,0,-52
9723,1,1,227,1663,1436
9724,1,0,272,0,-272
9725,1,0,77,0,-77
9726,0,0,6,0,-6
9727,0,0,47,0,-47
9728,0,0,14,0,-14
9729,1,0,56,0,-56
9730,0,0,106,0,-106
9731,1,0,27,0,-27
9732,1,0,2,0,-2
9733,0,0,34,0,-34
9734,0,0,46,0,-46
9735,0,0,21,0,-21
9736,0,0,7,0,-7
9737,1,1,1001,1492,491
9738,1,0,135,0,-135
9739,0,0,5,0,-5
9740,0,0,94,0,-94
9741,0,0,12,0,-12
9742,1,1,979,1798,819
9743,0,0,1,0,-1
9744,1,0,29,0,-29
9745,1,0,59,0,-59
9746,1,0,25,0,-25
9747,1,1,567,1448,881
9748,1,0,118,0,-118
9749,1,1,355,2182,1827
9750,1,1,187,1680,1493
9751,1,1,656,1250,594
9752,1,0,11,0,-11
9753,1,1,521,1495,974
9754,0,0,72,0,-72
9755,0,0,49,0,-49
9756,1,1,502,1912,1410
9757,1,0,18,0,-18
9758,0,0,2,0,-2
9759,0,0,133,0,-133
9760,1,1,678,1294,616
9761,1,0,37,0,-37
9762,1,0,73,0,-73
9763,1,0,4,0,-4
9764,0,0,59,0,-59
9765,0,0,94,0,-94
9766,1,0,36,0,-36
9767,1,1,983,1358,375
9768,0,0,24,0,-24
9769,1,1,331,1428,1097
9770,1,0,3,0,-3
9771,1,1,1126,1553,427
9772,1,0,81,0,-81
9773,1,0,15,0,-15
9774,1,1,371,1461,1090
9775,1,0,54,0,-54
9776,1,1,2188,1576,-612
9777,1,0,47,0,-47
9778,1,0,14,0,-14
9779,0,0,89,0,-89
9780,0,0,52,0,-52
9781,1,0,5,0,-5
9782,1,1,551,1784,1233
9783,1,1,837,1439,602
9784,0,0,27,0,-27
9785,1,0,21,0,-21
9786,0,0,60,0,-60
9787,1,1,470,1476,1006
9788,1,0,35,0,-35
9789,0,0,20,0,-20
9790,1,1,829,1260,431
9791,1,1,366,1324,958
9792,1,1,1087,2018,931
9793,0,0,3,0,-3
9794,0,0,21,0,-21
9795,1,1,472,1251,779
9796,0,0,52,0,-52
9797,1,1,349,1532,1183
9798,1,0,2,0,-2
9799,0,0,2,0,-2
9800,1,0,135,0,-135
9801,1,1,529,1879,1350
9802,0,0,40,0,-40
9803,1,1,354,1330,976
9804,1,1,2160,1249,-911
9805,1,0,42,0,-42
9806,1,1,948,1295,347
9807,1,1,983,1524,541
9808,1,0,2,0,-2
9809,0,0,70,0,-70
9810,1,1,33,1388,1355
9811,0,0,87,0,-87
9812,1,1,817,1560,743
9813,0,0,84,0,-84
9814,0,0,56,0,-56
9815,0,0,74,0,-74
9816,1,0,59,0,-59
9817,1,1,107,1451,1344
9818,1,1,892,1715,823
9819,0,0,11,0,-11
9820,1,0,265,0,-265
9821,1,0,4,0,-4
9822,1,1,94,1297,1203
9823,1,0,45,0,-45
9824,0,0,34,0,-34
9825,1,0,5,0,-5
9826,0,0,43,0,-43
9827,1,0,92,0,-92
9828,1,1,179,1600,1421
9829,1,1,112,1576,1464
9830,1,1,944,1683,739
9831,0,0,33,0,-33
9832,1,1,270,1226,956
9833,1,0,45,0,-45
9834,0,0,49,0,-49
9835,0,0,128,0,-128
9836,0,0,32,0,-32
9837,0,0,10,0,-10
9838,1,1,615,1262,647
9839,1,1,913,1267,354
9840,1,0,43,0,-43
9841,1,0,236,0,-236
9842,1,1,1119,1456,337
9843,0,0,141,0,-141
9844,1,1,144,1240,1096
9845,1,0,109,0,-109
9846,1,1,175,2267,2092
9847,1,0,42,0,-42
9848,1,1,223,1402,1179
9849,1,1,807,1431,624
9850,1,0,7,0,-7
9851,0,0,54,0,-54
9852,0,0,167,0,-167
9853,1,1,859,1863,1004
9854,1,0,1,0,-1
9855,0,0,61,0,-61
9856,1,0,97,0,-97
9857,1,1,516,1372,856
9858,0,0,30,0,-30
9859,0,0,34,0,-34
9860,1,0,33,0,-33
9861,1,0,110,0,-110
9862,1,0,77,0,-77
9863,1,0,33,0,-33
9864,1,0,29,0,-29
9865,1,0,23,0,-23
9866,1,0,58,0,-58
9867,1,1,264,1283,1019
9868,0,0,79,0,-79
9869,1,0,132,0,-132
9870,0,0,12,0,-12
9871,0,0,14,0,-14
9872,1,1,343,1221,878
9873,1,1,343,1452,1109
9874,1,1,191,1290,1099
9875,0,0,19,0,-19
9876,0,0,18,0,-18
9877,0,0,23,0,-23
9878,1,1,539,1755,1216
9879,1,1,709,2353,1644
9880,1,1,595,1217,622
9881,1,0,8,0,-8
9882,0,0,80,0,-80
9883,1,0,11,0,-11
9884,1,0,5,0,-5
9885,1,0,22,0,-22
9886,1,1,246,1307,1061
9887,1,0,72,0,-72
9888,1,0,22,0,-22
9889,0,0,53,0,-53
9890,1,0,0,0,0
9891,0,0,63,0,-63
9892,1,1,307,1200,893
9893,0,0,7,0,-7
9894,0,0,70,0,-70
9895,1,0,2,0,-2
9896,0,0,38,0,-38
9897,1,1,235,1234,999
9898,1,1,664,1511,847
9899,1,0,57,0,-57
9900,1,0,136,0,-136
9901,1,1,483,2310,1827
9902,1,0,28,0,-28
9903,0,0,37,0,-37
9904,1,1,530,1618,1088
9905,0,0,106,0,-106
9906,1,1,430,1206,776
9907,1,0,50,0,-50
9908,1,1,1314,1440,126
9909,0,0,23,0,-23
9910,1,1,91,1380,1289
9911,1,0,13,0,-13
9912,1,1,137,2361,2224
9913,1,1,754,1296,542
9914,1,0,34,0,-34
9915,0,0,44,0,-44
9916,0,0,6,0,-6
9917,0,0,63,0,-63
9918,1,0,96,0,-96
9919,1,1,144,1647,1503
9920,1,1,1193,1272,79
9921,1,1,130,4687,4557
9922,1,1,477,1237,760
9923,1,0,68,0,-68
9924,1,1,1163,1233,70
9925,0,0,49,0,-49
9926,1,1,299,1536,1237
9927,1,1,222,1351,1129
9928,0,0,84,0,-84
9929,1,0,234,0,-234
9930,1,0,105,0,-105
9931,1,0,29,0,-29
9932,1,1,802,1254,452
9933,0,0,123,0,-123
9934,1,1,3006,1254,-1752
9935,0,0,9,0,-9
9936,1,1,338,1213,875
9937,1,0,16,0,-16
9938,1,1,73,1207,1134
9939,1,0,234,0,-234
9940,1,0,19,0,-19
9941,0,0,1,0,-1
9942,1,1,366,1206,840
9943,1,1,268,1435,1167
9944,1,0,27,0,-27
9945,0,0,160,0,-160
9946,1,1,142,1559,1417
9947,1,1,119,1358,1239
9948,1,1,1535,1543,8
9949,1,0,150,0,-150
9950,1,1,22,1281,1259
9951,0,0,11,0,-11
9952,1,1,359,1443,1084
9953,1,0,7,0,-7
9954,1,1,27,1815,1788
9955,1,1,553,1649,1096
9956,1,0,30,0,-30
9957,0,0,115,0,-115
9958,0,0,98,0,-98
9959,1,1,887,1979,1092
9960,0,0,22,0,-22
9961,0,0,18,0,-18
9962,0,0,18,0,-18
9963,0,0,25,0,-25
9964,0,0,42,0,-42
9965,1,0,0,0,0
9966,1,1,224,1550,1326
9967,0,0,34,0,-34
9968,1,1,164,1261,1097
9969,1,0,1,0,-1
9970,0,0,28,0,-28
9971,1,0,4,0,-4
9972,1,0,102,0,-102
9973,0,0,72,0,-72
9974,1,1,821,1378,557
9975,1,0,102,0,-102
9976,0,0,3,0,-3
9977,0,0,35,0,-35
9978,0,0,82,0,-82
9979,0,0,109,0,-109
9980,1,0,24,0,-24
9981,1,0,14,0,-14
9982,0,0,45,0,-45
9983,0,0,48,0,-48
9984,1,0,102,0,-102
9985,1,0,71,0,-71
9986,1,0,30,0,-30
9987,1,1,277,1629,1352
9988,1,1,625,1862,1237
9989,0,0,53,0,-53
9990,1,0,51,0,-51
9991,1,0,64,0,-64
9992,1,0,52,0,-52
9993,1,0,166,0,-166
9994,0,0,52,0,-52
9995,0,0,12,0,-12
9996,1,0,18,0,-18
9997,1,1,601,1230,629
9998,0,0,265,0,-265
9999,1,0,32,0,-32
10000,0,0,21,0,-21
10001,0,0,46,0,-46
10002,0,0,38,0,-38
10003,1,0,10,0,-10
10004,0,0,110,0,-110
10005,1,0,25,0,-25
10006,0,0,53,0,-53
10007,1,0,22,0,-22
10008,1,1,599,1869,1270
10009,1,1,584,1406,822
10010,0,0,9,0,-9
10011,1,0,3,0,-3
10012,0,0,2,0,-2
10013,0,0,396,0,-396
10014,0,0,10,0,-10
10015,1,0,0,0,0
10016,1,1,200,1282,1082
10017,0,0,29,0,-29
10018,1,0,59,0,-59
10019,1,1,846,1220,374
10020,1,0,20,0,-20
10021,0,0,34,0,-34
10022,1,0,23,0,-23
10023,1,1,386,1528,1142
10024,0,0,23,0,-23
10025,0,0,11,0,-11
10026,1,0,44,0,-44
10027,0,0,13,0,-13
10028,0,0,166,0,-166
10029,1,0,38,0,-38
10030,1,1,3373,1305,-2068
10031,1,0,39,0,-39
10032,1,0,35,0,-35
10033,0,0,68,0,-68
10034,0,0,58,0,-58
10035,0,0,3,0,-3
10036,0,0,142,0,-142
10037,1,0,8,0,-8
10038,0,0,197,0,-197
10039,1,1,172,1212,1040
10040,1,1,109,1248,1139
10041,1,0,9,0,-9
10042,0,0,9,0,-9
10043,0,0,31,0,-31
10044,0,0,90,0,-90
10045,0,0,269,0,-269
10046,0,0,15,0,-15
10047,0,0,37,0,-37
10048,1,0,22,0,-22
10049,1,0,3,0,-3
10050,1,1,106,1738,1632
10051,1,1,355,1281,926
10052,1,1,770,1538,768
10053,1,0,4,0,-4
10054,1,1,262,1815,1553
10055,0,0,16,0,-16
10056,0,0,84,0,-84
10057,0,0,42,0,-42
10058,1,1,352,1342,990
10059,0,0,8,0,-8
10060,1,1,2246,1727,-519
10061,0,0,35,0,-35
10062,1,1,422,1395,973
10063,1,0,37,0,-37
10064,1,1,1082,1495,413
10065,0,0,83,0,-83
10066,0,0,74,0,-74
10067,1,1,125,1252,1127
10068,1,0,15,0,-15
10069,0,0,151,0,-151
10070,1,0,17,0,-17
10071,1,0,47,0,-47
10072,0,0,22,0,-22
10073,1,0,89,0,-89
10074,0,0,5,0,-5
10075,1,1,338,2743,2405
10076,0,0,47,0,-47
10077,1,0,6,0,-6
10078,1,1,273,1444,1171
10079,1,1,122,1785,1663
10080,1,0,51,0,-51
10081,0,0,3,0,-3
10082,1,1,706,1288,582
10083,1,1,389,1279,890
10084,0,0,147,0,-147
10085,0,0,51,0,-51
10086,1,0,2,0,-2
10087,1,1,647,1488,841
10088,1,1,149,1225,1076
10089,1,0,25,0,-25
10090,0,0,68,0,-68
10091,1,0,58,0,-58
10092,0,0,8,0,-8
10093,1,1,115,1283,1168
10094,1,0,29,0,-29
10095,0,0,0,0,0
10096,0,0,0,0,0
10097,1,1,125,1627,1502
10098,1,0,2,0,-2
10099,1,0,29,0,-29
10100,1,1,2084,1331,-753
10101,1,1,1376,1378,2
10102,0,0,111,0,-111
10103,0,0,49,0,-49
10104,1,1,167,1303,1136
10105,1,1,56,1238,1182
10106,1,0,22,0,-22
10107,0,0,53,0,-53
10108,1,1,431,1699,1268
10109,1,1,158,1313,1155
10110,1,1,948,1359,411
10111,1,0,39,0,-39
10112,1,0,45,0,-45
10113,1,1,73,1568,1495
10114,0,0,138,0,-138
10115,0,0,70,0,-70
10116,1,1,179,1415,1236
10117,0,0,34,0,-34
10118,1,1,79,1369,1290
10119,0,0,80,0,-80
10120,1,1,394,1346,952
10121,1,0,23,0,-23
10122,1,1,773,1529,756
10123,1,0,6,0,-6
10124,1,1,463,1355,892
10125,1,1,661,1257,596
10126,0,0,13,0,-13
10127,1,0,53,0,-53
10128,1,0,144,0,-144
10129,1,1,65,1216,1151
10130,1,1,465,2269,1804
10131,0,0,91,0,-91
10132,0,0,21,0,-21
10133,0,0,64,0,-64
10134,0,0,94,0,-94
10135,1,1,458,1437,979
10136,1,0,34,0,-34
10137,1,0,22,0,-22
10138,1,0,0,0,0
10139,1,0,16,0,-16
10140,1,0,2,0,-2
10141,1,0,15,0,-15
10142,0,0,53,0,-53
10143,0,0,13,0,-13
10144,1,0,51,0,-51
10145,0,0,6,0,-6
10146,1,0,107,0,-107
10147,1,0,4,0,-4
10148,0,0,89,0,-89
10149,1,1,1032,1362,330
10150,1,1,961,1226,265
10151,0,0,46,0,-46
10152,1,0,56,0,-56
10153,0,0,43,0,-43
10154,0,0,15,0,-15
10155,0,0,80,0,-80
10156,0,0,39,0,-39
10157,1,0,12,0,-12
10158,0,0,4,0,-4
10159,1,1,910,1312,402
10160,0,0,42,0,-42
10161,0,0,52,0,-52
10162,0,0,59,0,-59
10163,0,0,42,0,-42
10164,1,0,33,0,-33
10165,0,0,6,0,-6
10166,0,0,76,0,-76
10167,0,0,11,0,-11
10168,0,0,198,0,-198
10169,1,1,76,1218,1142
10170,1,0,69,0,-69
10171,1,0,33,0,-33
10172,0,0,0,0,0
10173,0,0,99,0,-99
10174,0,0,18,0,-18
10175,0,0,1,0,-1
10176,1,0,51,0,-51
10177,0,0,6,0,-6
10178,1,1,28,1722,1694
10179,1,1,65,1462,1397
10180,1,0,146,0,-146
10181,1,0,12,0,-12
10182,0,0,21,0,-21
10183,1,1,1173,1332,159
10184,0,0,20,0,-20
10185,0,0,50,0,-50
10186,0,0,54,0,-54
10187,1,1,122,2093,1971
10188,1,1,147,2564,2417
10189,1,0,41,0,-41
10190,1,1,286,1765,1479
10191,0,0,68,0,-68
10192,1,1,865,1363,498
10193,0,0,133,0,-133
10194,1,1,526,1272,746
10195,0,0,23,0,-23
10196,0,0,76,0,-76
10197,0,0,13,0,-13
10198,1,1,325,1682,1357
10199,0,0,6,0,-6
10200,0,0,25,0,-25
10201,1,0,4,0,-4
10202,1,0,87,0,-87
10203,0,0,118,0,-118
10204,0,0,12,0,-12
10205,1,1,525,1219,694
10206,0,0,1,0,-1
10207,0,0,86,0,-86
10208,0,0,22,0,-22
10209,1,1,1499,1564,65
10210,1,0,23,0,-23
10211,1,0,16,0,-16
10212,1,1,204,2932,2728
10213,0,0,169,0,-169
10214,0,0,69,0,-69
10215,1,0,28,0,-28
10216,0,0,27,0,-27
10217,0,0,18,0,-18
10218,1,0,120,0,-120
10219,1,0,51,0,-51
10220,0,0,0,0,0
10221,0,0,76,0,-76
10222,0,0,73,0,-73
10223,1,1,1026,1538,512
10224,1,0,19,0,-19
10225,1,0,6,0,-6
10226,1,1,554,1279,725
10227,1,1,584,2357,1773
10228,0,0,11,0,-11
10229,1,1,930,1284,354
10230,1,1,481,1602,1121
10231,0,0,97,0,-97
10232,0,0,14,0,-14
10233,0,0,38,0,-38
10234,0,0,80,0,-80
10235,0,0,89,0,-89
10236,1,1,1066,1486,420
10237,1,0,51,0,-51
10238,1,0,29,0,-29
10239,1,0,57,0,-57
10240,0,0,7,0,-7
10241,1,1,28,2082,2054
10242,1,0,42,0,-42
10243,1,1,545,1649,1104
10244,0,0,40,0,-40
10245,1,0,17,0,-17
10246,1,1,455,1857,1402
10247,1,1,350,1341,991
10248,0,0,61,0,-61
10249,1,0,109,0,-109
10250,0,0,1,0,-1
10251,1,1,435,1260,825
10252,0,0,42,0,-42
10253,0,0,81,0,-81
10254,1,0,18,0,-18
10255,0,0,61,0,-61
10256,1,0,24,0,-24
10257,1,0,68,0,-68
10258,1,0,32,0,-32
10259,1,1,1100,1231,131
10260,1,0,3,0,-3
10261,1,0,75,0,-75
10262,0,0,20,0,-20
10263,0,0,7,0,-7
10264,1,1,433,2364,1931
10265,0,0,5,0,-5
10266,1,0,60,0,-60
10267,0,0,27,0,-27
10268,1,1,1349,1335,-14
10269,0,0,20,0,-20
10270,1,1,932,1237,305
10271,1,0,121,0,-121
10272,0,0,11,0,-11
10273,1,1,319,1374,1055
10274,1,0,148,0,-148
10275,0,0,0,0,0
10276,1,0,69,0,-69
10277,0,0,107,0,-107
10278,1,1,2065,1644,-421
10279,0,0,15,0,-15
10280,0,0,22,0,-22
10281,1,1,652,1275,623
10282,0,0,31,0,-31
10283,0,0,55,0,-55
10284,0,0,34,0,-34
10285,1,1,357,1425,1068
10286,0,0,19,0,-19
10287,1,0,14,0,-14
10288,1,0,111,0,-111
10289,1,0,51,0,-51
10290,1,0,100,0,-100
10291,0,0,75,0,-75
10292,1,0,24,0,-24
10293,1,0,3,0,-3
10294,0,0,17,0,-17
10295,1,1,628,1650,1022
10296,0,0,56,0,-56
10297,0,0,13,0,-13
10298,1,1,1755,1620,-135
10299,0,0,61,0,-61
10300,1,0,21,0,-21
10301,0,0,78,0,-78
10302,1,0,19,0,-19
10303,0,0,80,0,-80
10304,0,0,90,0,-90
10305,0,0,21,0,-21
10306,1,1,718,2367,1649
10307,0,0,135,0,-135
10308,1,0,40,0,-40
10309,1,0,66,0,-66
10310,1,0,37,0,-37
10311,1,0,0,0,0
10312,1,0,0,0,0
10313,0,0,31,0,-31
10314,1,1,480,1556,1076
10315,0,0,0,0,0
10316,0,0,94,0,-94
10317,1,0,36,0,-36
10318,1,0,20,0,-20
10319,0,0,59,0,-59
10320,1,0,168,0,-168
10321,1,0,106,0,-106
10322,1,0,84,0,-84
10323,1,0,109,0,-109
10324,0,0,20,0,-20
10325,0,0,73,0,-73
10326,0,0,71,0,-71
10327,1,1,630,1437,807
10328,1,0,19,0,-19
10329,1,0,154,0,-154
10330,1,0,22,0,-22
10331,0,0,40,0,-40
10332,1,0,61,0,-61
10333,1,0,112,0,-112
10334,1,1,341,1261,920
10335,1,0,80,0,-80
10336,1,1,120,1366,1246
10337,1,1,535,1755,1220
10338,1,0,39,0,-39
10339,1,0,59,0,-59
10340,1,0,6,0,-6
10341,1,0,91,0,-91
10342,1,1,1219,1961,742
10343,1,1,539,1272,733
10344,0,0,211,0,-211
10345,0,0,3,0,-3
10346,1,1,320,1277,957
10347,0,0,42,0,-42
10348,0,0,58,0,-58
10349,1,0,2,0,-2
10350,1,1,317,1648,1331
10351,0,0,4,0,-4
10352,0,0,53,0,-53
10353,1,0,84,0,-84
10354,1,1,740,1308,568
10355,0,0,95,0,-95
10356,0,0,13,0,-13
10357,1,0,107,0,-107
10358,0,0,31,0,-31
10359,1,0,36,0,-36
10360,1,0,54,0,-54
10361,1,1,388,1278,890
10362,1,1,343,1303,960
10363,1,0,63,0,-63
10364,0,0,21,0,-21
10365,1,0,347,0,-347
10366,1,0,36,0,-36
10367,0,0,104,0,-104
10368,0,0,40,0,-40
10369,0,0,15,0,-15
10370,1,0,63,0,-63
10371,1,0,14,0,-14
10372,0,0,72,0,-72
10373,1,1,1587,1452,-135
10374,1,0,100,0,-100
10375,0,0,3,0,-3
10376,1,0,2,0,-2
10377,0,0,5,0,-5
10378,1,1,1280,1571,291
10379,1,0,10,0,-10
10380,1,0,37,0,-37
10381,0,0,18,0,-18
10382,1,1,116,1299,1183
10383,1,0,35,0,-35
10384,1,1,502,1217,715
10385,1,1,131,2001,1870
10386,0,0,43,0,-43
10387,1,1,523,1494,971
10388,0,0,108,0,-108
10389,0,0,27,0,-27
10390,1,0,29,0,-29
10391,1,1,304,3872,3568
10392,1,1,474,1270,796
10393,1,1,245,1527,1282
10394,1,0,0,0,0
10395,1,0,25,0,-25
10396,0,0,122,0,-122
10397,0,0,99,0,-99
10398,1,1,444,1433,989
10399,0,0,48,0,-48
10400,0,0,1,0,-1
10401,0,0,26,0,-26
10402,0,0,31,0,-31
10403,0,0,0,0,0
10404,1,1,125,1794,1669
10405,0,0,49,0,-49
10406,1,1,272,1297,1025
10407,0,0,83,0,-83
10408,1,0,53,0,-53
10409,0,0,91,0,-91
10410,0,0,49,0,-49
10411,1,0,21,0,-21
10412,1,0,66,0,-66
10413,1,1,234,1608,1374
10414,0,0,2,0,-2
10415,0,0,15,0,-15
10416,1,0,7,0,-7
10417,0,0,15,0,-15
10418,1,1,754,1460,706
10419,1,0,21,0,-21
10420,1,0,50,0,-50
10421,0,0,180,0,-180
10422,1,0,18,0,-18
10423,1,0,6,0,-6
10424,0,0,8,0,-8
10425,1,1,171,1369,1198
10426,1,1,327,1405,1078
10427,0,0,79,0,-79
10428,0,0,13,0,-13
10429,1,0,18,0,-18
10430,0,0,21,0,-21
10431,0,0,48,0,-48
10432,0,0,16,0,-16
10433,0,0,30,0,-30
10434,0,0,6,0,-6
10435,0,0,85,0,-85
10436,1,0,13,0,-13
10437,0,0,167,0,-167
10438,1,0,40,0,-40
10439,1,1,439,2012,1573
10440,0,0,6,0,-6
10441,1,0,7,0,-7
10442,0,0,66,0,-66
10443,1,1,158,1552,1394
10444,1,0,155,0,-155
10445,0,0,30,0,-30
10446,1,1,87,1582,1495
10447,0,0,3,0,-3
10448,1,0,173,0,-173
10449,0,0,11,0,-11
10450,1,0,17,0,-17
10451,0,0,75,0,-75
10452,1,1,521,1318,797
10453,1,0,45,0,-45
10454,0,0,7,0,-7
10455,0,0,54,0,-54
10456,0,0,16,0,-16
10457,1,0,215,0,-215
10458,1,0,7,0,-7
10459,1,1,432,1300,868
10460,0,0,15,0,-15
10461,1,1,348,1870,1522
10462,0,0,17,0,-17
10463,1,0,49,0,-49
10464,1,1,527,1279,752
10465,1,0,19,0,-19
10466,0,0,80,0,-80
10467,0,0,96,0,-96
10468,0,0,16,0,-16
10469,1,0,5,0,-5
10470,0,0,17,0,-17
10471,1,0,40,0,-40
10472,0,0,7,0,-7
10473,1,1,852,1397,545
10474,0,0,6,0,-6
10475,0,0,16,0,-16
10476,1,1,1192,2263,1071
10477,1,1,742,1480,738
10478,1,1,1390,1209,-181
10479,0,0,66,0,-66
10480,1,1,1268,2475,1207
10481,1,0,29,0,-29
10482,1,0,116,0,-116
10483,1,1,287,2177,1890
10484,0,0,7,0,-7
10485,0,0,45,0,-45
10486,1,0,86,0,-86
10487,0,0,28,0,-28
10488,0,0,55,0,-55
10489,1,1,1398,1663,265
10490,1,1,129,1380,1251
10491,1,1,1031,1814,783
10492,1,1,310,1277,967
10493,1,0,11,0,-11
10494,1,0,66,0,-66
10495,1,1,26,1237,1211
10496,0,0,9,0,-9
10497,0,0,37,0,-37
10498,1,0,38,0,-38
10499,1,1,195,1268,1073
10500,1,0,89,0,-89
10501,1,0,79,0,-79
10502,1,0,91,0,-91
10503,1,1,1740,2430,690
10504,0,0,74,0,-74
10505,1,1,185,1239,1054
10506,1,1,411,1484,1073
10507,0,0,121,0,-121
10508,1,1,337,1571,1234
10509,1,1,315,1359,1044
10510,1,0,61,0,-61
10511,0,0,41,0,-41
10512,0,0,37,0,-37
10513,1,1,211,2591,2380
10514,0,0,102,0,-102
10515,1,1,224,1207,983
10516,1,1,133,1399,1266
10517,1,0,45,0,-45
10518,0,0,98,0,-98
10519,0,0,9,0,-9
10520,1,0,62,0,-62
10521,0,0,8,0,-8
10522,0,0,4,0,-4
10523,1,0,8,0,-8
10524,1,0,17,0,-17
10525,1,1,528,1601,1073
10526,0,0,49,0,-49
10527,1,0,3,0,-3
10528,0,0,34,0,-34
10529,1,0,35,0,-35
10530,0,0,57,0,-57
10531,0,0,10,0,-10
10532,1,1,261,1352,1091
10533,0,0,30,0,-30
10534,1,0,4,0,-4
10535,1,0,16,0,-16
10536,1,1,360,1277,917
10537,1,1,246,1260,1014
10538,1,1,55,1860,1805
10539,0,0,17,0,-17
10540,1,0,44,0,-44
10541,1,1,225,1249,1024
10542,1,1,19,1248,1229
10543,1,1,437,1259,822
10544,0,0,82,0,-82
10545,1,1,602,1513,911
10546,1,1,444,2101,1657
10547,0,0,1,0,-1
10548,1,1,245,2042,1797
10549,1,1,92,1555,1463
10550,0,0,1,0,-1
10551,1,0,30,0,-30
10552,1,0,26,0,-26
10553,0,0,46,0,-46
10554,1,1,163,1315,1152
10555,0,0,29,0,-29
10556,0,0,2,0,-2
10557,1,0,80,0,-80
10558,0,0,110,0,-110
10559,1,0,37,0,-37
10560,0,0,38,0,-38
10561,0,0,6,0,-6
10562,0,0,62,0,-62
10563,0,0,4,0,-4
10564,1,1,177,2398,2221
10565,1,1,156,1446,1290
10566,0,0,6,0,-6
10567,1,0,51,0,-51
10568,0,0,53,0,-53
10569,1,0,41,0,-41
10570,0,0,14,0,-14
10571,1,1,199,1451,1252
10572,1,0,23,0,-23
10573,0,0,5,0,-5
10574,1,0,90,0,-90
10575,0,0,12,0,-12
10576,0,0,6,0,-6
10577,0,0,18,0,-18
10578,0,0,78,0,-78
10579,1,1,21,1306,1285
10580,0,0,19,0,-19
10581,0,0,40,0,-40
10582,1,0,159,0,-159
10583,0,0,64,0,-64
10584,0,0,42,0,-42
10585,1,0,10,0,-10
10586,0,0,118,0,-118
10587,1,0,15,0,-15
10588,1,0,74,0,-74
10589,1,1,277,1499,1222
10590,1,1,139,1501,1362
10591,0,0,51,0,-51
10592,0,0,40,0,-40
10593,1,0,39,0,-39
10594,0,0,20,0,-20
10595,1,0,8,0,-8
10596,1,0,50,0,-50
10597,1,0,42,0,-42
10598,1,0,10,0,-10
10599,1,1,442,1280,838
10600,1,1,510,1302,792
10601,1,1,248,1338,1090
10602,1,1,109,2661,2552
10603,0,0,5,0,-5
10604,1,0,56,0,-56
10605,1,0,124,0,-124
10606,0,0,8,0,-8
10607,0,0,9,0,-9
10608,0,0,47,0,-47
10609,1,0,74,0,-74
10610,1,1,1161,1529,368
10611,1,1,622,1401,779
10612,1,1,144,1240,1096
10613,1,1,245,1227,982
10614,1,1,1638,2259,621
10615,1,1,1017,1209,192
10616,0,0,4,0,-4
10617,1,1,493,1419,926
10618,1,1,221,1284,1063
10619,0,0,5,0,-5
10620,0,0,38,0,-38
10621,0,0,22,0,-22
10622,0,0,12,0,-12
10623,0,0,100,0,-100
10624,0,0,21,0,-21
10625,1,1,267,1238,971
10626,0,0,19,0,-19
10627,0,0,33,0,-33
10628,1,1,1188,1822,634
10629,0,0,8,0,-8
10630,1,1,407,1480,1073
10631,0,0,93,0,-93
10632,0,0,152,0,-152
10633,1,0,83,0,-83
10634,0,0,73,0,-73
10635,1,1,920,1257,337
10636,0,0,38,0,-38
10637,0,0,19,0,-19
10638,1,1,679,1317,638
10639,1,1,1240,1261,21
10640,0,0,5,0,-5
10641,0,0,21,0,-21
10642,0,0,74,0,-74
10643,0,0,32,0,-32
10644,1,0,4,0,-4
10645,0,0,67,0,-67
10646,1,1,2194,1294,-900
10647,0,0,98,0,-98
10648,0,0,15,0,-15
10649,1,1,1006,1241,235
10650,0,0,82,0,-82
10651,1,1,385,1325,940
10652,1,1,1148,1844,696
10653,0,0,12,0,-12
10654,0,0,109,0,-109
10655,1,0,45,0,-45
10656,0,0,7,0,-7
10657,1,1,5,1392,1387
10658,1,0,23,0,-23
10659,1,1,196,1581,1385
10660,1,1,498,1368,870
10661,1,1,740,1282,542
10662,0,0,12,0,-12
10663,1,0,19,0,-19
10664,0,0,15,0,-15
10665,1,1,165,1204,1039
10666,1,0,67,0,-67
10667,1,1,325,1280,955
10668,1,1,836,1616,780
10669,1,0,13,0,-13
10670,0,0,36,0,-36
10671,0,0,97,0,-97
10672,0,0,155,0,-155
10673,1,0,6,0,-6
10674,1,1,52,1561,1509
10675,1,0,85,0,-85
10676,1,0,29,0,-29
10677,1,1,97,1216,1119
10678,1,0,170,0,-170
10679,1,1,521,1440,919
10680,0,0,26,0,-26
10681,1,0,91,0,-91
10682,0,0,31,0,-31
10683,0,0,11,0,-11
10684,0,0,28,0,-28
10685,1,1,981,1273,292
10686,0,0,12,0,-12
10687,1,1,40,2415,2375
10688,1,1,482,1850,1368
10689,1,0,92,0,-92
10690,1,1,310,1361,1051
10691,1,0,179,0,-179
10692,1,0,16,0,-16
10693,0,0,69,0,-69
10694,0,0,67,0,-67
10695,1,1,171,2790,2619
10696,1,0,61,0,-61
10697,1,1,881,1563,682
10698,1,0,34,0,-34
10699,1,1,181,1213,1032
10700,1,1,80,1699,1619
10701,1,1,84,1329,1245
10702,1,1,476,1456,980
10703,0,0,127,0,-127
10704,0,0,130,0,-130
10705,0,0,108,0,-108
10706,1,1,652,1302,650
10707,1,1,3570,1290,-2280
10708,1,1,178,1480,1302
10709,0,0,52,0,-52
10710,0,0,19,0,-19
10711,0,0,5,0,-5
10712,0,0,52,0,-52
10713,0,0,20,0,-20
10714,0,0,45,0,-45
10715,0,0,11,0,-11
10716,1,1,279,1924,1645
10717,1,0,41,0,-41
10718,0,0,52,0,-52
10719,1,0,9,0,-9
10720,1,0,171,0,-171
10721,1,1,302,1411,1109
10722,0,0,4,0,-4
10723,0,0,20,0,-20
10724,1,0,112,0,-112
10725,1,0,66,0,-66
10726,1,1,194,1429,1235
10727,0,0,5,0,-5
10728,1,1,89,1396,1307
10729,0,0,25,0,-25
10730,0,0,17,0,-17
10731,0,0,17,0,-17
10732,0,0,39,0,-39
10733,1,1,994,1560,566
10734,1,0,23,0,-23
10735,0,0,33,0,-33
10736,1,0,19,0,-19
10737,1,0,41,0,-41
10738,1,0,8,0,-8
10739,0,0,182,0,-182
10740,1,0,233,0,-233
10741,0,0,58,0,-58
10742,0,0,29,0,-29
10743,0,0,49,0,-49
10744,1,0,51,0,-51
10745,1,0,22,0,-22
10746,1,0,46,0,-46
10747,1,0,64,0,-64
10748,1,1,718,1520,802
10749,1,0,48,0,-48
10750,0,0,45,0,-45
10751,0,0,13,0,-13
10752,0,0,64,0,-64
10753,0,0,80,0,-80
10754,1,0,35,0,-35
10755,0,0,34,0,-34
10756,1,1,706,1406,700
10757,1,0,12,0,-12
10758,0,0,49,0,-49
10759,0,0,208,0,-208
10760,1,1,153,1508,1355
10761,0,0,20,0,-20
10762,1,0,13,0,-13
10763,1,1,1077,1626,549
10764,0,0,93,0,-93
10765,0,0,3,0,-3
10766,1,0,14,0,-14
10767,1,0,45,0,-45
10768,1,0,105,0,-105
10769,1,1,267,1815,1548
10770,0,0,60,0,-60
10771,0,0,26,0,-26
10772,0,0,8,0,-8
10773,1,1,907,1429,522
10774,1,1,3097,2951,-146
10775,0,0,56,0,-56
10776,0,0,25,0,-25
10777,1,1,2036,1500,-536
10778,1,0,21,0,-21
10779,0,0,29,0,-29
10780,1,1,266,1433,1167
10781,1,1,144,1372,1228
10782,0,0,6,0,-6
10783,0,0,39,0,-39
10784,1,1,279,2082,1803
10785,0,0,17,0,-17
10786,0,0,31,0,-31
10787,0,0,37,0,-37
10788,1,0,120,0,-120
10789,1,0,32,0,-32
10790,1,0,11,0,-11
10791,0,0,9,0,-9
10792,1,1,288,1749,1461
10793,0,0,31,0,-31
10794,1,0,19,0,-19
10795,1,1,244,1236,992
10796,0,0,5,0,-5
10797,1,1,455,2488,2033
10798,1,1,700,3253,2553
10799,1,0,42,0,-42
10800,0,0,17,0,-17
10801,0,0,110,0,-110
10802,1,1,131,1243,1112
10803,1,1,1185,1522,337
10804,0,0,54,0,-54
10805,1,1,529,1990,1461
10806,0,0,10,0,-10
10807,0,0,58,0,-58
10808,0,0,31,0,-31
10809,1,1,150,2102,1952
10810,1,0,27,0,-27
10811,1,1,246,1365,1119
10812,1,0,100,0,-100
10813,1,1,121,1613,1492
10814,1,0,50,0,-50
10815,1,0,73,0,-73
10816,1,1,230,1461,1231
10817,1,1,587,2183,1596
10818,1,1,1658,1773,115
10819,1,1,458,1690,1232
10820,1,1,422,1394,972
10821,0,0,21,0,-21
10822,1,1,35,1302,1267
10823,1,1,179,2177,1998
10824,1,1,809,1704,895
10825,1,1,726,1242,516
10826,1,0,17,0,-17
10827,1,0,61,0,-61
10828,1,0,18,0,-18
10829,0,0,30,0,-30
10830,1,0,1,0,-1
10831,0,0,9,0,-9
10832,0,0,19,0,-19
10833,1,1,176,1455,1279
10834,1,0,214,0,-214
10835,1,0,52,0,-52
10836,1,0,77,0,-77
10837,1,1,342,1783,1441
10838,1,1,507,1407,900
10839,1,0,21,0,-21
10840,0,0,64,0,-64
10841,1,1,503,1435,932
10842,1,0,17,0,-17
10843,1,0,6,0,-6
10844,1,1,1390,1904,514
10845,1,1,723,1574,851
10846,0,0,53,0,-53
10847,1,1,89,1677,1588
10848,0,0,4,0,-4
10849,1,1,305,1255,950
10850,0,0,45,0,-45
10851,1,0,17,0,-17
10852,1,1,938,1514,576
10853,1,0,25,0,-25
10854,1,0,115,0,-115
10855,0,0,6,0,-6
10856,1,0,29,0,-29
10857,1,1,502,1706,1204
10858,0,0,121,0,-121
10859,1,1,1015,1242,227
10860,0,0,11,0,-11
10861,1,1,242,1680,1438
10862,0,0,30,0,-30
10863,1,0,4,0,-4
10864,1,1,196,1538,1342
10865,0,0,2,0,-2
10866,1,1,226,1486,1260
10867,1,0,1,0,-1
10868,1,1,517,1255,738
10869,1,0,17,0,-17
10870,1,1,109,2175,2066
10871,1,0,44,0,-44
10872,1,1,121,1285,1164
10873,0,0,61,0,-61
10874,0,0,86,0,-86
10875,1,0,15,0,-15
10876,0,0,65,0,-65
10877,1,0,36,0,-36
10878,1,1,955,3080,2125
10879,0,0,42,0,-42
10880,1,1,132,1898,1766
10881,0,0,141,0,-141
10882,1,0,3,0,-3
10883,0,0,114,0,-114
10884,0,0,36,0,-36
10885,1,1,184,2394,2210
10886,0,0,91,0,-91
10887,1,1,534,2111,1577
10888,0,0,20,0,-20
10889,1,1,5,2412,2407
10890,0,0,25,0,-25
10891,1,1,557,1448,891
10892,0,0,3,0,-3
10893,0,0,81,0,-81
10894,1,1,861,1455,594
10895,1,0,119,0,-119
10896,1,1,1615,1861,246
10897,0,0,99,0,-99
10898,0,0,52,0,-52
10899,1,1,340,1513,1173
10900,0,0,15,0,-15
10901,1,0,41,0,-41
10902,1,0,179,0,-179
10903,1,1,1246,1617,371
10904,1,1,612,1814,1202
10905,1,1,426,1269,843
10906,0,0,165,0,-165
10907,0,0,104,0,-104
10908,1,0,111,0,-111
10909,0,0,2,0,-2
10910,0,0,117,0,-117
10911,1,1,28,1410,1382
10912,1,0,10,0,-10
10913,1,1,512,1332,820
10914,1,1,202,1665,1463
10915,1,0,35,0,-35
10916,1,0,39,0,-39
10917,1,0,35,0,-35
10918,1,1,530,1504,974
10919,1,0,33,0,-33
10920,0,0,51,0,-51
10921,1,0,29,0,-29
10922,1,0,0,0,0
10923,0,0,8,0,-8
10924,0,0,6,0,-6
10925,1,0,45,0,-45
10926,1,1,837,1406,569
10927,0,0,19,0,-19
10928,1,0,97,0,-97
10929,0,0,3,0,-3
10930,0,0,29,0,-29
10931,1,1,741,1521,780
10932,1,1,52,1740,1688
10933,0,0,50,0,-50
10934,0,0,54,0,-54
10935,1,0,247,0,-247
10936,1,1,51,1228,1177
10937,0,0,25,0,-25
10938,0,0,8,0,-8
10939,1,1,307,1332,1025
10940,1,1,1142,1217,75
10941,1,0,60,0,-60
10942,1,1,676,1983,1307
10943,0,0,83,0,-83
10944,1,0,1,0,-1
10945,0,0,75,0,-75
10946,1,0,17,0,-17
10947,0,0,85,0,-85
10948,1,0,2,0,-2
10949,0,0,10,0,-10
10950,1,0,66,0,-66
10951,1,0,67,0,-67
10952,1,1,1155,1280,125
10953,0,0,59,0,-59
10954,0,0,54,0,-54
10955,0,0,115,0,-115
10956,1,0,149,0,-149
10957,1,1,605,1896,1291
10958,1,1,504,1210,706
10959,0,0,53,0,-53
10960,0,0,47,0,-47
10961,1,0,44,0,-44
10962,0,0,68,0,-68
10963,1,1,32,1646,1614
10964,1,0,104,0,-104
10965,1,0,161,0,-161
10966,1,0,80,0,-80
10967,0,0,101,0,-101
10968,0,0,38,0,-38
10969,1,0,63,0,-63
10970,1,0,44,0,-44
10971,0,0,127,0,-127
10972,0,0,27,0,-27
10973,0,0,49,0,-49
10974,1,1,4090,2387,-1703
10975,0,0,4,0,-4
10976,1,1,326,1448,1122
10977,1,1,95,1445,1350
10978,1,0,8,0,-8
10979,1,0,41,0,-41
10980,1,0,124,0,-124
10981,1,1,504,1962,1458
10982,1,1,578,1841,1263
10983,0,0,10,0,-10
10984,1,1,234,1566,1332
10985,0,0,22,0,-22
10986,0,0,4,0,-4
10987,0,0,5,0,-5
10988,1,1,287,1390,1103
10989,0,0,33,0,-33
10990,0,0,48,0,-48
10991,0,0,125,0,-125
10992,0,0,47,0,-47
10993,0,0,13,0,-13
10994,1,0,139,0,-139
10995,0,0,140,0,-140
10996,0,0,41,0,-41
10997,1,1,159,1383,1224
10998,1,0,48,0,-48
10999,1,1,1052,1535,483
11000,0,0,13,0,-13
11001,1,0,14,0,-14
11002,1,1,251,1625,1374
11003,1,0,11,0,-11
11004,0,0,33,0,-33
11005,1,1,1746,2518,772
11006,0,0,46,0,-46
11007,0,0,30,0,-30
11008,0,0,108,0,-108
11009,1,0,165,0,-165
11010,1,1,398,2111,1713
11011,1,0,252,0,-252
11012,1,0,8,0,-8
11013,1,1,414,1983,1569
11014,1,0,83,0,-83
11015,1,1,309,1460,1151
11016,0,0,15,0,-15
11017,0,0,53,0,-53
11018,0,0,38,0,-38
11019,0,0,28,0,-28
11020,1,1,535,1270,735
11021,1,0,23,0,-23
11022,1,1,1177,2938,1761
11023,1,0,27,0,-27
11024,0,0,6,0,-6
11025,0,0,12,0,-12
11026,1,0,11,0,-11
11027,0,0,285,0,-285
11028,0,0,20,0,-20
11029,0,0,15,0,-15
11030,1,1,592,1226,634
11031,1,0,181,0,-181
11032,1,1,326,1246,920
11033,1,0,20,0,-20
11034,0,0,108,0,-108
11035,1,0,85,0,-85
11036,1,1,341,1446,1105
11037,1,1,530,1680,1150
11038,0,0,48,0,-48
11039,0,0,52,0,-52
11040,1,1,1516,1276,-240
11041,1,0,4,0,-4
11042,0,0,31,0,-31
11043,0,0,31,0,-31
11044,1,1,1226,1236,10
11045,1,1,414,1311,897
11046,0,0,122,0,-122
11047,0,0,56,0,-56
11048,1,1,388,1327,939
11049,1,0,78,0,-78
11050,0,0,20,0,-20
11051,1,1,301,1329,1028
11052,0,0,64,0,-64
11053,0,0,11,0,-11
11054,0,0,13,0,-13
11055,1,0,21,0,-21
11056,1,0,9,0,-9
11057,1,1,72,1449,1377
11058,1,1,1265,1288,23
11059,0,0,176,0,-176
11060,1,1,279,1243,964
11061,0,0,30,0,-30
11062,1,0,32,0,-32
11063,1,0,15,0,-15
11064,1,0,30,0,-30
11065,1,1,847,1691,844
11066,1,1,231,1870,1639
11067,1,1,465,2696,2231
11068,0,0,39,0,-39
11069,1,0,1,0,-1
11070,1,0,32,0,-32
11071,1,0,65,0,-65
11072,1,1,434,1456,1022
11073,1,1,2531,1801,-730
11074,0,0,34,0,-34
11075,1,1,215,1453,1238
11076,1,1,137,1274,1137
11077,0,0,113,0,-113
11078,1,0,20,0,-20
11079,1,0,7,0,-7
11080,1,0,105,0,-105
11081,1,1,322,1285,963
11082,0,0,47,0,-47
11083,1,0,11,0,-11
11084,1,0,31,0,-31
11085,1,0,35,0,-35
11086,1,0,47,0,-47
11087,1,1,1483,1648,165
11088,1,1,770,1830,1060
11089,1,1,533,1443,910
11090,1,0,46,0,-46
11091,1,0,111,0,-111
11092,0,0,7,0,-7
11093,0,0,16,0,-16
11094,1,0,35,0,-35
11095,0,0,9,0,-9
11096,0,0,161,0,-161
11097,1,1,766,1234,468
11098,1,1,365,2621,2256
11099,0,0,62,0,-62
11100,0,0,121,0,-121
11101,0,0,14,0,-14
11102,1,1,89,1594,1505
11103,1,0,2,0,-2
11104,0,0,8,0,-8
11105,0,0,34,0,-34
11106,1,0,8,0,-8
11107,1,1,1409,7854,6445
11108,0,0,108,0,-108
11109,1,1,106,1752,1646
11110,0,0,1,0,-1
11111,1,0,34,0,-34
11112,0,0,24,0,-24
11113,0,0,38,0,-38
11114,0,0,30,0,-30
11115,0,0,122,0,-122
11116,1,1,296,1231,935
11117,0,0,148,0,-148
11118,0,0,60,0,-60
11119,0,0,30,0,-30
11120,1,0,17,0,-17
11121,0,0,147,0,-147
11122,1,1,167,1912,1745
11123,1,0,449,0,-449
11124,0,0,38,0,-38
11125,1,0,129,0,-129
11126,1,1,530,1307,777
11127,1,0,12,0,-12
11128,0,0,36,0,-36
11129,1,1,142,1307,1165
11130,1,1,289,1787,1498
11131,1,1,507,1233,726
11132,1,0,99,0,-99
11133,0,0,24,0,-24
11134,1,0,69,0,-69
11135,1,1,483,1247,764
11136,1,1,859,1239,380
11137,1,1,219,1254,1035
11138,1,1,1149,1360,211
11139,1,1,233,1627,1394
11140,1,1,156,1448,1292
11141,1,0,59,0,-59
11142,1,0,13,0,-13
11143,0,0,33,0,-33
11144,1,0,98,0,-98
11145,0,0,44,0,-44
11146,1,0,44,0,-44
11147,1,1,1443,1240,-203
11148,0,0,54,0,-54
11149,1,1,43,1354,1311
11150,0,0,34,0,-34
11151,1,0,78,0,-78
11152,1,0,13,0,-13
11153,0,0,28,0,-28
11154,0,0,27,0,-27
11155,1,0,1,0,-1
11156,1,1,448,1253,805
11157,0,0,47,0,-47
11158,0,0,32,0,-32
11159,0,0,36,0,-36
11160,1,0,42,0,-42
11161,1,1,246,1302,1056
11162,1,0,76,0,-76
11163,0,0,68,0,-68
11164,0,0,0,0,0
11165,1,1,88,2947,2859
11166,0,0,79,0,-79
11167,0,0,69,0,-69
11168,1,1,30,2707,2677
11169,0,0,30,0,-30
11170,1,0,1,0,-1
11171,0,0,60,0,-60
11172,1,1,1704,1350,-354
11173,0,0,43,0,-43
11174,1,0,102,0,-102
11175,1,1,491,1204,713
11176,0,0,99,0,-99
11177,0,0,18,0,-18
11178,1,0,36,0,-36
11179,1,1,838,2278,1440
11180,0,0,90,0,-90
11181,1,1,313,1456,1143
11182,1,0,3,0,-3
11183,1,0,96,0,-96
11184,1,1,867,1841,974
11185,1,1,1079,1387,308
11186,0,0,15,0,-15
11187,0,0,33,0,-33
11188,1,1,190,2009,1819
11189,0,0,43,0,-43
11190,1,1,1286,1617,331
11191,0,0,132,0,-132
11192,0,0,57,0,-57
11193,1,1,34,1207,1173
11194,1,0,20,0,-20
11195,1,0,16,0,-16
11196,0,0,83,0,-83
11197,1,1,245,1318,1073
11198,1,0,128,0,-128
11199,0,0,22,0,-22
11200,1,0,12,0,-12
11201,1,0,28,0,-28
11202,1,1,226,2106,1880
11203,1,1,116,1599,1483
11204,0,0,78,0,-78
11205,1,0,116,0,-116
11206,0,0,8,0,-8
11207,1,0,33,0,-33
11208,1,0,104,0,-104
11209,1,0,8,0,-8
11210,1,0,93,0,-93
11211,0,0,32,0,-32
11212,1,1,55,1293,1238
11213,0,0,122,0,-122
11214,1,1,398,2431,2033
11215,1,1,436,1357,921
11216,1,1,1950,1743,-207
11217,1,1,960,1242,282
11218,0,0,23,0,-23
11219,1,0,219,0,-219
11220,0,0,36,0,-36
11221,0,0,52,0,-52
11222,1,1,196,1506,1310
11223,0,0,110,0,-110
11224,1,0,167,0,-167
11225,1,0,116,0,-116
11226,0,0,2,0,-2
11227,0,0,130,0,-130
11228,1,0,43,0,-43
11229,0,0,36,0,-36
11230,1,1,359,1651,1292
11231,1,1,321,2309,1988
11232,1,0,76,0,-76
11233,0,0,10,0,-10
11234,0,0,8,0,-8
11235,0,0,44,0,-44
11236,1,0,0,0,0
11237,1,1,299,1658,1359
11238,1,1,1066,1820,754
11239,1,0,45,0,-45
11240,1,0,34,0,-34
11241,1,0,41,0,-41
11242,1,1,274,1464,1190
11243,1,1,803,1283,480
11244,0,0,54,0,-54
11245,0,0,108,0,-108
11246,0,0,57,0,-57
11247,1,0,21,0,-21
11248,1,0,97,0,-97
11249,0,0,64,0,-64
11250,1,0,9,0,-9
11251,1,1,993,1358,365
11252,1,0,15,0,-15
11253,0,0,31,0,-31
11254,0,0,48,0,-48
11255,0,0,21,0,-21
11256,0,0,11,0,-11
11257,1,1,578,1739,1161
11258,0,0,113,0,-113
11259,1,1,132,2574,2442
11260,1,0,29,0,-29
11261,1,1,147,2238,2091
11262,0,0,18,0,-18
11263,1,0,16,0,-16
11264,1,1,1016,1547,531
11265,1,0,18,0,-18
11266,0,0,134,0,-134
11267,1,0,28,0,-28
11268,0,0,90,0,-90
11269,1,0,0,0,0
11270,0,0,72,0,-72
11271,1,1,349,1321,972
11272,0,0,110,0,-110
11273,0,0,39,0,-39
11274,0,0,59,0,-59
11275,1,0,81,0,-81
11276,1,0,70,0,-70
11277,1,0,75,0,-75
11278,1,1,164,1214,1050
11279,0,0,116,0,-116
11280,1,1,278,1486,1208
11281,0,0,271,0,-271
11282,0,0,1,0,-1
11283,1,0,10,0,-10
11284,0,0,27,0,-27
11285,0,0,20,0,-20
11286,1,0,10,0,-10
11287,0,0,19,0,-19
11288,1,0,4,0,-4
11289,1,1,314,2272,1958
11290,1,1,103,3090,2987
11291,0,0,15,0,-15
11292,0,0,7,0,-7
11293,1,1,25,1865,1840
11294,1,0,32,0,-32
11295,1,0,13,0,-13
11296,0,0,50,0,-50
11297,0,0,2,0,-2
11298,1,0,35,0,-35
11299,0,0,30,0,-30
11300,1,0,0,0,0
11301,0,0,23,0,-23
11302,0,0,184,0,-184
11303,0,0,8,0,-8
11304,0,0,77,0,-77
11305,0,0,9,0,-9
11306,0,0,24,0,-24
11307,1,1,77,1221,1144
11308,1,0,0,0,0
11309,1,1,640,1388,748
11310,1,0,19,0,-19
11311,1,0,11,0,-11
11312,1,1,183,1866,1683
11313,0,0,25,0,-25
11314,1,1,1103,1282,179
11315,1,0,175,0,-175
11316,1,1,41,1243,1202
11317,1,1,722,2158,1436
11318,1,1,1044,1287,243
11319,0,0,57,0,-57
11320,0,0,19,0,-19
11321,1,0,36,0,-36
11322,0,0,112,0,-112
11323,1,0,144,0,-144
11324,0,0,32,0,-32
11325,1,0,129,0,-129
11326,1,0,38,0,-38
11327,1,1,98,1425,1327
11328,1,0,21,0,-21
11329,0,0,107,0,-107
11330,1,0,19,0,-19
11331,1,1,252,1668,1416
11332,0,0,18,0,-18
11333,0,0,29,0,-29
11334,1,0,1,0,-1
11335,1,0,15,0,-15
11336,0,0,20,0,-20
11337,1,0,124,0,-124
11338,1,1,150,1314,1164
11339,0,0,33,0,-33
11340,0,0,136,0,-136
11341,0,0,54,0,-54
11342,1,1,244,1267,1023
11343,1,1,170,2702,2532
11344,0,0,2,0,-2
11345,1,0,118,0,-118
11346,1,0,17,0,-17
11347,0,0,33,0,-33
11348,0,0,65,0,-65
11349,1,1,400,1737,1337
11350,0,0,200,0,-200
11351,0,0,8,0,-8
11352,0,0,4,0,-4
11353,1,1,367,1290,923
11354,1,1,297,1406,1109
11355,1,1,540,1552,1012
11356,1,1,473,1396,923
11357,0,0,6,0,-6
11358,1,1,608,1359,751
11359,1,0,37,0,-37
11360,0,0,39,0,-39
11361,0,0,68,0,-68
11362,1,1,599,1215,616
11363,1,1,426,1792,1366
11364,1,1,1197,2418,1221
11365,1,0,119,0,-119
11366,0,0,68,0,-68
11367,0,0,56,0,-56
11368,0,0,48,0,-48
11369,1,1,554,1825,1271
11370,1,0,50,0,-50
11371,1,1,43,1327,1284
11372,0,0,148,0,-148
11373,1,0,118,0,-118
11374,0,0,16,0,-16
11375,0,0,10,0,-10
11376,1,0,0,0,0
11377,1,0,7,0,-7
11378,1,1,1303,1272,-31
11379,0,0,70,0,-70
11380,0,0,114,0,-114
11381,1,0,17,0,-17
11382,1,0,30,0,-30
11383,0,0,13,0,-13
11384,1,0,16,0,-16
11385,1,1,239,1297,1058
11386,1,1,122,1650,1528
11387,1,1,524,2870,2346
11388,1,0,46,0,-46
11389,1,0,199,0,-199
11390,1,1,566,1623,1057
11391,0,0,37,0,-37
11392,1,0,24,0,-24
11393,0,0,83,0,-83
11394,1,1,2715,1713,-1002
11395,0,0,18,0,-18
11396,1,0,21,0,-21
11397,1,0,26,0,-26
11398,1,1,1276,1268,-8
11399,1,0,7,0,-7
11400,1,0,6,0,-6
11401,1,1,90,2041,1951
11402,0,0,7,0,-7
11403,1,1,294,1262,968
11404,0,0,68,0,-68
11405,1,1,1207,1702,495
11406,0,0,24,0,-24
11407,1,1,316,1290,974
11408,1,1,149,1203,1054
11409,0,0,17,0,-17
11410,0,0,22,0,-22
11411,0,0,12,0,-12
11412,1,0,3,0,-3
11413,1,1,415,1683,1268
11414,1,0,15,0,-15
11415,1,1,158,1224,1066
11416,1,1,776,1357,581
11417,0,0,33,0,-33
11418,0,0,26,0,-26
11419,1,0,6,0,-6
11420,0,0,0,0,0
11421,1,0,57,0,-57
11422,1,0,28,0,-28
11423,1,1,543,1202,659
11424,0,0,9,0,-9
11425,1,1,145,1565,1420
11426,0,0,1,0,-1
11427,1,0,42,0,-42
11428,0,0,60,0,-60
11429,0,0,7,0,-7
11430,0,0,21,0,-21
11431,1,0,17,0,-17
11432,0,0,23,0,-23
11433,1,0,18,0,-18
11434,0,0,21,0,-21
11435,1,0,57,0,-57
11436,0,0,0,0,0
11437,1,1,484,1874,1390
11438,1,1,59,1269,1210
11439,1,0,34,0,-34
11440,0,0,410,0,-410
11441,0,0,329,0,-329
11442,1,1,358,1257,899
11443,1,1,5612,1570,-4042
11444,0,0,25,0,-25
11445,1,0,63,0,-63
11446,1,1,491,1682,1191
11447,1,1,776,1331,555
11448,1,0,74,0,-74
11449,1,1,124,1896,1772
11450,0,0,62,0,-62
11451,1,1,354,1523,1169
11452,1,0,5,0,-5
11453,0,0,12,0,-12
11454,1,1,1046,1645,599
11455,0,0,69,0,-69
11456,1,0,52,0,-52
11457,1,1,1195,1397,202
11458,0,0,79,0,-79
11459,1,1,158,1359,1201
11460,0,0,5,0,-5
11461,1,1,664,1359,695
11462,0,0,13,0,-13
11463,1,1,1124,1626,502
11464,1,0,52,0,-52
11465,0,0,32,0,-32
11466,0,0,49,0,-49
11467,0,0,2,0,-2
11468,1,0,2,0,-2
11469,0,0,66,0,-66
11470,1,0,10,0,-10
11471,1,0,64,0,-64
11472,0,0,29,0,-29
11473,0,0,85,0,-85
11474,1,1,1552,2520,968
11475,0,0,11,0,-11
11476,1,1,924,2325,1401
11477,1,1,67,1451,1384
11478,1,1,399,1767,1368
11479,1,0,21,0,-21
11480,0,0,42,0,-42
11481,0,0,52,0,-52
11482,1,0,68,0,-68
11483,0,0,97,0,-97
11484,0,0,48,0,-48
11485,0,0,19,0,-19
11486,1,0,132,0,-132
11487,1,1,266,2989,2723
11488,1,1,846,1368,522
11489,1,1,48,1224,1176
11490,1,1,2246,1477,-769
11491,1,1,102,1539,1437
11492,0,0,160,0,-160
11493,1,0,34,0,-34
11494,0,0,36,0,-36
11495,0,0,56,0,-56
11496,1,1,118,1481,1363
11497,0,0,86,0,-86
11498,1,0,9,0,-9
11499,1,1,122,1397,1275
11500,1,0,3,0,-3
11501,0,0,15,0,-15
11502,1,0,76,0,-76
11503,0,0,42,0,-42
11504,1,0,56,0,-56
11505,0,0,24,0,-24
11506,0,0,84,0,-84
11507,0,0,43,0,-43
11508,1,0,32,0,-32
11509,1,0,74,0,-74
11510,0,0,6,0,-6
11511,0,0,15,0,-15
11512,1,0,25,0,-25
11513,0,0,5,0,-5
11514,1,1,1125,1350,225
11515,0,0,23,0,-23
11516,0,0,25,0,-25
11517,1,1,869,1536,667
11518,0,0,68,0,-68
11519,0,0,150,0,-150
11520,1,1,735,1631,896
11521,0,0,95,0,-95
11522,0,0,7,0,-7
11523,0,0,41,0,-41
11524,0,0,28,0,-28
11525,1,0,7,0,-7
11526,0,0,10,0,-10
11527,1,1,227,1457,1230
11528,0,0,54,0,-54
11529,1,1,393,1415,1022
11530,1,0,20,0,-20
11531,1,0,34,0,-34
11532,1,1,150,7257,7107
11533,1,0,33,0,-33
11534,1,0,83,0,-83
11535,1,1,823,1347,524
11536,1,1,194,1487,1293
11537,0,0,64,0,-64
11538,0,0,182,0,-182
11539,1,0,310,0,-310
11540,0,0,10,0,-10
11541,0,0,185,0,-185
11542,1,1,486,1999,1513
11543,0,0,5,0,-5
11544,1,1,422,1220,798
11545,1,0,7,0,-7
11546,1,0,106,0,-106
11547,0,0,56,0,-56
11548,0,0,81,0,-81
11549,1,0,0,0,0
11550,0,0,39,0,-39
11551,0,0,3,0,-3
11552,1,0,175,0,-175
11553,0,0,0,0,0
11554,0,0,43,0,-43
11555,1,0,3,0,-3
11556,0,0,117,0,-117
11557,1,0,6,0,-6
11558,0,0,32,0,-32
11559,0,0,63,0,-63
11560,1,1,193,1218,1025
11561,1,0,39,0,-39
11562,0,0,16,0,-16
11563,1,0,23,0,-23
11564,0,0,3,0,-3
11565,1,1,447,1556,1109
11566,0,0,48,0,-48
11567,1,1,744,1253,509
11568,0,0,76,0,-76
11569,1,1,734,1876,1142
11570,0,0,48,0,-48
11571,1,1,481,3052,2571
11572,0,0,9,0,-9
11573,0,0,72,0,-72
11574,1,0,22,0,-22
11575,0,0,126,0,-126
11576,0,0,134,0,-134
11577,0,0,44,0,-44
11578,1,0,136,0,-136
11579,1,1,298,1457,1159
11580,1,1,338,1565,1227
11581,1,0,51,0,-51
11582,0,0,30,0,-30
11583,1,1,61,1652,1591
11584,1,1,512,1647,1135
11585,0,0,39,0,-39
11586,1,1,109,1219,1110
11587,1,0,3,0,-3
11588,1,1,420,2098,1678
11589,1,1,440,2807,2367
11590,0,0,58,0,-58
11591,1,0,48,0,-48
11592,1,0,33,0,-33
11593,1,0,30,0,-30
11594,1,1,530,2226,1696
11595,1,0,48,0,-48
11596,0,0,43,0,-43
11597,1,1,1096,1627,531
11598,0,0,7,0,-7
11599,1,0,3,0,-3
11600,1,1,260,2187,1927
11601,0,0,27,0,-27
11602,1,1,72,2235,2163
11603,0,0,107,0,-107
11604,0,0,8,0,-8
11605,1,0,12,0,-12
11606,0,0,26,0,-26
11607,1,1,719,1498,779
11608,0,0,35,0,-35
11609,1,1,297,1339,1042
11610,0,0,74,0,-74
11611,1,1,510,1735,1225
11612,1,0,116,0,-116
11613,0,0,137,0,-137
11614,1,0,48,0,-48
11615,1,1,354,1548,1194
11616,1,1,578,1286,708
11617,1,0,48,0,-48
11618,0,0,26,0,-26
11619,1,1,506,1239,733
11620,1,0,20,0,-20
11621,0,0,13,0,-13
11622,1,1,628,1742,1114
11623,0,0,44,0,-44
11624,0,0,1,0,-1
11625,1,0,18,0,-18
11626,0,0,1,0,-1
11627,0,0,3,0,-3
11628,0,0,8,0,-8
11629,1,1,321,1415,1094
11630,1,0,36,0,-36
11631,1,1,1252,1349,97
11632,1,0,21,0,-21
11633,1,1,269,1238,969
11634,0,0,58,0,-58
11635,0,0,55,0,-55
11636,0,0,32,0,-32
11637,1,0,47,0,-47
11638,0,0,4,0,-4
11639,0,0,15,0,-15
11640,1,1,106,1209,1103
11641,1,1,178,1901,1723
11642,1,1,134,1571,1437
11643,1,1,798,1228,430
11644,0,0,16,0,-16
11645,1,0,133,0,-133
11646,1,1,439,1755,1316
11647,1,1,237,1273,1036
11648,0,0,51,0,-51
11649,1,0,151,0,-151
11650,1,0,14,0,-14
11651,1,0,15,0,-15
11652,1,1,197,1237,1040
11653,1,1,560,1533,973
11654,1,1,841,1301,460
11655,1,1,169,1216,1047
11656,0,0,180,0,-180
11657,1,0,73,0,-73
11658,0,0,5,0,-5
11659,1,1,1308,1334,26
11660,0,0,13,0,-13
11661,1,0,12,0,-12
11662,0,0,2,0,-2
11663,0,0,70,0,-70
11664,0,0,7,0,-7
11665,0,0,13,0,-13
11666,1,1,397,1627,1230
11667,1,0,20,0,-20
11668,1,0,37,0,-37
11669,1,1,223,1416,1193
11670,0,0,123,0,-123
11671,0,0,30,0,-30
11672,1,1,1125,1380,255
11673,1,1,464,1581,1117
11674,0,0,45,0,-45
11675,0,0,89,0,-89
11676,0,0,10,0,-10
11677,0,0,14,0,-14
11678,0,0,163,0,-163
11679,1,1,609,2059,1450
11680,0,0,35,0,-35
11681,0,0,42,0,-42
11682,1,0,24,0,-24
11683,0,0,92,0,-92
11684,0,0,50,0,-50
11685,1,0,55,0,-55
11686,1,0,14,0,-14
11687,1,1,209,1391,1182
11688,0,0,37,0,-37
11689,1,1,1122,1646,524
11690,0,0,25,0,-25
11691,0,0,53,0,-53
11692,1,0,77,0,-77
11693,0,0,76,0,-76
11694,0,0,63,0,-63
11695,1,1,385,2648,2263
11696,0,0,33,0,-33
11697,1,0,9,0,-9
11698,0,0,39,0,-39
11699,1,0,72,0,-72
11700,1,0,26,0,-26
11701,1,0,29,0,-29
11702,1,1,134,1460,1326
11703,0,0,65,0,-65
11704,1,0,35,0,-35
11705,1,1,205,2344,2139
11706,1,0,51,0,-51
11707,1,1,348,1920,1572
11708,1,1,298,1352,1054
11709,0,0,50,0,-50
11710,1,1,1143,1296,153
11711,0,0,0,0,0
11712,0,0,67,0,-67
11713,1,0,9,0,-9
11714,1,1,318,1585,1267
11715,0,0,2,0,-2
11716,0,0,121,0,-121
11717,1,0,9,0,-9
11718,0,0,15,0,-15
11719,1,0,167,0,-167
11720,1,1,470,1877,1407
11721,0,0,26,0,-26
11722,0,0,57,0,-57
11723,0,0,98,0,-98
11724,0,0,41,0,-41
11725,0,0,66,0,-66
11726,0,0,22,0,-22
11727,0,0,65,0,-65
11728,1,0,28,0,-28
11729,0,0,18,0,-18
11730,1,0,105,0,-105
11731,1,0,41,0,-41
11732,0,0,17,0,-17
11733,1,1,96,1391,1295
11734,1,1,935,2650,1715
11735,1,0,67,0,-67
11736,1,1,614,1360,746
11737,1,0,102,0,-102
11738,1,0,27,0,-27
11739,0,0,92,0,-92
11740,1,1,88,1563,1475
11741,1,1,1245,1604,359
11742,1,0,10,0,-10
11743,1,0,21,0,-21
11744,1,1,544,1212,668
11745,0,0,16,0,-16
11746,0,0,47,0,-47
11747,1,1,485,1459,974
11748,1,1,263,1442,1179
11749,1,1,498,1993,1495
11750,1,0,71,0,-71
11751,1,1,148,1535,1387
11752,0,0,133,0,-133
11753,1,1,199,1609,1410
11754,0,0,11,0,-11
11755,1,1,69,1335,1266
11756,1,1,1522,2195,673
11757,1,1,276,1510,1234
11758,1,0,8,0,-8
11759,1,1,15,1413,1398
11760,1,1,22,2191,2169
11761,0,0,46,0,-46
11762,0,0,70,0,-70
11763,1,0,14,0,-14
11764,0,0,39,0,-39
11765,0,0,29,0,-29
11766,1,0,13,0,-13
11767,0,0,12,0,-12
11768,0,0,56,0,-56
11769,1,0,0,0,0
11770,1,0,32,0,-32
11771,1,1,219,1923,1704
11772,1,1,336,2401,2065
11773,1,0,56,0,-56
11774,0,0,78,0,-78
11775,1,1,157,1267,1110
11776,1,1,318,1651,1333
11777,1,0,135,0,-135
11778,1,1,1270,1786,516
11779,0,0,4,0,-4
11780,0,0,16,0,-16
11781,1,1,300,1467,1167
11782,0,0,41,0,-41
11783,0,0,50,0,-50
11784,1,0,56,0,-56
11785,1,1,157,1271,1114
11786,0,0,120,0,-120
11787,1,0,28,0,-28
11788,1,1,787,1315,528
11789,0,0,4,0,-4
11790,1,0,31,0,-31
11791,1,1,247,1426,1179
11792,1,1,1190,1233,43
11793,1,0,28,0,-28
11794,1,1,172,1223,1051
11795,0,0,12,0,-12
11796,1,0,36,0,-36
11797,1,0,12,0,-12
11798,0,0,64,0,-64
11799,1,0,4,0,-4
11800,0,0,171,0,-171
11801,1,0,29,0,-29
11802,0,0,23,0,-23
11803,0,0,31,0,-31
11804,0,0,69,0,-69
11805,1,0,38,0,-38
11806,1,1,107,1589,1482
11807,0,0,0,0,0
11808,1,0,14,0,-14
11809,1,1,1234,1288,54
11810,1,1,213,1409,1196
11811,1,1,1589,1489,-100
11812,1,1,217,1229,1012
11813,1,0,29,0,-29
11814,1,1,55,1253,1198
11815,0,0,60,0,-60
11816,0,0,1,0,-1
11817,0,0,84,0,-84
11818,0,0,47,0,-47
11819,1,0,122,0,-122
11820,0,0,4,0,-4
11821,0,0,86,0,-86
11822,1,1,62,1723,1661
11823,1,1,128,1345,1217
11824,1,0,46,0,-46
11825,1,0,18,0,-18
11826,0,0,122,0,-122
11827,1,0,75,0,-75
11828,1,0,38,0,-38
11829,0,0,9,0,-9
11830,1,0,27,0,-27
11831,1,0,20,0,-20
11832,0,0,69,0,-69
11833,0,0,44,0,-44
11834,1,1,66,2327,2261
11835,0,0,59,0,-59
11836,1,0,7,0,-7
11837,1,0,143,0,-143
11838,1,0,28,0,-28
11839,1,0,32,0,-32
11840,0,0,26,0,-26
11841,1,0,38,0,-38
11842,1,1,298,1360,1062
11843,0,0,68,0,-68
11844,1,0,47,0,-47
11845,0,0,65,0,-65
11846,0,0,23,0,-23
11847,0,0,4,0,-4
11848,1,0,101,0,-101
11849,0,0,18,0,-18
11850,1,1,542,1255,713
11851,0,0,129,0,-129
11852,1,0,35,0,-35
11853,1,1,135,1618,1483
11854,1,0,1,0,-1
11855,0,0,138,0,-138
11856,1,0,26,0,-26
11857,1,1,180,2254,2074
11858,1,1,1034,1599,565
11859,0,0,11,0,-11
11860,1,0,115,0,-115
11861,1,0,151,0,-151
11862,1,1,231,5221,4990
11863,0,0,25,0,-25
11864,1,1,85,1228,1143
11865,0,0,104,0,-104
11866,1,0,41,0,-41
11867,0,0,39,0,-39
11868,1,0,45,0,-45
11869,0,0,94,0,-94
11870,1,1,985,1268,283
11871,0,0,7,0,-7
11872,0,0,95,0,-95
11873,0,0,31,0,-31
11874,1,0,47,0,-47
11875,1,1,130,1201,1071
11876,0,0,68,0,-68
11877,1,1,113,1374,1261
11878,1,1,81,2716,2635
11879,1,1,1349,2163,814
11880,1,0,113,0,-113
11881,0,0,102,0,-102
11882,0,0,22,0,-22
11883,1,1,252,1339,1087
11884,0,0,119,0,-119
11885,0,0,63,0,-63
11886,0,0,0,0,0
11887,1,0,29,0,-29
11888,0,0,7,0,-7
11889,1,1,286,2358,2072
11890,1,0,11,0,-11
11891,1,1,1149,1682,533
11892,0,0,37,0,-37
11893,0,0,74,0,-74
11894,1,1,260,1662,1402
11895,1,1,1140,1399,259
11896,0,0,110,0,-110
11897,1,0,172,0,-172
11898,1,1,1320,1316,-4
11899,1,1,65,1290,1225
11900,1,1,857,1392,535
11901,1,1,90,1233,1143
11902,1,0,66,0,-66
11903,1,0,11,0,-11
11904,1,0,31,0,-31
11905,0,0,23,0,-23
11906,1,1,60,1400,1340
11907,1,1,786,1580,794
11908,1,0,97,0,-97
11909,0,0,13,0,-13
11910,1,0,18,0,-18
11911,0,0,26,0,-26
11912,0,0,4,0,-4
11913,0,0,8,0,-8
11914,1,0,6,0,-6
11915,1,1,215,1533,1318
11916,0,0,12,0,-12
11917,1,1,371,1448,1077
11918,0,0,16,0,-16
11919,1,0,121,0,-121
11920,1,0,4,0,-4
11921,0,0,47,0,-47
11922,1,1,312,1372,1060
11923,0,0,20,0,-20
11924,0,0,52,0,-52
11925,1,0,169,0,-169
11926,0,0,8,0,-8
11927,0,0,329,0,-329
11928,0,0,21,0,-21
11929,1,0,56,0,-56
11930,1,0,66,0,-66
11931,1,1,342,1362,1020
11932,1,0,10,0,-10
11933,1,0,47,0,-47
11934,0,0,7,0,-7
11935,0,0,5,0,-5
11936,0,0,65,0,-65
11937,1,1,1419,1215,-204
11938,0,0,3,0,-3
11939,1,1,200,1555,1355
11940,0,0,28,0,-28
11941,1,0,23,0,-23
11942,1,0,20,0,-20
11943,1,0,87,0,-87
11944,1,0,47,0,-47
11945,0,0,83,0,-83
11946,1,1,1906,3941,2035
11947,0,0,48,0,-48
11948,0,0,24,0,-24
11949,1,0,34,0,-34
11950,1,1,469,1312,843
11951,1,0,26,0,-26
11952,1,0,45,0,-45
11953,1,0,13,0,-13
11954,1,1,1183,2715,1532
11955,1,0,0,0,0
11956,1,0,94,0,-94
11957,1,1,200,1705,1505
11958,0,0,15,0,-15
11959,0,0,21,0,-21
11960,0,0,53,0,-53
11961,0,0,37,0,-37
11962,0,0,38,0,-38
11963,0,0,27,0,-27
11964,0,0,84,0,-84
11965,0,0,20,0,-20
11966,0,0,15,0,-15
11967,0,0,74,0,-74
11968,1,1,207,1211,1004
11969,0,0,46,0,-46
11970,1,0,25,0,-25
11971,1,1,414,1297,883
11972,0,0,36,0,-36
11973,1,1,484,1346,862
11974,0,0,24,0,-24
11975,1,1,1723,2055,332
11976,1,0,11,0,-11
11977,0,0,126,0,-126
11978,0,0,58,0,-58
11979,1,0,155,0,-155
11980,1,1,161,1336,1175
11981,1,1,245,1202,957
11982,0,0,19,0,-19
11983,0,0,14,0,-14
11984,1,1,96,1639,1543
11985,1,0,15,0,-15
11986,0,0,103,0,-103
11987,1,0,8,0,-8
11988,1,1,759,1440,681
11989,0,0,34,0,-34
11990,0,0,52,0,-52
11991,0,0,141,0,-141
11992,1,0,1,0,-1
11993,0,0,61,0,-61
11994,1,1,776,1287,511
11995,1,0,3,0,-3
11996,0,0,11,0,-11
11997,0,0,51,0,-51
11998,0,0,40,0,-40
11999,0,0,146,0,-146
12000,1,0,0,0,0
12001,1,0,35,0,-35
12002,0,0,14,0,-14
12003,0,0,35,0,-35
12004,0,0,88,0,-88
12005,0,0,21,0,-21
12006,0,0,1,0,-1
12007,1,0,61,0,-61
12008,0,0,73,0,-73
12009,0,0,46,0,-46
12010,1,1,178,1373,1195
12011,1,0,11,0,-11
12012,1,0,31,0,-31
12013,0,0,1,0,-1
12014,1,0,30,0,-30
12015,1,0,103,0,-103
12016,0,0,5,0,-5
12017,1,0,83,0,-83
12018,1,1,617,1215,598
12019,0,0,24,0,-24
12020,0,0,174,0,-174
12021,1,0,37,0,-37
12022,1,0,51,0,-51
12023,0,0,87,0,-87
12024,1,0,189,0,-189
12025,1,1,136,1346,1210
12026,1,0,0,0,0
12027,1,0,9,0,-9
12028,1,0,23,0,-23
12029,0,0,1,0,-1
12030,1,0,29,0,-29
12031,0,0,87,0,-87
12032,1,1,237,1211,974
12033,1,1,645,2043,1398
12034,0,0,89,0,-89
12035,1,0,65,0,-65
12036,1,0,32,0,-32
12037,0,0,24,0,-24
12038,0,0,33,0,-33
12039,0,0,61,0,-61
12040,1,0,53,0,-53
12041,1,1,923,1249,326
12042,0,0,37,0,-37
12043,1,0,1,0,-1
12044,0,0,77,0,-77
12045,0,0,2,0,-2
12046,0,0,6,0,-6
12047,0,0,76,0,-76
12048,1,1,314,1320,1006
12049,1,0,113,0,-113
12050,1,1,132,1339,1207
12051,1,1,325,1663,1338
12052,0,0,192,0,-192
12053,1,1,1509,1528,19
12054,0,0,5,0,-5
12055,0,0,27,0,-27
12056,1,1,129,1280,1151
12057,1,1,694,1242,548
12058,0,0,132,0,-132
12059,1,1,307,1270,963
12060,0,0,1,0,-1
12061,0,0,59,0,-59
12062,1,1,99,1372,1273
12063,0,0,98,0,-98
12064,1,1,273,1265,992
12065,1,0,39,0,-39
12066,1,1,41,1549,1508
12067,0,0,38,0,-38
12068,0,0,109,0,-109
12069,0,0,38,0,-38
12070,0,0,29,0,-29
12071,1,1,105,1644,1539
12072,1,1,23,1742,1719
12073,1,1,1155,1424,269
12074,1,1,342,2849,2507
12075,0,0,172,0,-172
12076,0,0,11,0,-11
12077,1,1,779,1333,554
12078,0,0,34,0,-34
12079,0,0,26,0,-26
12080,0,0,81,0,-81
12081,0,0,11,0,-11
12082,1,1,337,1821,1484
12083,1,1,363,1374,1011
12084,1,0,0,0,0
12085,1,0,17,0,-17
12086,1,0,22,0,-22
12087,1,1,279,1296,1017
12088,0,0,35,0,-35
12089,0,0,10,0,-10
12090,1,1,397,2466,2069
12091,0,0,35,0,-35
12092,0,0,1,0,-1
12093,1,1,260,1429,1169
12094,0,0,218,0,-218
12095,1,1,464,1538,1074
12096,1,0,9,0,-9
12097,1,0,42,0,-42
12098,0,0,0,0,0
12099,1,1,308,1703,1395
12100,1,0,26,0,-26
12101,1,0,84,0,-84
12102,0,0,34,0,-34
12103,0,0,23,0,-23
12104,0,0,0,0,0
12105,1,1,58,1266,1208
12106,1,0,59,0,-59
12107,0,0,48,0,-48
12108,0,0,68,0,-68
12109,1,0,12,0,-12
12110,1,1,205,1632,1427
12111,1,1,191,1230,1039
12112,0,0,7,0,-7
12113,0,0,39,0,-39
12114,0,0,11,0,-11
12115,1,0,36,0,-36
12116,1,1,581,1512,931
12117,0,0,19,0,-19
12118,0,0,81,0,-81
12119,0,0,15,0,-15
12120,0,0,91,0,-91
12121,1,1,532,1354,822
12122,1,0,30,0,-30
12123,0,0,76,0,-76
12124,1,1,95,1214,1119
12125,0,0,105,0,-105
12126,1,1,895,1262,367
12127,1,0,161,0,-161
12128,1,1,724,1741,1017
12129,1,1,162,3134,2972
12130,1,1,935,1437,502
12131,0,0,44,0,-44
12132,0,0,19,0,-19
12133,1,1,297,1406,1109
12134,1,1,177,1252,1075
12135,1,1,704,1488,784
12136,1,0,29,0,-29
12137,1,0,25,0,-25
12138,1,0,28,0,-28
12139,0,0,30,0,-30
12140,1,1,378,1468,1090
12141,1,1,63,1479,1416
12142,1,1,126,1267,1141
12143,1,0,111,0,-111
12144,1,0,97,0,-97
12145,1,0,109,0,-109
12146,1,0,86,0,-86
12147,1,0,122,0,-122
12148,0,0,199,0,-199
12149,1,1,183,1813,1630
12150,1,1,510,1410,900
12151,1,0,9,0,-9
12152,1,1,380,1209,829
12153,0,0,28,0,-28
12154,0,0,74,0,-74
12155,1,1,886,1224,338
12156,0,0,43,0,-43
12157,1,0,28,0,-28
12158,1,0,99,0,-99
12159,0,0,47,0,-47
12160,1,1,737,1354,617
12161,1,1,119,2766,2647
12162,1,1,3379,1701,-1678
12163,0,0,38,0,-38
12164,1,1,885,1694,809
12165,1,1,778,1381,603
12166,0,0,52,0,-52
12167,1,1,1155,2561,1406
12168,1,0,9,0,-9
12169,0,0,56,0,-56
12170,1,0,101,0,-101
12171,0,0,20,0,-20
12172,0,0,21,0,-21
12173,1,0,37,0,-37
12174,0,0,138,0,-138
12175,1,0,1,0,-1
12176,0,0,10,0,-10
12177,1,1,223,1385,1162
12178,1,1,503,1345,842
12179,1,1,171,6288,6117
12180,1,0,195,0,-195
12181,1,1,473,1666,1193
12182,1,1,582,1239,657
12183,0,0,13,0,-13
12184,1,1,271,1293,1022
12185,1,1,465,1215,750
12186,0,0,46,0,-46
12187,0,0,20,0,-20
12188,0,0,27,0,-27
12189,0,0,71,0,-71
12190,0,0,78,0,-78
12191,0,0,34,0,-34
12192,1,1,160,1605,1445
12193,1,1,1407,1396,-11
12194,1,0,4,0,-4
12195,1,1,53,1351,1298
12196,0,0,1,0,-1
12197,0,0,1,0,-1
12198,0,0,15,0,-15
12199,0,0,28,0,-28
12200,1,1,319,1223,904
12201,1,1,570,1519,949
12202,0,0,10,0,-10
12203,0,0,7,0,-7
12204,1,0,70,0,-70
12205,1,0,11,0,-11
12206,1,0,16,0,-16
12207,0,0,19,0,-19
12208,1,0,108,0,-108
12209,0,0,10,0,-10
12210,1,0,4,0,-4
12211,0,0,68,0,-68
12212,0,0,64,0,-64
12213,1,0,54,0,-54
12214,1,0,6,0,-6
12215,0,0,9,0,-9
12216,1,1,795,1219,424
12217,1,1,1802,1361,-441
12218,1,1,148,1829,1681
12219,1,0,3,0,-3
12220,0,0,87,0,-87
12221,0,0,143,0,-143
12222,1,1,474,1247,773
12223,0,0,181,0,-181
12224,1,1,232,1806,1574
12225,1,1,92,1330,1238
12226,0,0,89,0,-89
12227,1,0,9,0,-9
12228,1,0,56,0,-56
12229,1,1,641,1323,682
12230,1,0,7,0,-7
12231,1,0,7,0,-7
12232,1,0,87,0,-87
12233,1,1,974,1760,786
12234,1,0,12,0,-12
12235,1,1,235,1647,1412
12236,1,1,231,3847,3616
12237,1,1,617,3921,3304
12238,1,0,7,0,-7
12239,1,0,73,0,-73
12240,1,1,977,1934,957
12241,1,0,18,0,-18
12242,1,1,405,1445,1040
12243,1,0,2,0,-2
12244,1,1,244,2847,2603
12245,1,1,1788,1291,-497
12246,0,0,76,0,-76
12247,0,0,33,0,-33
12248,1,1,1034,1326,292
12249,1,1,238,1463,1225
12250,1,0,3,0,-3
12251,1,1,556,1695,1139
12252,1,1,512,1390,878
12253,0,0,68,0,-68
12254,0,0,63,0,-63
12255,1,1,151,2386,2235
12256,0,0,164,0,-164
12257,1,0,88,0,-88
12258,0,0,227,0,-227
12259,1,1,1978,1585,-393
12260,1,0,72,0,-72
12261,0,0,154,0,-154
12262,0,0,47,0,-47
12263,0,0,83,0,-83
12264,0,0,5,0,-5
12265,1,1,424,1262,838
12266,0,0,13,0,-13
12267,0,0,95,0,-95
12268,0,0,0,0,0
12269,0,0,45,0,-45
12270,0,0,56,0,-56
12271,0,0,137,0,-137
12272,1,0,235,0,-235
12273,1,0,146,0,-146
12274,0,0,13,0,-13
12275,1,0,37,0,-37
12276,1,0,22,0,-22
12277,1,0,48,0,-48
12278,0,0,7,0,-7
12279,1,0,0,0,0
12280,0,0,53,0,-53
12281,0,0,14,0,-14
12282,1,1,158,1301,1143
12283,0,0,35,0,-35
12284,0,0,15,0,-15
12285,1,0,31,0,-31
12286,1,0,27,0,-27
12287,1,0,59,0,-59
12288,0,0,73,0,-73
12289,0,0,165,0,-165
12290,1,0,53,0,-53
12291,1,0,6,0,-6
12292,1,0,14,0,-14
12293,1,1,190,1597,1407
12294,1,1,959,1206,247
12295,0,0,6,0,-6
12296,1,1,734,1298,564
12297,1,0,4,0,-4
12298,1,0,47,0,-47
12299,1,1,280,1282,1002
12300,1,1,58,1398,1340
12301,1,1,1647,1322,-325
12302,0,0,36,0,-36
12303,1,1,585,1987,1402
12304,0,0,71,0,-71
12305,1,1,727,1587,860
12306,0,0,41,0,-41
12307,1,1,311,1325,1014
12308,1,1,982,1434,452
12309,0,0,2,0,-2
12310,0,0,18,0,-18
12311,1,1,414,1306,892
12312,1,0,64,0,-64
12313,0,0,8,0,-8
12314,0,0,23,0,-23
12315,0,0,68,0,-68
12316,1,0,174,0,-174
12317,1,0,25,0,-25
12318,1,0,5,0,-5
12319,1,0,6,0,-6
12320,1,0,9,0,-9
12321,1,0,14,0,-14
12322,0,0,65,0,-65
12323,1,1,378,1902,1524
12324,0,0,99,0,-99
12325,0,0,22,0,-22
12326,1,0,19,0,-19
12327,1,0,26,0,-26
12328,1,0,57,0,-57
12329,1,1,432,1717,1285
12330,1,0,9,0,-9
12331,0,0,59,0,-59
12332,1,1,752,1331,579
12333,0,0,3,0,-3
12334,1,1,1063,1387,324
12335,1,0,13,0,-13
12336,1,0,168,0,-168
12337,0,0,119,0,-119
12338,0,0,12,0,-12
12339,0,0,25,0,-25
12340,1,1,113,1745,1632
12341,0,0,4,0,-4
12342,1,0,35,0,-35
12343,1,1,259,1209,950
12344,1,1,58,2008,1950
12345,1,1,646,1259,613
12346,1,1,590,1350,760
12347,1,0,34,0,-34
12348,1,1,270,1708,1438
12349,1,0,214,0,-214
12350,1,0,73,0,-73
12351,0,0,23,0,-23
12352,1,1,196,1226,1030
12353,0,0,11,0,-11
12354,0,0,1,0,-1
12355,1,1,263,1911,1648
12356,0,0,11,0,-11
12357,0,0,21,0,-21
12358,1,0,48,0,-48
12359,1,0,86,0,-86
12360,1,0,67,0,-67
12361,0,0,79,0,-79
12362,1,0,57,0,-57
12363,1,1,116,1222,1106
12364,0,0,0,0,0
12365,1,0,35,0,-35
12366,1,1,666,1577,911
12367,0,0,50,0,-50
12368,0,0,115,0,-115
12369,0,0,46,0,-46
12370,1,1,170,1393,1223
12371,1,0,65,0,-65
12372,1,0,3,0,-3
12373,0,0,125,0,-125
12374,1,1,811,1264,453
12375,0,0,0,0,0
12376,0,0,112,0,-112
12377,1,1,57,1242,1185
12378,1,1,351,1516,1165
12379,1,1,1234,1524,290
12380,1,1,61,2521,2460
12381,1,0,47,0,-47
12382,0,0,64,0,-64
12383,1,1,220,1411,1191
12384,0,0,33,0,-33
12385,0,0,0,0,0
12386,0,0,235,0,-235
12387,0,0,16,0,-16
12388,1,0,60,0,-60
12389,1,1,423,1510,1087
12390,0,0,117,0,-117
12391,1,0,34,0,-34
12392,1,0,74,0,-74
12393,1,0,92,0,-92
12394,0,0,73,0,-73
12395,1,1,1040,1451,411
12396,1,0,46,0,-46
12397,0,0,22,0,-22
12398,1,1,234,1203,969
12399,1,0,6,0,-6
12400,0,0,136,0,-136
12401,1,1,97,1302,1205
12402,0,0,21,0,-21
12403,1,1,521,1319,798
12404,0,0,12,0,-12
12405,1,0,76,0,-76
12406,0,0,5,0,-5
12407,1,0,14,0,-14
12408,1,1,165,1253,1088
12409,1,0,8,0,-8
12410,0,0,22,0,-22
12411,1,1,290,1272,982
12412,1,1,396,1630,1234
12413,0,0,30,0,-30
12414,1,0,77,0,-77
12415,1,1,1598,1861,263
12416,1,1,1140,1205,65
12417,1,1,233,1788,1555
12418,0,0,80,0,-80
12419,0,0,100,0,-100
12420,0,0,5,0,-5
12421,1,0,3,0,-3
12422,1,0,58,0,-58
12423,1,0,66,0,-66
12424,1,1,43,2774,2731
12425,0,0,22,0,-22
12426,1,0,0,0,0
12427,1,1,1365,2373,1008
12428,0,0,70,0,-70
12429,0,0,22,0,-22
12430,1,1,368,1894,1526
12431,1,1,597,1230,633
12432,0,0,174,0,-174
12433,0,0,44,0,-44
12434,0,0,21,0,-21
12435,0,0,136,0,-136
12436,0,0,34,0,-34
12437,1,1,257,1329,1072
12438,1,0,43,0,-43
12439,1,0,21,0,-21
12440,1,1,450,1619,1169
12441,0,0,72,0,-72
12442,1,0,10,0,-10
12443,1,1,596,1660,1064
12444,0,0,1,0,-1
12445,0,0,144,0,-144
12446,1,1,181,1410,1229
12447,1,0,35,0,-35
12448,1,0,61,0,-61
12449,1,0,86,0,-86
12450,1,0,40,0,-40
12451,0,0,36,0,-36
12452,1,0,135,0,-135
12453,0,0,7,0,-7
12454,1,0,11,0,-11
12455,1,0,4,0,-4
12456,0,0,0,0,0
12457,1,0,4,0,-4
12458,1,1,430,1795,1365
12459,1,0,5,0,-5
12460,1,0,28,0,-28
12461,0,0,12,0,-12
12462,0,0,10,0,-10
12463,1,1,393,1245,852
12464,1,1,100,1364,1264
12465,1,1,404,2175,1771
12466,1,1,1001,2763,1762
12467,1,0,47,0,-47
12468,1,0,38,0,-38
12469,0,0,70,0,-70
12470,0,0,15,0,-15
12471,1,0,49,0,-49
12472,1,1,188,2389,2201
12473,1,0,87,0,-87
12474,0,0,99,0,-99
12475,1,1,132,1740,1608
12476,1,0,18,0,-18
12477,0,0,104,0,-104
12478,1,1,312,2421,2109
12479,1,1,258,1297,1039
12480,1,0,8,0,-8
12481,1,0,15,0,-15
12482,1,1,277,2373,2096
12483,0,0,24,0,-24
12484,0,0,57,0,-57
12485,1,0,2,0,-2
12486,1,0,12,0,-12
12487,1,0,37,0,-37
12488,0,0,18,0,-18
12489,0,0,20,0,-20
12490,1,1,459,1873,1414
12491,1,1,221,1798,1577
12492,1,1,199,2201,2002
12493,1,0,2,0,-2
12494,0,0,40,0,-40
12495,0,0,195,0,-195
12496,0,0,5,0,-5
12497,0,0,14,0,-14
12498,1,0,1,0,-1
12499,1,0,52,0,-52
12500,1,0,79,0,-79
12501,1,1,1121,1482,361
12502,1,1,82,1220,1138
12503,0,0,210,0,-210
12504,1,1,84,1514,1430
12505,1,1,584,1383,799
12506,1,0,16,0,-16
12507,0,0,35,0,-35
12508,0,0,5,0,-5
12509,1,1,83,1350,1267
12510,0,0,3,0,-3
12511,0,0,58,0,-58
12512,0,0,30,0,-30
12513,1,0,100,0,-100
12514,0,0,59,0,-59
12515,1,0,118,0,-118
12516,0,0,11,0,-11
12517,1,0,20,0,-20
12518,0,0,16,0,-16
12519,1,0,18,0,-18
12520,0,0,63,0,-63
12521,0,0,43,0,-43
12522,1,1,305,1341,1036
12523,0,0,6,0,-6
12524,0,0,83,0,-83
12525,0,0,17,0,-17
12526,0,0,3,0,-3
12527,0,0,18,0,-18
12528,0,0,155,0,-155
12529,1,0,94,0,-94
12530,1,0,3,0,-3
12531,1,0,24,0,-24
12532,1,1,316,1240,924
12533,1,0,0,0,0
12534,0,0,61,0,-61
12535,0,0,78,0,-78
12536,0,0,45,0,-45
12537,0,0,46,0,-46
12538,1,0,101,0,-101
12539,0,0,17,0,-17
12540,1,0,51,0,-51
12541,1,1,878,2229,1351
12542,1,0,2,0,-2
12543,0,0,3,0,-3
12544,1,1,158,1352,1194
12545,0,0,5,0,-5
12546,1,0,45,0,-45
12547,0,0,36,0,-36
12548,1,1,482,1357,875
12549,1,1,617,1240,623
12550,1,0,38,0,-38
12551,0,0,49,0,-49
12552,0,0,26,0,-26
12553,0,0,97,0,-97
12554,1,1,620,2871,2251
12555,1,0,68,0,-68
12556,0,0,19,0,-19
12557,1,0,68,0,-68
12558,1,0,197,0,-197
12559,0,0,26,0,-26
12560,1,0,4,0,-4
12561,0,0,64,0,-64
12562,1,1,283,1215,932
12563,1,1,281,1224,943
12564,1,1,378,1686,1308
12565,0,0,76,0,-76
12566,1,1,83,1740,1657
12567,0,0,75,0,-75
12568,0,0,54,0,-54
12569,1,1,415,1843,1428
12570,1,0,23,0,-23
12571,0,0,63,0,-63
12572,0,0,15,0,-15
12573,1,0,92,0,-92
12574,1,1,387,1492,1105
12575,1,1,104,2527,2423
12576,0,0,29,0,-29
12577,1,1,1278,1356,78
12578,0,0,44,0,-44
12579,0,0,87,0,-87
12580,0,0,11,0,-11
12581,1,0,49,0,-49
12582,0,0,90,0,-90
12583,1,0,11,0,-11
12584,1,1,125,1358,1233
12585,1,1,1014,1801,787
12586,0,0,150,0,-150
12587,1,1,893,1220,327
12588,0,0,14,0,-14
12589,0,0,157,0,-157
12590,0,0,138,0,-138
12591,1,0,20,0,-20
12592,1,1,917,1377,460
12593,0,0,0,0,0
12594,1,1,77,1294,1217
12595,1,0,1,0,-1
12596,1,0,25,0,-25
12597,1,0,69,0,-69
12598,1,1,296,1413,1117
12599,1,0,2,0,-2
12600,1,1,62,2224,2162
12601,1,0,6,0,-6
12602,1,0,19,0,-19
12603,0,0,37,0,-37
12604,1,0,15,0,-15
12605,1,0,13,0,-13
12606,1,0,46,0,-46
12607,0,0,11,0,-11
12608,0,0,71,0,-71
12609,0,0,50,0,-50
12610,1,1,94,2449,2355
12611,0,0,48,0,-48
12612,1,0,29,0,-29
12613,0,0,264,0,-264
12614,1,1,108,1261,1153
12615,0,0,25,0,-25
12616,1,0,65,0,-65
12617,0,0,17,0,-17
12618,0,0,8,0,-8
12619,1,1,1153,1873,720
12620,1,0,64,0,-64
12621,0,0,23,0,-23
12622,0,0,72,0,-72
12623,1,1,1013,1765,752
12624,1,0,218,0,-218
12625,1,1,126,3470,3344
12626,1,1,578,1318,740
12627,0,0,9,0,-9
12628,1,1,796,1577,781
12629,0,0,1,0,-1
12630,0,0,250,0,-250
12631,1,0,64,0,-64
12632,1,1,493,3605,3112
12633,1,1,1450,1660,210
12634,1,1,911,1202,291
12635,0,0,62,0,-62
12636,1,0,7,0,-7
12637,0,0,59,0,-59
12638,1,0,24,0,-24
12639,1,1,368,1650,1282
12640,1,0,29,0,-29
12641,0,0,5,0,-5
12642,1,0,46,0,-46
12643,0,0,148,0,-148
12644,0,0,73,0,-73
12645,1,1,382,1709,1327
12646,1,0,25,0,-25
12647,0,0,8,0,-8
12648,0,0,38,0,-38
12649,1,0,71,0,-71
12650,0,0,47,0,-47
12651,1,0,94,0,-94
12652,1,0,75,0,-75
12653,0,0,43,0,-43
12654,0,0,2,0,-2
12655,1,1,616,1362,746
12656,1,0,23,0,-23
12657,0,0,14,0,-14
12658,1,0,279,0,-279
12659,1,1,1097,1210,113
12660,1,1,674,2085,1411
12661,0,0,32,0,-32
12662,1,1,181,1336,1155
12663,1,1,540,2391,1851
12664,1,0,8,0,-8
12665,1,0,17,0,-17
12666,0,0,5,0,-5
12667,0,0,8,0,-8
12668,0,0,33,0,-33
12669,1,1,273,1420,1147
12670,1,0,19,0,-19
12671,1,0,5,0,-5
12672,1,0,56,0,-56
12673,0,0,77,0,-77
12674,0,0,70,0,-70
12675,1,0,71,0,-71
12676,1,1,215,1963,1748
12677,0,0,83,0,-83
12678,1,0,32,0,-32
12679,0,0,51,0,-51
12680,1,1,708,1784,1076
12681,1,0,108,0,-108
12682,1,0,32,0,-32
12683,1,1,1645,1281,-364
12684,0,0,17,0,-17
12685,1,1,660,1354,694
12686,0,0,13,0,-13
12687,0,0,23,0,-23
12688,1,0,78,0,-78
12689,0,0,81,0,-81
12690,0,0,40,0,-40
12691,0,0,171,0,-171
12692,1,1,953,1222,269
12693,1,1,345,1227,882
12694,1,1,1910,1211,-699
12695,1,0,22,0,-22
12696,1,1,148,1630,1482
12697,1,1,245,1376,1131
12698,0,0,19,0,-19
12699,1,1,453,1353,900
12700,0,0,95,0,-95
12701,1,1,702,2049,1347
12702,0,0,119,0,-119
12703,1,1,834,1306,472
12704,0,0,65,0,-65
12705,1,0,11,0,-11
12706,0,0,57,0,-57
12707,0,0,14,0,-14
12708,1,1,709,1203,494
12709,1,0,64,0,-64
12710,0,0,64,0,-64
12711,1,0,7,0,-7
12712,1,1,308,1291,983
12713,0,0,42,0,-42
12714,0,0,76,0,-76
12715,1,0,0,0,0
12716,1,1,653,1250,597
12717,1,0,4,0,-4
12718,1,0,42,0,-42
12719,0,0,8,0,-8
12720,0,0,3,0,-3
12721,0,0,24,0,-24
12722,0,0,55,0,-55
12723,0,0,27,0,-27
12724,0,0,81,0,-81
12725,0,0,48,0,-48
12726,1,1,577,2343,1766
12727,1,0,48,0,-48
12728,1,1,52,1540,1488
12729,1,1,24,1448,1424
12730,1,1,454,1815,1361
12731,1,0,3,0,-3
12732,1,0,3,0,-3
12733,0,0,66,0,-66
12734,1,1,599,2473,1874
12735,1,1,122,1580,1458
12736,1,1,463,1232,769
12737,0,0,37,0,-37
12738,1,1,29,1353,1324
12739,0,0,20,0,-20
12740,1,0,7,0,-7
12741,1,0,30,0,-30
12742,1,1,198,1392,1194
12743,1,0,19,0,-19
12744,1,0,21,0,-21
12745,1,1,103,1522,1419
12746,1,0,193,0,-193
12747,1,0,0,0,0
12748,1,1,138,1253,1115
12749,0,0,7,0,-7
12750,0,0,14,0,-14
12751,1,0,54,0,-54
12752,1,1,819,2016,1197
12753,0,0,45,0,-45
12754,1,0,14,0,-14
12755,0,0,17,0,-17
12756,1,1,1254,1381,127
12757,1,0,45,0,-45
12758,0,0,125,0,-125
12759,1,0,275,0,-275
12760,1,0,15,0,-15
12761,0,0,37,0,-37
12762,0,0,67,0,-67
12763,1,0,132,0,-132
12764,1,1,446,1229,783
12765,0,0,12,0,-12
12766,1,0,4,0,-4
12767,0,0,149,0,-149
12768,0,0,12,0,-12
12769,1,0,295,0,-295
12770,0,0,73,0,-73
12771,0,0,106,0,-106
12772,0,0,72,0,-72
12773,1,0,112,0,-112
12774,0,0,19,0,-19
12775,1,0,19,0,-19
12776,1,0,52,0,-52
12777,1,0,25,0,-25
12778,1,1,1107,1763,656
12779,1,0,40,0,-40
12780,0,0,70,0,-70
12781,1,1,119,4211,4092
12782,1,0,25,0,-25
12783,1,0,106,0,-106
12784,1,1,119,1630,1511
12785,1,1,887,1871,984
12786,0,0,43,0,-43
12787,0,0,28,0,-28
12788,1,1,307,1808,1501
12789,1,0,117,0,-117
12790,1,0,30,0,-30
12791,1,0,243,0,-243
12792,0,0,6,0,-6
12793,1,0,103,0,-103
12794,0,0,27,0,-27
12795,1,1,1386,1416,30
12796,0,0,17,0,-17
12797,1,1,689,1536,847
12798,1,0,110,0,-110
12799,1,1,360,2722,2362
12800,0,0,49,0,-49
12801,1,0,90,0,-90
12802,1,0,78,0,-78
12803,1,0,36,0,-36
12804,1,1,373,1742,1369
12805,1,1,441,1584,1143
12806,1,0,51,0,-51
12807,1,1,94,1543,1449
12808,0,0,66,0,-66
12809,1,0,46,0,-46
12810,0,0,42,0,-42
12811,1,0,42,0,-42
12812,0,0,67,0,-67
12813,1,1,370,1864,1494
12814,0,0,50,0,-50
12815,0,0,100,0,-100
12816,0,0,123,0,-123
12817,0,0,90,0,-90
12818,1,1,262,3589,3327
12819,1,0,52,0,-52
12820,0,0,82,0,-82
12821,0,0,93,0,-93
12822,0,0,4,0,-4
12823,0,0,40,0,-40
12824,0,0,94,0,-94
12825,1,0,8,0,-8
12826,0,0,21,0,-21
12827,1,0,0,0,0
12828,1,0,143,0,-143
12829,1,0,147,0,-147
12830,0,0,7,0,-7
12831,0,0,138,0,-138
12832,0,0,123,0,-123
12833,0,0,2,0,-2
12834,1,0,42,0,-42
12835,1,0,39,0,-39
12836,1,1,683,2072,1389
12837,1,0,127,0,-127
12838,0,0,66,0,-66
12839,1,0,14,0,-14
12840,1,1,179,1681,1502
12841,1,1,145,1447,1302
12842,1,0,105,0,-105
12843,1,1,457,1415,958
12844,1,1,595,1251,656
12845,0,0,55,0,-55
12846,0,0,17,0,-17
12847,0,0,149,0,-149
12848,0,0,31,0,-31
12849,0,0,10,0,-10
12850,1,0,37,0,-37
12851,1,1,576,1308,732
12852,1,0,11,0,-11
12853,1,1,433,1475,1042
12854,0,0,49,0,-49
12855,0,0,43,0,-43
12856,0,0,239,0,-239
12857,0,0,29,0,-29
12858,1,0,116,0,-116
12859,0,0,165,0,-165
12860,1,1,71,2282,2211
12861,1,1,385,1858,1473
12862,0,0,97,0,-97
12863,1,1,162,1258,1096
12864,1,1,1058,1218,160
12865,1,1,118,1855,1737
12866,0,0,36,0,-36
12867,1,1,479,1379,900
12868,0,0,47,0,-47
12869,1,1,663,1326,663
12870,1,0,136,0,-136
12871,1,0,27,0,-27
12872,0,0,47,0,-47
12873,1,1,279,1465,1186
12874,1,0,19,0,-19
12875,1,1,90,1345,1255
12876,0,0,59,0,-59
12877,0,0,84,0,-84
12878,1,1,397,1472,1075
12879,1,0,16,0,-16
12880,1,0,72,0,-72
12881,1,1,138,1250,1112
12882,1,1,659,1429,770
12883,1,0,17,0,-17
12884,0,0,40,0,-40
12885,0,0,45,0,-45
12886,0,0,26,0,-26
12887,1,0,27,0,-27
12888,0,0,15,0,-15
12889,0,0,66,0,-66
12890,1,1,461,1268,807
12891,0,0,27,0,-27
12892,1,1,135,1712,1577
12893,1,0,80,0,-80
12894,0,0,34,0,-34
12895,0,0,4,0,-4
12896,0,0,149,0,-149
12897,1,1,236,1283,1047
12898,0,0,33,0,-33
12899,1,1,312,1632,1320
12900,0,0,33,0,-33
12901,0,0,42,0,-42
12902,1,0,3,0,-3
12903,1,0,4,0,-4
12904,1,1,504,1536,1032
12905,1,0,79,0,-79
12906,0,0,68,0,-68
12907,1,1,203,2059,1856
12908,0,0,82,0,-82
12909,0,0,1,0,-1
12910,0,0,20,0,-20
12911,1,1,503,1378,875
12912,0,0,5,0,-5
12913,1,1,1063,1993,930
12914,1,1,427,1266,839
12915,0,0,8,0,-8
12916,1,1,206,1229,1023
12917,1,1,432,1334,902
12918,0,0,30,0,-30
12919,1,0,34,0,-34
12920,1,0,15,0,-15
12921,0,0,5,0,-5
12922,1,1,659,1440,781
12923,1,0,58,0,-58
12924,1,0,210,0,-210
12925,1,1,380,1436,1056
12926,1,0,69,0,-69
12927,1,1,394,1542,1148
12928,1,0,18,0,-18
12929,1,1,455,1263,808
12930,1,0,27,0,-27
12931,0,0,67,0,-67
12932,0,0,1,0,-1
12933,0,0,135,0,-135
12934,1,0,54,0,-54
12935,0,0,175,0,-175
12936,1,0,11,0,-11
12937,0,0,30,0,-30
12938,1,0,27,0,-27
12939,1,0,70,0,-70
12940,0,0,52,0,-52
12941,0,0,12,0,-12
12942,1,0,49,0,-49
12943,1,0,1,0,-1
12944,1,1,301,2399,2098
12945,0,0,39,0,-39
12946,0,0,3,0,-3
12947,1,1,107,1549,1442
12948,1,0,193,0,-193
12949,0,0,17,0,-17
12950,0,0,113,0,-113
12951,1,0,29,0,-29
12952,0,0,185,0,-185
12953,1,1,475,1718,1243
12954,1,1,633,1444,811
12955,0,0,108,0,-108
12956,0,0,8,0,-8
12957,0,0,26,0,-26
12958,1,0,88,0,-88
12959,1,1,404,1311,907
12960,0,0,37,0,-37
12961,1,0,90,0,-90
12962,1,0,19,0,-19
12963,1,1,80,2864,2784
12964,1,0,38,0,-38
12965,1,0,3,0,-3
12966,0,0,41,0,-41
12967,1,1,1506,1475,-31
12968,1,1,293,1758,1465
12969,1,1,300,1280,980
12970,0,0,40,0,-40
12971,1,1,167,2243,2076
12972,0,0,0,0,0
12973,1,1,10,1307,1297
12974,1,0,123,0,-123
12975,1,0,49,0,-49
12976,1,1,279,1997,1718
12977,1,0,6,0,-6
12978,1,0,16,0,-16
12979,1,1,1067,2415,1348
12980,1,1,479,1992,1513
12981,0,0,2,0,-2
12982,1,1,139,1286,1147
12983,1,1,219,1653,1434
12984,0,0,57,0,-57
12985,1,1,605,1318,713
12986,1,1,103,2198,2095
12987,1,0,95,0,-95
12988,0,0,13,0,-13
12989,0,0,131,0,-131
12990,1,1,259,1286,1027
12991,1,1,1246,1360,114
12992,1,1,696,1296,600
12993,1,0,106,0,-106
12994,1,0,75,0,-75
12995,1,1,163,1734,1571
12996,0,0,37,0,-37
12997,0,0,66,0,-66
12998,1,1,302,1423,1121
12999,1,0,38,0,-38
13000,0,0,7,0,-7
13001,1,1,726,1263,537
13002,0,0,134,0,-134
13003,1,0,47,0,-47
13004,0,0,66,0,-66
13005,1,0,91,0,-91
13006,0,0,65,0,-65
13007,0,0,11,0,-11
13008,1,0,42,0,-42
13009,0,0,1,0,-1
13010,1,1,720,2690,1970
13011,1,0,24,0,-24
13012,1,0,89,0,-89
13013,1,1,408,1568,1160
13014,0,0,9,0,-9
13015,1,1,78,2374,2296
13016,1,1,568,1250,682
13017,1,0,36,0,-36
13018,0,0,174,0,-174
13019,0,0,26,0,-26
13020,0,0,95,0,-95
13021,0,0,31,0,-31
13022,1,1,307,1247,940
13023,1,1,479,1759,1280
13024,0,0,146,0,-146
13025,0,0,19,0,-19
13026,0,0,111,0,-111
13027,0,0,9,0,-9
13028,1,1,1197,1837,640
13029,0,0,87,0,-87
13030,1,1,537,1249,712
13031,0,0,18,0,-18
13032,0,0,29,0,-29
13033,0,0,7,0,-7
13034,1,1,1106,1765,659
13035,0,0,62,0,-62
13036,1,0,108,0,-108
13037,1,0,6,0,-6
13038,1,0,39,0,-39
13039,1,0,34,0,-34
13040,0,0,28,0,-28
13041,1,0,58,0,-58
13042,1,1,692,1626,934
13043,1,1,1065,1255,190
13044,0,0,199,0,-199
13045,1,0,74,0,-74
13046,0,0,131,0,-131
13047,1,1,536,1462,926
13048,1,1,173,1374,1201
13049,1,0,10,0,-10
13050,1,0,13,0,-13
13051,0,0,118,0,-118
13052,1,1,973,1215,242
13053,0,0,22,0,-22
13054,1,0,14,0,-14
13055,0,0,1,0,-1
13056,1,0,105,0,-105
13057,0,0,43,0,-43
13058,0,0,86,0,-86
13059,1,1,816,2201,1385
13060,1,1,1062,1839,777
13061,0,0,11,0,-11
13062,1,0,73,0,-73
13063,0,0,36,0,-36
13064,1,0,99,0,-99
13065,0,0,14,0,-14
13066,0,0,140,0,-140
13067,1,1,104,1299,1195
13068,1,0,5,0,-5
13069,1,0,19,0,-19
13070,1,0,59,0,-59
13071,0,0,25,0,-25
13072,1,1,436,1200,764
13073,0,0,17,0,-17
13074,1,1,827,1387,560
13075,1,0,51,0,-51
13076,1,1,935,1519,584
13077,1,0,8,0,-8
13078,1,0,11,0,-11
13079,0,0,0,0,0
13080,1,0,19,0,-19
13081,0,0,35,0,-35
13082,1,0,37,0,-37
13083,1,1,675,1324,649
13084,1,0,88,0,-88
13085,0,0,5,0,-5
13086,1,0,81,0,-81
13087,0,0,9,0,-9
13088,0,0,7,0,-7
13089,1,1,161,1381,1220
13090,1,1,208,1200,992
13091,0,0,2,0,-2
13092,0,0,15,0,-15
13093,1,0,24,0,-24
13094,1,0,115,0,-115
13095,0,0,102,0,-102
13096,0,0,85,0,-85
13097,0,0,10,0,-10
13098,1,1,126,1224,1098
13099,1,0,12,0,-12
13100,1,0,79,0,-79
13101,0,0,67,0,-67
13102,1,0,2,0,-2
13103,1,0,26,0,-26
13104,0,0,10,0,-10
13105,1,1,485,1411,926
13106,1,0,12,0,-12
13107,1,1,190,1525,1335
13108,1,0,187,0,-187
13109,0,0,57,0,-57
13110,1,1,956,1223,267
13111,0,0,14,0,-14
13112,0,0,104,0,-104
13113,1,1,59,1343,1284
13114,1,1,754,1651,897
13115,0,0,8,0,-8
13116,1,0,141,0,-141
13117,1,1,364,1332,968
13118,0,0,27,0,-27
13119,0,0,4,0,-4
13120,1,1,963,2259,1296
13121,1,1,2644,1319,-1325
13122,0,0,140,0,-140
13123,0,0,1,0,-1
13124,1,1,898,1363,465
13125,0,0,5,0,-5
13126,1,1,846,1539,693
13127,1,0,91,0,-91
13128,1,0,13,0,-13
13129,0,0,1,0,-1
13130,1,0,8,0,-8
13131,0,0,22,0,-22
13132,1,1,1094,2179,1085
13133,0,0,48,0,-48
13134,1,0,15,0,-15
13135,1,0,22,0,-22
13136,1,0,79,0,-79
13137,1,1,770,1357,587
13138,1,1,654,1211,557
13139,1,0,73,0,-73
13140,0,0,228,0,-228
13141,1,0,19,0,-19
13142,0,0,122,0,-122
13143,0,0,6,0,-6
13144,1,0,30,0,-30
13145,1,1,315,1244,929
13146,0,0,2,0,-2
13147,1,0,39,0,-39
13148,1,1,1247,1470,223
13149,0,0,5,0,-5
13150,1,0,27,0,-27
13151,1,0,236,0,-236
13152,1,1,28,1607,1579
13153,1,0,0,0,0
13154,1,0,49,0,-49
13155,1,0,8,0,-8
13156,0,0,21,0,-21
13157,0,0,24,0,-24
13158,0,0,9,0,-9
13159,0,0,62,0,-62
13160,0,0,38,0,-38
13161,1,1,215,1210,995
13162,0,0,73,0,-73
13163,1,0,2,0,-2
13164,1,1,19,1726,1707
13165,0,0,59,0,-59
13166,1,0,1,0,-1
13167,1,0,159,0,-159
13168,1,0,10,0,-10
13169,1,0,5,0,-5
13170,1,1,313,1472,1159
13171,1,0,90,0,-90
13172,1,0,14,0,-14
13173,0,0,1,0,-1
13174,1,0,1,0,-1
13175,1,0,35,0,-35
13176,0,0,21,0,-21
13177,1,1,642,1913,1271
13178,1,0,2,0,-2
13179,1,0,12,0,-12
13180,1,0,3,0,-3
13181,1,0,140,0,-140
13182,1,0,29,0,-29
13183,1,1,876,1446,570
13184,1,0,15,0,-15
13185,0,0,6,0,-6
13186,1,0,71,0,-71
13187,1,1,172,2815,2643
13188,0,0,20,0,-20
13189,1,1,328,1302,974
13190,0,0,5,0,-5
13191,0,0,9,0,-9
13192,1,0,181,0,-181
13193,1,0,42,0,-42
13194,1,1,171,1529,1358
13195,0,0,99,0,-99
13196,1,1,1047,1564,517
13197,1,1,878,1303,425
13198,1,0,8,0,-8
13199,1,0,26,0,-26
13200,0,0,62,0,-62
13201,1,1,781,2398,1617
13202,1,0,29,0,-29
13203,1,1,107,1570,1463
13204,1,1,1064,2177,1113
13205,0,0,29,0,-29
13206,1,1,119,1337,1218
13207,0,0,43,0,-43
13208,1,0,0,0,0
13209,0,0,48,0,-48
13210,1,1,933,1379,446
13211,0,0,51,0,-51
13212,1,1,198,2361,2163
13213,0,0,147,0,-147
13214,0,0,38,0,-38
13215,0,0,82,0,-82
13216,1,1,942,1310,368
13217,0,0,54,0,-54
13218,1,0,11,0,-11
13219,1,1,201,1945,1744
13220,1,0,37,0,-37
13221,1,1,1753,1340,-413
13222,1,0,80,0,-80
13223,0,0,1,0,-1
13224,1,0,104,0,-104
13225,1,0,31,0,-31
13226,0,0,90,0,-90
13227,1,0,65,0,-65
13228,1,0,2,0,-2
13229,1,1,534,1272,738
13230,1,0,108,0,-108
13231,1,0,32,0,-32
13232,1,0,5,0,-5
13233,0,0,1,0,-1
13234,1,0,3,0,-3
13235,1,0,23,0,-23
13236,0,0,18,0,-18
13237,1,1,188,1491,1303
13238,0,0,112,0,-112
13239,1,1,310,1859,1549
13240,1,0,9,0,-9
13241,0,0,13,0,-13
13242,0,0,20,0,-20
13243,0,0,54,0,-54
13244,1,1,77,1690,1613
13245,1,0,79,0,-79
13246,0,0,2,0,-2
13247,1,0,11,0,-11
13248,1,1,368,4218,3850
13249,1,1,175,1378,1203
13250,1,1,461,1308,847
13251,0,0,38,0,-38
13252,0,0,12,0,-12
13253,1,1,982,1463,481
13254,1,0,11,0,-11
13255,0,0,81,0,-81
13256,1,1,421,2082,1661
13257,0,0,13,0,-13
13258,0,0,2,0,-2
13259,0,0,27,0,-27
13260,0,0,49,0,-49
13261,1,0,26,0,-26
13262,1,0,65,0,-65
13263,0,0,14,0,-14
13264,1,0,62,0,-62
13265,0,0,1,0,-1
13266,1,1,350,1219,869
13267,0,0,10,0,-10
13268,1,0,3,0,-3
13269,1,1,315,1211,896
13270,1,0,24,0,-24
13271,0,0,138,0,-138
13272,1,0,2,0,-2
13273,1,0,50,0,-50
13274,0,0,3,0,-3
13275,0,0,4,0,-4
13276,0,0,11,0,-11
13277,1,0,70,0,-70
13278,1,1,356,1508,1152
13279,1,0,29,0,-29
13280,0,0,127,0,-127
13281,0,0,33,0,-33
13282,0,0,61,0,-61
13283,1,0,19,0,-19
13284,0,0,6,0,-6
13285,0,0,31,0,-31
13286,0,0,7,0,-7
13287,1,1,491,1723,1232
13288,1,0,48,0,-48
13289,1,1,251,1329,1078
13290,0,0,94,0,-94
13291,0,0,15,0,-15
13292,1,1,429,1436,1007
13293,1,0,56,0,-56
13294,0,0,30,0,-30
13295,1,0,139,0,-139
13296,1,1,786,1200,414
13297,1,1,123,2550,2427
13298,1,0,26,0,-26
13299,0,0,12,0,-12
13300,1,0,11,0,-11
13301,0,0,151,0,-151
13302,1,0,24,0,-24
13303,0,0,10,0,-10
13304,1,0,46,0,-46
13305,1,1,708,2573,1865
13306,1,0,2,0,-2
13307,0,0,36,0,-36
13308,1,1,190,2192,2002
13309,0,0,7,0,-7
13310,1,0,6,0,-6
13311,0,0,45,0,-45
13312,1,0,63,0,-63
13313,0,0,52,0,-52
13314,1,1,213,1701,1488
13315,0,0,143,0,-143
13316,0,0,42,0,-42
13317,0,0,19,0,-19
13318,1,1,633,1234,601
13319,0,0,24,0,-24
13320,1,1,1178,3830,2652
13321,0,0,52,0,-52
13322,1,0,57,0,-57
13323,0,0,7,0,-7
13324,0,0,88,0,-88
13325,1,1,1179,1401,222
13326,1,1,462,1320,858
13327,0,0,121,0,-121
13328,1,0,40,0,-40
13329,1,1,686,1242,556
13330,1,1,77,1457,1380
13331,1,1,724,1249,525
13332,1,1,224,1323,1099
13333,0,0,23,0,-23
13334,1,1,116,2603,2487
13335,1,1,364,1694,1330
13336,1,0,108,0,-108
13337,0,0,4,0,-4
13338,1,1,583,1391,808
13339,0,0,44,0,-44
13340,1,0,11,0,-11
13341,1,1,285,1525,1240
13342,0,0,30,0,-30
13343,1,0,4,0,-4
13344,1,0,15,0,-15
13345,1,0,18,0,-18
13346,0,0,5,0,-5
13347,0,0,27,0,-27
13348,1,0,2,0,-2
13349,1,1,547,6334,5787
13350,0,0,41,0,-41
13351,1,0,10,0,-10
13352,0,0,9,0,-9
13353,1,0,23,0,-23
13354,1,0,127,0,-127
13355,0,0,166,0,-166
13356,1,0,30,0,-30
13357,0,0,26,0,-26
13358,1,0,23,0,-23
13359,1,1,175,1241,1066
13360,1,1,207,1316,1109
13361,1,0,36,0,-36
13362,0,0,19,0,-19
13363,1,0,70,0,-70
13364,1,0,160,0,-160
13365,0,0,33,0,-33
13366,0,0,65,0,-65
13367,1,0,18,0,-18
13368,1,0,54,0,-54
13369,0,0,42,0,-42
13370,0,0,12,0,-12
13371,1,1,713,1300,587
13372,1,1,61,1286,1225
13373,1,1,355,1318,963
13374,1,1,193,1431,1238
13375,0,0,0,0,0
13376,0,0,6,0,-6
13377,1,0,14,0,-14
13378,0,0,254,0,-254
13379,1,1,133,2182,2049
13380,1,0,25,0,-25
13381,1,0,86,0,-86
13382,0,0,2,0,-2
13383,1,1,438,1619,1181
13384,1,0,24,0,-24
13385,0,0,57,0,-57
13386,1,0,41,0,-41
13387,1,1,129,1378,1249
13388,1,0,43,0,-43
13389,0,0,18,0,-18
13390,1,1,1402,1588,186
13391,1,1,204,1314,1110
13392,1,0,94,0,-94
13393,1,1,763,1422,659
13394,0,0,33,0,-33
13395,1,0,12,0,-12
13396,0,0,118,0,-118
13397,0,0,10,0,-10
13398,0,0,71,0,-71
13399,1,0,26,0,-26
13400,1,1,506,1457,951
13401,0,0,16,0,-16
13402,1,1,1047,1679,632
13403,1,1,969,1562,593
13404,1,1,2021,1675,-346
13405,0,0,1,0,-1
13406,1,1,56,2534,2478
13407,1,0,21,0,-21
13408,0,0,154,0,-154
13409,1,1,257,2436,2179
13410,1,1,235,1266,1031
13411,0,0,21,0,-21
13412,1,1,372,1741,1369
13413,1,0,39,0,-39
13414,1,1,1194,1714,520
13415,0,0,199,0,-199
13416,1,1,1035,1224,189
13417,1,1,407,2050,1643
13418,1,1,1437,1496,59
13419,0,0,39,0,-39
13420,1,0,3,0,-3
13421,0,0,55,0,-55
13422,0,0,28,0,-28
13423,1,1,39,1270,1231
13424,0,0,6,0,-6
13425,1,0,50,0,-50
13426,1,1,393,1279,886
13427,1,1,415,1243,828
13428,1,0,12,0,-12
13429,0,0,0,0,0
13430,1,0,30,0,-30
13431,0,0,15,0,-15
13432,1,0,36,0,-36
13433,0,0,65,0,-65
13434,0,0,14,0,-14
13435,0,0,21,0,-21
13436,0,0,19,0,-19
13437,1,1,229,1256,1027
13438,1,0,221,0,-221
13439,0,0,8,0,-8
13440,0,0,1,0,-1
13441,1,1,310,1222,912
13442,0,0,9,0,-9
13443,1,0,60,0,-60
13444,0,0,26,0,-26
13445,0,0,20,0,-20
13446,1,1,224,1220,996
13447,1,1,663,4002,3339
13448,1,0,55,0,-55
13449,1,1,493,1299,806
13450,0,0,20,0,-20
13451,1,0,28,0,-28
13452,0,0,12,0,-12
13453,1,1,172,1393,1221
13454,1,0,148,0,-148
13455,0,0,36,0,-36
13456,1,1,820,1347,527
13457,0,0,10,0,-10
13458,1,0,113,0,-113
13459,1,0,203,0,-203
13460,0,0,32,0,-32
13461,1,1,172,1220,1048
13462,1,0,5,0,-5
13463,1,1,1167,5117,3950
13464,1,0,37,0,-37
13465,0,0,56,0,-56
13466,1,0,38,0,-38
13467,1,0,8,0,-8
13468,1,1,314,1427,1113
13469,0,0,9,0,-9
13470,1,0,63,0,-63
13471,0,0,322,0,-322
13472,1,1,1346,1232,-114
13473,1,0,44,0,-44
13474,1,0,13,0,-13
13475,1,0,106,0,-106
13476,0,0,38,0,-38
13477,0,0,8,0,-8
13478,0,0,144,0,-144
13479,1,0,42,0,-42
13480,1,0,54,0,-54
13481,0,0,68,0,-68
13482,0,0,14,0,-14
13483,0,0,66,0,-66
13484,0,0,2,0,-2
13485,1,0,47,0,-47
13486,1,0,49,0,-49
13487,0,0,19,0,-19
13488,1,0,30,0,-30
13489,0,0,23,0,-23
13490,1,1,97,1358,1261
13491,1,0,35,0,-35
13492,1,1,424,1336,912
13493,0,0,74,0,-74
13494,1,1,539,1615,1076
13495,0,0,4,0,-4
13496,0,0,31,0,-31
13497,1,1,1770,1324,-446
13498,0,0,5,0,-5
13499,1,1,92,1217,1125
13500,1,1,174,1281,1107
13501,1,0,18,0,-18
13502,1,1,584,1275,691
13503,0,0,47,0,-47
13504,0,0,47,0,-47
13505,0,0,46,0,-46
13506,1,1,406,1409,1003
13507,0,0,16,0,-16
13508,1,1,544,1283,739
13509,0,0,73,0,-73
13510,1,0,60,0,-60
13511,0,0,98,0,-98
13512,1,0,77,0,-77
13513,1,1,439,1280,841
13514,0,0,10,0,-10
13515,0,0,75,0,-75
13516,1,0,28,0,-28
13517,0,0,9,0,-9
13518,1,0,21,0,-21
13519,0,0,116,0,-116
13520,1,0,77,0,-77
13521,0,0,8,0,-8
13522,1,0,14,0,-14
13523,0,0,83,0,-83
13524,0,0,31,0,-31
13525,1,0,92,0,-92
13526,1,0,43,0,-43
13527,0,0,121,0,-121
13528,1,1,185,2638,2453
13529,1,0,22,0,-22
13530,0,0,26,0,-26
13531,1,0,50,0,-50
13532,1,0,14,0,-14
13533,1,1,29,1877,1848
13534,1,1,125,1295,1170
13535,1,0,3,0,-3
13536,1,0,91,0,-91
13537,1,0,18,0,-18
13538,1,1,154,1689,1535
13539,0,0,39,0,-39
13540,0,0,85,0,-85
13541,0,0,39,0,-39
13542,1,1,309,2508,2199
13543,1,1,150,1466,1316
13544,1,1,810,1855,1045
13545,0,0,15,0,-15
13546,1,0,24,0,-24
13547,0,0,29,0,-29
13548,0,0,0,0,0
13549,0,0,117,0,-117
13550,1,1,160,1332,1172
13551,1,1,364,1813,1449
13552,1,1,47,1381,1334
13553,0,0,99,0,-99
13554,0,0,12,0,-12
13555,1,0,31,0,-31
13556,1,1,780,1472,692
13557,1,0,4,0,-4
13558,1,1,1216,1239,23
13559,0,0,105,0,-105
13560,1,0,16,0,-16
13561,1,1,799,1236,437
13562,1,1,1613,1327,-286
13563,0,0,222,0,-222
13564,1,1,633,1239,606
13565,1,1,488,1689,1201
13566,1,1,200,4802,4602
13567,1,0,19,0,-19
13568,1,1,1054,1781,727
13569,1,1,766,1236,470
13570,0,0,9,0,-9
13571,0,0,23,0,-23
13572,1,0,194,0,-194
13573,1,0,100,0,-100
13574,0,0,66,0,-66
13575,1,1,1289,1344,55
13576,0,0,102,0,-102
13577,0,0,12,0,-12
13578,0,0,56,0,-56
13579,1,0,5,0,-5
13580,1,1,526,1898,1372
13581,0,0,99,0,-99
13582,0,0,77,0,-77
13583,1,1,249,2033,1784
13584,1,0,51,0,-51
13585,1,1,312,2365,2053
13586,0,0,74,0,-74
13587,1,1,108,1244,1136
13588,1,0,33,0,-33
13589,1,0,37,0,-37
13590,1,1,575,1436,861
13591,1,0,116,0,-116
13592,1,0,39,0,-39
13593,0,0,51,0,-51
13594,1,0,86,0,-86
13595,1,0,67,0,-67
13596,0,0,107,0,-107
13597,1,0,123,0,-123
13598,0,0,30,0,-30
13599,1,1,283,1361,1078
13600,0,0,131,0,-131
13601,0,0,49,0,-49
13602,0,0,62,0,-62
13603,0,0,3,0,-3
13604,1,1,851,1204,353
13605,0,0,63,0,-63
13606,1,0,51,0,-51
13607,0,0,98,0,-98
13608,0,0,0,0,0
13609,0,0,54,0,-54
13610,1,0,5,0,-5
13611,1,0,43,0,-43
13612,1,1,941,1356,415
13613,1,1,485,2046,1561
13614,1,0,32,0,-32
13615,0,0,29,0,-29
13616,1,0,50,0,-50
13617,1,1,39,1947,1908
13618,0,0,121,0,-121
13619,1,1,600,1216,616
13620,1,1,362,1317,955
13621,1,0,73,0,-73
13622,1,0,8,0,-8
13623,1,0,10,0,-10
13624,1,1,650,1396,746
13625,1,0,75,0,-75
13626,0,0,89,0,-89
13627,1,0,6,0,-6
13628,0,0,126,0,-126
13629,1,0,4,0,-4
13630,1,0,26,0,-26
13631,0,0,59,0,-59
13632,0,0,11,0,-11
13633,1,0,58,0,-58
13634,0,0,38,0,-38
13635,1,1,288,1628,1340
13636,0,0,42,0,-42
13637,1,0,3,0,-3
13638,0,0,3,0,-3
13639,0,0,12,0,-12
13640,1,0,42,0,-42
13641,1,1,452,1369,917
13642,0,0,27,0,-27
13643,0,0,57,0,-57
13644,1,0,19,0,-19
13645,0,0,0,0,0
13646,1,1,731,1520,789
13647,1,0,26,0,-26
13648,0,0,95,0,-95
13649,0,0,10,0,-10
13650,0,0,107,0,-107
13651,0,0,35,0,-35
13652,1,1,781,1208,427
13653,1,0,8,0,-8
13654,1,0,48,0,-48
13655,1,1,472,1223,751
13656,1,0,53,0,-53
13657,0,0,11,0,-11
13658,1,1,241,1729,1488
13659,0,0,99,0,-99
13660,0,0,11,0,-11
13661,0,0,132,0,-132
13662,1,0,91,0,-91
13663,0,0,64,0,-64
13664,0,0,0,0,0
13665,1,1,534,1330,796
13666,1,1,662,1282,620
13667,0,0,175,0,-175
13668,0,0,116,0,-116
13669,1,0,51,0,-51
13670,1,1,258,2324,2066
13671,1,0,64,0,-64
13672,1,1,498,1207,709
13673,0,0,51,0,-51
13674,0,0,47,0,-47
13675,0,0,207,0,-207
13676,1,1,389,2604,2215
13677,0,0,46,0,-46
13678,1,0,37,0,-37
13679,0,0,2,0,-2
13680,0,0,2,0,-2
13681,0,0,19,0,-19
13682,0,0,11,0,-11
13683,0,0,232,0,-232
13684,0,0,2,0,-2
13685,1,1,204,1639,1435
13686,1,1,33,1662,1629
13687,0,0,65,0,-65
13688,1,1,438,1362,924
13689,1,0,2,0,-2
13690,0,0,134,0,-134
13691,1,1,303,1396,1093
13692,1,1,121,2070,1949
13693,1,0,6,0,-6
13694,1,1,394,2375,1981
13695,1,0,3,0,-3
13696,0,0,5,0,-5
13697,1,0,70,0,-70
13698,1,0,25,0,-25
13699,0,0,13,0,-13
13700,1,1,214,2196,1982
13701,1,1,43,1478,1435
13702,0,0,54,0,-54
13703,1,0,39,0,-39
13704,1,0,23,0,-23
13705,1,1,468,1922,1454
13706,1,0,0,0,0
13707,0,0,41,0,-41
13708,0,0,57,0,-57
13709,0,0,83,0,-83
13710,0,0,53,0,-53
13711,0,0,10,0,-10
13712,1,1,896,3257,2361
13713,0,0,4,0,-4
13714,1,1,553,2359,1806
13715,1,0,247,0,-247
13716,1,1,440,2502,2062
13717,1,1,1470,1574,104
13718,1,1,1095,1229,134
13719,1,1,97,1611,1514
13720,1,1,1085,2089,1004
13721,1,1,718,2527,1809
13722,0,0,40,0,-40
13723,0,0,58,0,-58
13724,0,0,13,0,-13
13725,0,0,35,0,-35
13726,1,1,2190,1652,-538
13727,1,1,75,1306,1231
13728,1,1,889,1404,515
13729,1,1,75,1590,1515
13730,1,0,31,0,-31
13731,1,1,114,1494,1380
13732,0,0,0,0,0
13733,0,0,38,0,-38
13734,0,0,357,0,-357
13735,1,0,92,0,-92
13736,1,0,6,0,-6
13737,1,0,47,0,-47
13738,1,1,643,1788,1145
13739,0,0,28,0,-28
13740,0,0,82,0,-82
13741,0,0,42,0,-42
13742,0,0,72,0,-72
13743,0,0,66,0,-66
13744,1,1,82,1514,1432
13745,1,0,22,0,-22
13746,1,1,474,1689,1215
13747,1,1,139,1891,1752
13748,1,0,73,0,-73
13749,0,0,33,0,-33
13750,1,0,8,0,-8
13751,1,1,691,1387,696
13752,1,0,38,0,-38
13753,1,1,996,1224,228
13754,0,0,181,0,-181
13755,0,0,4,0,-4
13756,1,0,32,0,-32
13757,1,1,149,4078,3929
13758,0,0,57,0,-57
13759,1,1,303,1548,1245
13760,1,0,37,0,-37
13761,0,0,22,0,-22
13762,0,0,15,0,-15
13763,0,0,30,0,-30
13764,1,1,662,1488,826
13765,1,0,57,0,-57
13766,0,0,39,0,-39
13767,1,0,8,0,-8
13768,1,0,30,0,-30
13769,1,0,56,0,-56
13770,0,0,73,0,-73
13771,1,1,1316,1451,135
13772,0,0,5,0,-5
13773,1,1,127,1237,1110
13774,0,0,17,0,-17
13775,1,1,130,1598,1468
13776,1,1,231,1221,990
13777,0,0,13,0,-13
13778,0,0,12,0,-12
13779,1,0,4,0,-4
13780,0,0,71,0,-71
13781,0,0,91,0,-91
13782,1,0,6,0,-6
13783,0,0,46,0,-46
13784,1,0,0,0,0
13785,1,0,40,0,-40
13786,1,1,1034,1399,365
13787,1,1,418,1418,1000
13788,1,0,0,0,0
13789,0,0,10,0,-10
13790,1,0,45,0,-45
13791,0,0,13,0,-13
13792,1,0,39,0,-39
13793,1,0,8,0,-8
13794,0,0,43,0,-43
13795,0,0,42,0,-42
13796,1,1,987,1330,343
13797,1,1,247,1872,1625
13798,1,0,159,0,-159
13799,1,0,6,0,-6
13800,0,0,56,0,-56
13801,1,1,128,1653,1525
13802,1,1,592,1416,824
13803,1,0,228,0,-228
13804,1,1,241,1402,1161
13805,1,0,72,0,-72
13806,0,0,10,0,-10
13807,0,0,108,0,-108
13808,1,0,53,0,-53
13809,0,0,22,0,-22
13810,0,0,8,0,-8
13811,1,0,148,0,-148
13812,0,0,39,0,-39
13813,1,1,553,1420,867
13814,0,0,51,0,-51
13815,1,0,6,0,-6
13816,1,1,92,1200,1108
13817,0,0,10,0,-10
13818,0,0,33,0,-33
13819,0,0,163,0,-163
13820,1,1,577,2948,2371
13821,0,0,6,0,-6
13822,0,0,2,0,-2
13823,0,0,27,0,-27
13824,0,0,32,0,-32
13825,1,0,38,0,-38
13826,1,1,111,1735,1624
13827,0,0,171,0,-171
13828,0,0,33,0,-33
13829,1,1,151,2521,2370
13830,1,0,7,0,-7
13831,1,1,1003,1289,286
13832,0,0,100,0,-100
13833,0,0,44,0,-44
13834,1,0,56,0,-56
13835,0,0,32,0,-32
13836,1,0,36,0,-36
13837,1,0,21,0,-21
13838,1,1,643,1505,862
13839,0,0,73,0,-73
13840,0,0,6,0,-6
13841,0,0,90,0,-90
13842,0,0,30,0,-30
13843,1,0,27,0,-27
13844,1,1,183,1237,1054
13845,1,1,346,4138,3792
13846,0,0,28,0,-28
13847,1,1,290,1218,928
13848,1,1,74,1423,1349
13849,1,0,4,0,-4
13850,1,0,10,0,-10
13851,1,0,127,0,-127
13852,1,1,1722,1348,-374
13853,1,1,843,1309,466
13854,0,0,0,0,0
13855,1,1,633,1357,724
13856,1,0,19,0,-19
13857,1,1,50,1241,1191
13858,1,1,195,1470,1275
13859,1,1,493,1255,762
13860,1,1,269,1493,1224
13861,1,0,84,0,-84
13862,1,1,410,1743,1333
13863,1,1,117,1203,1086
13864,0,0,109,0,-109
13865,0,0,47,0,-47
13866,1,1,558,1327,769
13867,0,0,5,0,-5
13868,0,0,31,0,-31
13869,0,0,33,0,-33
13870,0,0,7,0,-7
13871,0,0,19,0,-19
13872,1,0,122,0,-122
13873,1,1,118,1720,1602
13874,0,0,15,0,-15
13875,1,0,16,0,-16
13876,1,1,1050,1830,780
13877,0,0,200,0,-200
13878,0,0,44,0,-44
13879,0,0,50,0,-50
13880,0,0,23,0,-23
13881,0,0,55,0,-55
13882,0,0,18,0,-18
13883,0,0,180,0,-180
13884,0,0,55,0,-55
13885,1,0,36,0,-36
13886,0,0,3,0,-3
13887,1,1,121,1656,1535
13888,0,0,1,0,-1
13889,1,1,276,1470,1194
13890,1,0,76,0,-76
13891,1,1,471,1358,887
13892,0,0,22,0,-22
13893,0,0,2,0,-2
13894,1,0,20,0,-20
13895,0,0,2,0,-2
13896,0,0,3,0,-3
13897,1,1,775,1247,472
13898,1,0,35,0,-35
13899,1,0,35,0,-35
13900,1,0,146,0,-146
13901,1,1,100,1797,1697
13902,1,0,71,0,-71
13903,0,0,111,0,-111
13904,0,0,34,0,-34
13905,1,0,8,0,-8
13906,1,0,14,0,-14
13907,1,1,150,2120,1970
13908,1,1,1149,1604,455
13909,1,0,27,0,-27
13910,0,0,14,0,-14
13911,1,1,598,1365,767
13912,1,1,458,1694,1236
13913,1,1,35,2147,2112
13914,1,0,15,0,-15
13915,1,0,32,0,-32
13916,1,1,724,1472,748
13917,0,0,15,0,-15
13918,1,0,104,0,-104
13919,0,0,30,0,-30
13920,1,0,9,0,-9
13921,1,0,2,0,-2
13922,1,0,21,0,-21
13923,0,0,137,0,-137
13924,1,0,16,0,-16
13925,1,1,492,1476,984
13926,1,0,9,0,-9
13927,1,1,1529,1422,-107
13928,1,0,91,0,-91
13929,0,0,60,0,-60
13930,1,0,30,0,-30
13931,0,0,41,0,-41
13932,1,0,43,0,-43
13933,1,1,51,1243,1192
13934,0,0,36,0,-36
13935,1,1,71,3842,3771
13936,0,0,10,0,-10
13937,1,0,3,0,-3
13938,0,0,11,0,-11
13939,1,1,587,1355,768
13940,1,1,582,1446,864
13941,0,0,162,0,-162
13942,1,1,518,1975,1457
13943,1,1,1630,1230,-400
13944,0,0,25,0,-25
13945,0,0,27,0,-27
13946,0,0,16,0,-16
13947,1,0,7,0,-7
13948,1,1,308,1560,1252
13949,0,0,36,0,-36
13950,0,0,17,0,-17
13951,1,1,440,1651,1211
13952,1,0,12,0,-12
13953,0,0,26,0,-26
13954,1,0,73,0,-73
13955,0,0,54,0,-54
13956,1,0,145,0,-145
13957,1,0,208,0,-208
13958,1,0,101,0,-101
13959,1,0,90,0,-90
13960,1,0,60,0,-60
13961,1,0,109,0,-109
13962,1,1,43,1544,1501
13963,1,0,13,0,-13
13964,1,1,80,1356,1276
13965,1,0,3,0,-3
13966,1,0,12,0,-12
13967,0,0,13,0,-13
13968,0,0,111,0,-111
13969,1,1,798,1610,812
13970,1,0,98,0,-98
13971,0,0,20,0,-20
13972,1,1,625,1219,594
13973,0,0,204,0,-204
13974,0,0,0,0,0
13975,0,0,3,0,-3
13976,1,1,947,1312,365
13977,0,0,169,0,-169
13978,1,1,413,1621,1208
13979,0,0,23,0,-23
13980,0,0,55,0,-55
13981,1,0,24,0,-24
13982,1,1,48,1271,1223
13983,1,1,81,1255,1174
13984,1,0,6,0,-6
13985,0,0,15,0,-15
13986,0,0,19,0,-19
13987,0,0,74,0,-74
13988,1,1,258,1682,1424
13989,1,1,1150,1218,68
13990,1,1,226,1725,1499
13991,0,0,39,0,-39
13992,0,0,53,0,-53
13993,0,0,87,0,-87
13994,0,0,24,0,-24
13995,1,1,56,1954,1898
13996,1,1,92,1660,1568
13997,1,1,802,1695,893
13998,0,0,94,0,-94
13999,0,0,13,0,-13
14000,0,0,0,0,0
14001,1,0,7,0,-7
14002,1,1,919,1698,779
14003,0,0,69,0,-69
14004,0,0,7,0,-7
14005,1,0,111,0,-111
14006,0,0,105,0,-105
14007,0,0,51,0,-51
14008,0,0,45,0,-45
14009,1,0,17,0,-17
14010,1,0,47,0,-47
14011,1,0,108,0,-108
14012,1,1,772,2267,1495
14013,0,0,162,0,-162
14014,0,0,22,0,-22
14015,1,1,86,1568,1482
14016,0,0,75,0,-75
14017,1,1,180,1374,1194
14018,1,1,399,1261,862
14019,0,0,56,0,-56
14020,0,0,4,0,-4
14021,0,0,45,0,-45
14022,0,0,62,0,-62
14023,0,0,1,0,-1
14024,0,0,34,0,-34
14025,1,0,56,0,-56
14026,1,0,32,0,-32
14027,0,0,58,0,-58
14028,1,1,142,2165,2023
14029,1,0,57,0,-57
14030,0,0,42,0,-42
14031,1,1,88,2336,2248
14032,0,0,1,0,-1
14033,1,0,78,0,-78
14034,1,0,61,0,-61
14035,1,1,1484,1253,-231
14036,0,0,62,0,-62
14037,1,1,469,2338,1869
14038,1,1,464,1225,761
14039,1,1,106,1333,1227
14040,1,1,146,1422,1276
14041,0,0,46,0,-46
14042,1,0,76,0,-76
14043,1,0,96,0,-96
14044,1,1,617,1326,709
14045,1,0,3,0,-3
14046,1,0,127,0,-127
14047,1,1,426,1713,1287
14048,1,0,9,0,-9
14049,0,0,1,0,-1
14050,1,0,0,0,0
14051,1,0,70,0,-70
14052,1,1,104,1208,1104
14053,0,0,1,0,-1
14054,1,0,24,0,-24
14055,1,0,75,0,-75
14056,1,0,17,0,-17
14057,1,1,116,1413,1297
14058,1,0,115,0,-115
14059,0,0,42,0,-42
14060,1,0,214,0,-214
14061,0,0,11,0,-11
14062,0,0,97,0,-97
14063,1,1,374,1322,948
14064,1,0,5,0,-5
14065,1,1,216,1236,1020
14066,1,0,18,0,-18
14067,1,0,8,0,-8
14068,0,0,47,0,-47
14069,0,0,18,0,-18
14070,1,1,206,1428,1222
14071,0,0,67,0,-67
14072,0,0,10,0,-10
14073,0,0,44,0,-44
14074,0,0,78,0,-78
14075,1,1,663,1211,548
14076,1,1,414,2119,1705
14077,0,0,31,0,-31
14078,0,0,83,0,-83
14079,1,0,29,0,-29
14080,1,0,45,0,-45
14081,0,0,198,0,-198
14082,1,1,3,1895,1892
14083,0,0,9,0,-9
14084,1,0,131,0,-131
14085,0,0,126,0,-126
14086,1,0,8,0,-8
14087,0,0,271,0,-271
14088,0,0,73,0,-73
14089,1,1,701,1252,551
14090,1,0,7,0,-7
14091,1,0,14,0,-14
14092,0,0,7,0,-7
14093,0,0,32,0,-32
14094,1,1,94,1203,1109
14095,0,0,81,0,-81
14096,1,1,439,1233,794
14097,1,0,68,0,-68
14098,1,1,279,1411,1132
14099,1,1,311,1428,1117
14100,0,0,98,0,-98
14101,0,0,54,0,-54
14102,0,0,63,0,-63
14103,1,0,15,0,-15
14104,1,1,481,1410,929
14105,1,1,237,1257,1020
14106,0,0,5,0,-5
14107,0,0,40,0,-40
14108,1,0,24,0,-24
14109,1,0,133,0,-133
14110,1,0,13,0,-13
14111,0,0,17,0,-17
14112,1,0,34,0,-34
14113,1,1,285,1328,1043
14114,0,0,42,0,-42
14115,1,0,6,0,-6
14116,1,0,17,0,-17
14117,1,1,637,1209,572
14118,1,1,763,1292,529
14119,1,0,66,0,-66
14120,1,1,972,1307,335
14121,1,0,77,0,-77
14122,1,1,232,1541,1309
14123,1,1,361,1257,896
14124,1,0,28,0,-28
14125,1,0,102,0,-102
14126,0,0,11,0,-11
14127,1,1,624,1498,874
14128,1,0,15,0,-15
14129,1,0,12,0,-12
14130,0,0,23,0,-23
14131,1,1,1426,1751,325
14132,1,1,1195,1273,78
14133,1,0,3,0,-3
14134,1,1,142,1289,1147
14135,1,0,24,0,-24
14136,0,0,50,0,-50
14137,1,1,1324,1367,43
14138,0,0,52,0,-52
14139,1,1,287,2266,1979
14140,1,1,285,1269,984
14141,0,0,3,0,-3
14142,0,0,4,0,-4
14143,0,0,10,0,-10
14144,0,0,64,0,-64
14145,0,0,20,0,-20
14146,1,0,11,0,-11
14147,0,0,127,0,-127
14148,0,0,32,0,-32
14149,1,1,574,1527,953
14150,1,0,33,0,-33
14151,0,0,82,0,-82
14152,0,0,85,0,-85
14153,0,0,82,0,-82
14154,1,0,135,0,-135
14155,0,0,14,0,-14
14156,0,0,67,0,-67
14157,0,0,40,0,-40
14158,1,1,2036,1349,-687
14159,1,1,1001,1234,233
14160,1,0,18,0,-18
14161,0,0,46,0,-46
14162,1,1,188,1937,1749
14163,1,0,29,0,-29
14164,0,0,35,0,-35
14165,1,0,26,0,-26
14166,0,0,78,0,-78
14167,1,1,585,1730,1145
14168,0,0,4,0,-4
14169,1,1,211,1589,1378
14170,1,0,14,0,-14
14171,0,0,6,0,-6
14172,1,1,731,1261,530
14173,0,0,21,0,-21
14174,0,0,3,0,-3
14175,1,1,1020,1836,816
14176,1,0,36,0,-36
14177,1,1,878,1392,514
14178,1,0,34,0,-34
14179,1,1,244,1210,966
14180,0,0,44,0,-44
14181,0,0,20,0,-20
14182,1,0,2,0,-2
14183,0,0,27,0,-27
14184,1,1,657,3286,2629
14185,1,0,62,0,-62
14186,0,0,21,0,-21
14187,0,0,36,0,-36
14188,1,0,30,0,-30
14189,1,1,369,1280,911
14190,1,1,190,1208,1018
14191,0,0,24,0,-24
14192,1,1,617,1259,642
14193,1,1,2709,1590,-1119
14194,1,1,70,1335,1265
14195,0,0,61,0,-61
14196,1,1,582,1262,680
14197,0,0,37,0,-37
14198,1,1,399,1383,984
14199,0,0,32,0,-32
14200,0,0,21,0,-21
14201,1,1,679,1574,895
14202,1,0,12,0,-12
14203,1,1,728,1772,1044
14204,1,1,141,1298,1157
14205,1,0,0,0,0
14206,1,1,965,5128,4163
14207,1,1,132,2049,1917
14208,0,0,23,0,-23
14209,0,0,16,0,-16
14210,0,0,72,0,-72
14211,0,0,92,0,-92
14212,1,1,518,1295,777
14213,1,1,1428,1286,-142
14214,0,0,23,0,-23
14215,0,0,47,0,-47
14216,0,0,59,0,-59
14217,1,1,70,1544,1474
14218,1,0,79,0,-79
14219,1,1,457,1446,989
14220,0,0,142,0,-142
14221,1,0,78,0,-78
14222,0,0,102,0,-102
14223,1,0,35,0,-35
14224,0,0,55,0,-55
14225,1,1,123,3690,3567
14226,1,1,533,2169,1636
14227,0,0,53,0,-53
14228,1,1,74,1390,1316
14229,1,0,71,0,-71
14230,1,0,258,0,-258
14231,1,1,635,2301,1666
14232,1,0,18,0,-18
14233,0,0,80,0,-80
14234,1,1,253,2234,1981
14235,0,0,49,0,-49
14236,0,0,41,0,-41
14237,1,1,104,1292,1188
14238,1,1,259,2620,2361
14239,1,0,25,0,-25
14240,0,0,168,0,-168
14241,1,0,22,0,-22
14242,0,0,187,0,-187
14243,1,1,279,1516,1237
14244,1,0,5,0,-5
14245,0,0,17,0,-17
14246,1,0,14,0,-14
14247,0,0,18,0,-18
14248,1,1,280,3207,2927
14249,0,0,13,0,-13
14250,1,1,590,1441,851
14251,0,0,41,0,-41
14252,1,0,47,0,-47
14253,1,1,265,1222,957
14254,0,0,217,0,-217
14255,1,0,32,0,-32
14256,1,0,49,0,-49
14257,1,1,1193,1849,656
14258,1,1,281,1236,955
14259,0,0,28,0,-28
14260,1,1,284,1245,961
14261,0,0,33,0,-33
14262,1,1,384,1323,939
14263,0,0,55,0,-55
14264,1,0,183,0,-183
14265,0,0,41,0,-41
14266,0,0,59,0,-59
14267,1,0,153,0,-153
14268,1,0,24,0,-24
14269,1,1,467,1232,765
14270,0,0,3,0,-3
14271,1,1,219,1629,1410
14272,0,0,0,0,0
14273,0,0,43,0,-43
14274,1,0,65,0,-65
14275,1,1,231,1741,1510
14276,0,0,178,0,-178
14277,1,1,340,1749,1409
14278,0,0,35,0,-35
14279,0,0,4,0,-4
14280,1,0,19,0,-19
14281,1,1,888,2357,1469
14282,1,1,992,1421,429
14283,1,1,655,1497,842
14284,1,0,6,0,-6
14285,1,0,40,0,-40
14286,0,0,37,0,-37
14287,1,0,22,0,-22
14288,0,0,24,0,-24
14289,1,1,375,1288,913
14290,1,1,68,1262,1194
14291,0,0,85,0,-85
14292,1,1,363,1793,1430
14293,0,0,4,0,-4
14294,1,0,6,0,-6
14295,0,0,8,0,-8
14296,1,1,576,1271,695
14297,1,0,40,0,-40
14298,0,0,20,0,-20
14299,0,0,14,0,-14
14300,1,0,2,0,-2
14301,0,0,43,0,-43
14302,1,0,22,0,-22
14303,1,0,28,0,-28
14304,1,1,450,1376,926
14305,0,0,32,0,-32
14306,1,0,165,0,-165
14307,1,1,421,1902,1481
14308,0,0,106,0,-106
14309,1,1,335,1365,1030
14310,0,0,52,0,-52
14311,1,1,115,1661,1546
14312,1,0,67,0,-67
14313,1,0,150,0,-150
14314,0,0,48,0,-48
14315,0,0,30,0,-30
14316,1,0,18,0,-18
14317,0,0,3,0,-3
14318,0,0,9,0,-9
14319,1,1,173,1241,1068
14320,1,0,8,0,-8
14321,1,0,51,0,-51
14322,1,0,18,0,-18
14323,1,1,292,1461,1169
14324,1,0,12,0,-12
14325,1,1,79,2506,2427
14326,1,0,64,0,-64
14327,1,0,29,0,-29
14328,1,0,70,0,-70
14329,1,0,22,0,-22
14330,0,0,80,0,-80
14331,1,0,309,0,-309
14332,0,0,14,0,-14
14333,0,0,86,0,-86
14334,0,0,86,0,-86
14335,0,0,4,0,-4
14336,1,1,877,1290,413
14337,1,0,16,0,-16
14338,1,0,154,0,-154
14339,1,0,21,0,-21
14340,0,0,95,0,-95
14341,1,0,70,0,-70
14342,1,1,287,1828,1541
14343,1,0,120,0,-120
14344,1,0,25,0,-25
14345,0,0,92,0,-92
14346,0,0,12,0,-12
14347,0,0,41,0,-41
14348,1,1,664,1594,930
14349,1,0,60,0,-60
14350,0,0,48,0,-48
14351,1,1,317,1339,1022
14352,1,0,86,0,-86
14353,0,0,26,0,-26
14354,1,0,2,0,-2
14355,0,0,92,0,-92
14356,1,1,886,1228,342
14357,0,0,2,0,-2
14358,0,0,8,0,-8
14359,0,0,260,0,-260
14360,0,0,77,0,-77
14361,1,0,0,0,0
14362,1,0,47,0,-47
14363,1,0,14,0,-14
14364,0,0,16,0,-16
14365,1,0,36,0,-36
14366,1,0,30,0,-30
14367,1,1,564,1351,787
14368,0,0,39,0,-39
14369,1,0,79,0,-79
14370,1,0,94,0,-94
14371,0,0,187,0,-187
14372,1,1,1094,1355,261
14373,1,0,56,0,-56
14374,0,0,58,0,-58
14375,0,0,90,0,-90
14376,0,0,66,0,-66
14377,1,0,13,0,-13
14378,1,0,46,0,-46
14379,1,0,80,0,-80
14380,1,1,206,1330,1124
14381,1,1,1026,1420,394
14382,1,0,169,0,-169
14383,0,0,35,0,-35
14384,1,1,361,1305,944
14385,0,0,35,0,-35
14386,1,1,411,1203,792
14387,0,0,25,0,-25
14388,1,0,36,0,-36
14389,1,1,684,1484,800
14390,1,1,1158,1323,165
14391,1,0,10,0,-10
14392,0,0,15,0,-15
14393,0,0,106,0,-106
14394,0,0,10,0,-10
14395,1,1,777,1750,973
14396,0,0,30,0,-30
14397,0,0,65,0,-65
14398,1,1,657,1259,602
14399,1,1,968,1592,624
14400,0,0,31,0,-31
14401,1,1,717,1245,528
14402,1,1,225,1345,1120
14403,0,0,95,0,-95
14404,1,1,2499,1318,-1181
14405,1,1,629,1871,1242
14406,1,1,1771,1429,-342
14407,1,1,338,2941,2603
14408,1,0,26,0,-26
14409,0,0,12,0,-12
14410,1,1,253,2485,2232
14411,0,0,15,0,-15
14412,0,0,21,0,-21
14413,0,0,43,0,-43
14414,1,1,238,1240,1002
14415,0,0,51,0,-51
14416,1,0,115,0,-115
14417,1,0,14,0,-14
14418,1,1,554,1762,1208
14419,1,0,25,0,-25
14420,1,1,947,1353,406
14421,0,0,28,0,-28
14422,0,0,15,0,-15
14423,1,0,7,0,-7
14424,1,1,302,1540,1238
14425,1,1,106,1287,1181
14426,0,0,36,0,-36
14427,1,0,32,0,-32
14428,0,0,26,0,-26
14429,1,0,60,0,-60
14430,1,0,37,0,-37
14431,1,0,24,0,-24
14432,1,0,17,0,-17
14433,1,0,158,0,-158
14434,0,0,9,0,-9
14435,1,0,44,0,-44
14436,1,1,773,1505,732
14437,1,0,7,0,-7
14438,1,1,753,2044,1291
14439,0,0,1,0,-1
14440,1,1,61,1205,1144
14441,1,0,31,0,-31
14442,1,0,32,0,-32
14443,1,0,119,0,-119
14444,1,1,422,1501,1079
14445,0,0,24,0,-24
14446,1,0,24,0,-24
14447,0,0,149,0,-149
14448,1,1,329,1249,920
14449,1,0,62,0,-62
14450,0,0,200,0,-200
14451,1,0,29,0,-29
14452,0,0,187,0,-187
14453,0,0,26,0,-26
14454,1,1,100,1617,1517
14455,1,1,372,1215,843
14456,1,0,43,0,-43
14457,0,0,80,0,-80
14458,1,0,27,0,-27
14459,1,1,1916,1569,-347
14460,1,0,1,0,-1
14461,1,0,9,0,-9
14462,1,0,89,0,-89
14463,0,0,85,0,-85
14464,1,1,641,1468,827
14465,1,0,84,0,-84
14466,0,0,45,0,-45
14467,0,0,34,0,-34
14468,1,1,1929,1263,-666
14469,1,0,69,0,-69
14470,1,0,1,0,-1
14471,0,0,32,0,-32
14472,0,0,12,0,-12
14473,1,1,692,1216,524
14474,0,0,152,0,-152
14475,0,0,6,0,-6
14476,1,0,19,0,-19
14477,0,0,12,0,-12
14478,1,0,27,0,-27
14479,0,0,86,0,-86
14480,0,0,46,0,-46
14481,1,1,139,1381,1242
14482,0,0,46,0,-46
14483,1,1,541,2885,2344
14484,1,1,829,1202,373
14485,0,0,44,0,-44
14486,1,0,24,0,-24
14487,1,0,137,0,-137
14488,0,0,40,0,-40
14489,1,1,325,1345,1020
14490,1,1,34,1462,1428
14491,1,1,340,1288,948
14492,1,1,742,1223,481
14493,0,0,7,0,-7
14494,0,0,10,0,-10
14495,1,1,424,1213,789
14496,0,0,11,0,-11
14497,0,0,41,0,-41
14498,0,0,89,0,-89
14499,0,0,134,0,-134
14500,1,0,238,0,-238
14501,0,0,4,0,-4
14502,0,0,213,0,-213
14503,0,0,39,0,-39
14504,1,1,550,1713,1163
14505,0,0,42,0,-42
14506,0,0,33,0,-33
14507,0,0,33,0,-33
14508,0,0,0,0,0
14509,1,0,61,0,-61
14510,0,0,52,0,-52
14511,1,1,399,3925,3526
14512,1,0,6,0,-6
14513,1,1,131,1222,1091
14514,0,0,35,0,-35
14515,1,0,14,0,-14
14516,1,1,306,1468,1162
14517,0,0,51,0,-51
14518,0,0,13,0,-13
14519,1,1,91,2489,2398
14520,1,0,146,0,-146
14521,1,0,72,0,-72
14522,1,0,174,0,-174
14523,1,1,399,1272,873
14524,1,0,40,0,-40
14525,0,0,133,0,-133
14526,1,0,50,0,-50
14527,1,0,46,0,-46
14528,1,0,71,0,-71
14529,0,0,32,0,-32
14530,0,0,37,0,-37
14531,0,0,101,0,-101
14532,0,0,7,0,-7
14533,1,1,478,1209,731
14534,0,0,207,0,-207
14535,0,0,71,0,-71
14536,0,0,5,0,-5
14537,0,0,95,0,-95
14538,1,1,339,1806,1467
14539,1,1,2970,1402,-1568
14540,1,0,36,0,-36
14541,1,1,2142,1776,-366
14542,1,0,23,0,-23
14543,0,0,36,0,-36
14544,0,0,15,0,-15
14545,1,0,94,0,-94
14546,1,1,103,1273,1170
14547,0,0,29,0,-29
14548,0,0,43,0,-43
14549,0,0,22,0,-22
14550,1,1,34,1229,1195
14551,1,1,243,1451,1208
14552,0,0,142,0,-142
14553,1,0,15,0,-15
14554,0,0,117,0,-117
14555,0,0,74,0,-74
14556,1,1,426,1887,1461
14557,1,0,2,0,-2
14558,0,0,104,0,-104
14559,1,0,23,0,-23
14560,1,0,16,0,-16
14561,0,0,51,0,-51
14562,1,1,586,1639,1053
14563,1,1,458,1544,1086
14564,1,0,58,0,-58
14565,0,0,4,0,-4
14566,0,0,34,0,-34
14567,0,0,65,0,-65
14568,0,0,7,0,-7
14569,1,1,139,1367,1228
14570,1,1,1318,1210,-108
14571,1,0,53,0,-53
14572,0,0,49,0,-49
14573,0,0,39,0,-39
14574,0,0,198,0,-198
14575,0,0,221,0,-221
14576,1,0,77,0,-77
14577,1,0,3,0,-3
14578,0,0,65,0,-65
14579,1,0,1,0,-1
14580,1,1,313,1240,927
14581,1,1,462,2210,1748
14582,0,0,198,0,-198
14583,1,1,614,1211,597
14584,1,1,1342,1411,69
14585,0,0,37,0,-37
14586,1,0,58,0,-58
14587,1,1,1645,1260,-385
14588,0,0,23,0,-23
14589,0,0,60,0,-60
14590,0,0,59,0,-59
14591,0,0,2,0,-2
14592,0,0,45,0,-45
14593,0,0,20,0,-20
14594,1,1,546,1218,672
14595,0,0,43,0,-43
14596,0,0,0,0,0
14597,1,1,90,1339,1249
14598,0,0,335,0,-335
14599,0,0,60,0,-60
14600,1,0,51,0,-51
14601,1,1,243,1302,1059
14602,1,0,29,0,-29
14603,0,0,86,0,-86
14604,0,0,11,0,-11
14605,0,0,43,0,-43
14606,1,1,41,1258,1217
14607,1,0,20,0,-20
14608,1,1,481,2330,1849
14609,1,1,1168,1226,58
14610,0,0,57,0,-57
14611,0,0,116,0,-116
14612,1,0,15,0,-15
14613,1,0,16,0,-16
14614,1,1,614,1221,607
14615,0,0,1,0,-1
14616,1,0,28,0,-28
14617,0,0,110,0,-110
14618,0,0,60,0,-60
14619,1,0,470,0,-470
14620,0,0,55,0,-55
14621,1,0,20,0,-20
14622,1,0,17,0,-17
14623,0,0,23,0,-23
14624,1,0,112,0,-112
14625,1,0,158,0,-158
14626,1,0,12,0,-12
14627,1,1,780,2036,1256
14628,1,1,1650,1230,-420
14629,1,1,419,1283,864
14630,1,1,172,1642,1470
14631,1,0,66,0,-66
14632,1,0,4,0,-4
14633,0,0,6,0,-6
14634,0,0,19,0,-19
14635,0,0,8,0,-8
14636,1,1,312,1612,1300
14637,0,0,37,0,-37
14638,0,0,71,0,-71
14639,1,1,593,1825,1232
14640,1,1,468,1431,963
14641,1,1,857,2208,1351
14642,1,0,40,0,-40
14643,0,0,29,0,-29
14644,0,0,16,0,-16
14645,1,0,168,0,-168
14646,1,0,86,0,-86
14647,1,0,67,0,-67
14648,0,0,101,0,-101
14649,0,0,27,0,-27
14650,1,1,964,1840,876
14651,0,0,58,0,-58
14652,1,1,670,1237,567
14653,0,0,16,0,-16
14654,0,0,57,0,-57
14655,0,0,122,0,-122
14656,1,1,109,1384,1275
14657,0,0,60,0,-60
14658,1,1,316,1223,907
14659,1,0,18,0,-18
14660,0,0,6,0,-6
14661,1,0,4,0,-4
14662,1,1,482,1343,861
14663,1,1,337,1303,966
14664,0,0,80,0,-80
14665,1,1,342,2055,1713
14666,1,1,97,2111,2014
14667,0,0,39,0,-39
14668,1,0,3,0,-3
14669,0,0,58,0,-58
14670,1,0,2,0,-2
14671,1,0,35,0,-35
14672,0,0,33,0,-33
14673,1,1,473,1727,1254
14674,0,0,13,0,-13
14675,0,0,24,0,-24
14676,1,0,183,0,-183
14677,1,0,143,0,-143
14678,1,0,0,0,0
14679,1,1,251,2303,2052
14680,0,0,8,0,-8
14681,0,0,30,0,-30
14682,0,0,67,0,-67
14683,0,0,164,0,-164
14684,0,0,5,0,-5
14685,1,0,219,0,-219
14686,1,1,1718,1438,-280
14687,0,0,64,0,-64
14688,0,0,7,0,-7
14689,1,0,17,0,-17
14690,1,1,1052,1219,167
14691,1,0,19,0,-19
14692,1,0,17,0,-17
14693,1,0,193,0,-193
14694,1,1,344,1341,997
14695,1,0,30,0,-30
14696,0,0,13,0,-13
14697,1,0,4,0,-4
14698,1,0,45,0,-45
14699,1,1,465,3323,2858
14700,0,0,60,0,-60
14701,0,0,35,0,-35
14702,0,0,64,0,-64
14703,1,1,1556,2039,483
14704,1,1,190,1356,1166
14705,0,0,126,0,-126
14706,1,0,80,0,-80
14707,1,0,31,0,-31
14708,0,0,66,0,-66
14709,1,0,57,0,-57
14710,0,0,24,0,-24
14711,1,1,260,1505,1245
14712,0,0,48,0,-48
14713,1,1,495,1900,1405
14714,1,1,573,1833,1260
14715,1,1,463,1233,770
14716,1,1,685,2145,1460
14717,0,0,8,0,-8
14718,0,0,154,0,-154
14719,0,0,277,0,-277
14720,1,0,83,0,-83
14721,1,0,74,0,-74
14722,0,0,107,0,-107
14723,0,0,15,0,-15
14724,0,0,66,0,-66
14725,1,1,114,3106,2992
14726,1,0,3,0,-3
14727,0,0,114,0,-114
14728,1,0,12,0,-12
14729,0,0,1,0,-1
14730,0,0,22,0,-22
14731,0,0,25,0,-25
14732,0,0,36,0,-36
14733,1,1,195,1508,1313
14734,1,1,433,1561,1128
14735,1,1,407,1290,883
14736,0,0,50,0,-50
14737,1,0,272,0,-272
14738,1,0,24,0,-24
14739,1,0,22,0,-22
14740,0,0,29,0,-29
14741,0,0,3,0,-3
14742,0,0,4,0,-4
14743,1,1,65,1623,1558
14744,1,1,192,1282,1090
14745,1,0,34,0,-34
14746,1,0,23,0,-23
14747,1,1,762,1418,656
14748,1,0,1,0,-1
14749,0,0,219,0,-219
14750,0,0,36,0,-36
14751,1,0,227,0,-227
14752,1,0,10,0,-10
14753,0,0,18,0,-18
14754,0,0,21,0,-21
14755,1,0,22,0,-22
14756,0,0,2,0,-2
14757,0,0,22,0,-22
14758,1,0,55,0,-55
14759,0,0,99,0,-99
14760,1,1,636,1306,670
14761,0,0,78,0,-78
14762,0,0,119,0,-119
14763,1,1,51,2115,2064
14764,1,1,362,1360,998
14765,0,0,69,0,-69
14766,1,1,89,1482,1393
14767,0,0,12,0,-12
14768,0,0,15,0,-15
14769,0,0,21,0,-21
14770,0,0,27,0,-27
14771,1,1,1038,1714,676
14772,1,0,4,0,-4
14773,0,0,6,0,-6
14774,1,1,352,1200,848
14775,0,0,51,0,-51
14776,0,0,129,0,-129
14777,1,1,242,1226,984
14778,1,1,440,2257,1817
14779,1,0,54,0,-54
14780,0,0,77,0,-77
14781,1,0,43,0,-43
14782,0,0,0,0,0
14783,1,1,253,1431,1178
14784,1,0,102,0,-102
14785,0,0,100,0,-100
14786,1,0,63,0,-63
14787,1,0,27,0,-27
14788,1,0,8,0,-8
14789,1,0,7,0,-7
14790,1,0,2,0,-2
14791,1,1,895,1502,607
14792,1,0,30,0,-30
14793,0,0,57,0,-57
14794,0,0,64,0,-64
14795,0,0,64,0,-64
14796,0,0,201,0,-201
14797,1,1,247,1251,1004
14798,1,0,13,0,-13
14799,0,0,89,0,-89
14800,1,0,1,0,-1
14801,1,1,1098,1248,150
14802,1,1,927,3091,2164
14803,1,1,495,1303,808
14804,0,0,46,0,-46
14805,1,1,311,1267,956
14806,0,0,14,0,-14
14807,0,0,9,0,-9
14808,0,0,20,0,-20
14809,1,1,1712,1643,-69
14810,0,0,5,0,-5
14811,1,1,462,1207,745
14812,1,1,169,5358,5189
14813,1,0,1,0,-1
14814,1,0,21,0,-21
14815,1,1,563,1527,964
14816,1,1,816,1466,650
14817,1,0,23,0,-23
14818,1,1,1672,1329,-343
14819,0,0,18,0,-18
14820,1,1,67,1746,1679
14821,1,1,326,1377,1051
14822,1,0,28,0,-28
14823,1,1,825,1223,398
14824,1,1,428,1363,935
14825,1,1,263,1886,1623
14826,0,0,60,0,-60
14827,1,0,116,0,-116
14828,1,0,37,0,-37
14829,0,0,89,0,-89
14830,1,0,96,0,-96
14831,1,1,837,2377,1540
14832,1,0,54,0,-54
14833,1,1,290,2520,2230
14834,1,0,54,0,-54
14835,1,0,5,0,-5
14836,1,1,1183,1614,431
14837,0,0,11,0,-11
14838,1,1,267,1342,1075
14839,1,1,233,2093,1860
14840,0,0,61,0,-61
14841,1,1,1241,1527,286
14842,1,0,79,0,-79
14843,1,1,164,1574,1410
14844,0,0,51,0,-51
14845,1,0,0,0,0
14846,0,0,51,0,-51
14847,1,1,249,1462,1213
14848,0,0,58,0,-58
14849,1,1,106,1654,1548
14850,1,1,1118,1700,582
14851,0,0,11,0,-11
14852,0,0,53,0,-53
14853,0,0,18,0,-18
14854,1,0,41,0,-41
14855,1,1,545,1419,874
14856,0,0,63,0,-63
14857,0,0,29,0,-29
14858,1,0,3,0,-3
14859,0,0,23,0,-23
14860,0,0,0,0,0
14861,1,0,5,0,-5
14862,1,0,8,0,-8
14863,1,0,16,0,-16
14864,0,0,50,0,-50
14865,1,0,13,0,-13
14866,1,1,758,1365,607
14867,0,0,114,0,-114
14868,1,1,818,2080,1262
14869,1,0,23,0,-23
14870,1,1,1560,1410,-150
14871,1,1,617,1830,1213
14872,1,1,213,2073,1860
14873,0,0,106,0,-106
14874,1,1,145,1341,1196
14875,1,1,45,1201,1156
14876,0,0,7,0,-7
14877,0,0,1,0,-1
14878,0,0,0,0,0
14879,1,1,121,2249,2128
14880,0,0,42,0,-42
14881,1,0,71,0,-71
14882,0,0,56,0,-56
14883,0,0,119,0,-119
14884,0,0,17,0,-17
14885,0,0,13,0,-13
14886,0,0,23,0,-23
14887,1,1,843,1350,507
14888,0,0,43,0,-43
14889,0,0,12,0,-12
14890,1,0,10,0,-10
14891,0,0,102,0,-102
14892,0,0,31,0,-31
14893,1,1,494,1269,775
14894,1,1,451,1284,833
14895,1,0,56,0,-56
14896,1,1,139,2386,2247
14897,1,1,61,1275,1214
14898,0,0,33,0,-33
14899,0,0,34,0,-34
14900,0,0,75,0,-75
14901,1,0,43,0,-43
14902,1,0,75,0,-75
14903,0,0,3,0,-3
14904,1,0,42,0,-42
14905,1,1,876,1476,600
14906,1,0,63,0,-63
14907,1,1,188,1708,1520
14908,0,0,33,0,-33
14909,0,0,73,0,-73
14910,0,0,44,0,-44
14911,0,0,151,0,-151
14912,1,0,6,0,-6
14913,1,0,273,0,-273
14914,1,0,88,0,-88
14915,0,0,0,0,0
14916,1,0,23,0,-23
14917,0,0,59,0,-59
14918,0,0,12,0,-12
14919,1,1,375,1293,918
14920,1,1,392,1382,990
14921,1,1,176,1441,1265
14922,0,0,33,0,-33
14923,0,0,20,0,-20
14924,0,0,34,0,-34
14925,0,0,15,0,-15
14926,1,1,1446,1265,-181
14927,1,0,62,0,-62
14928,1,1,391,1542,1151
14929,1,1,376,2206,1830
14930,1,0,34,0,-34
14931,0,0,97,0,-97
14932,0,0,52,0,-52
14933,0,0,157,0,-157
14934,1,1,200,1355,1155
14935,0,0,37,0,-37
14936,0,0,112,0,-112
14937,1,0,37,0,-37
14938,0,0,48,0,-48
14939,0,0,3,0,-3
14940,0,0,43,0,-43
14941,1,1,79,1441,1362
14942,1,1,141,1258,1117
14943,1,0,34,0,-34
14944,1,0,5,0,-5
14945,0,0,102,0,-102
14946,0,0,7,0,-7
14947,0,0,116,0,-116
14948,1,1,105,1693,1588
14949,0,0,1,0,-1
14950,1,1,182,1664,1482
14951,0,0,17,0,-17
14952,1,0,71,0,-71
14953,1,0,7,0,-7
14954,1,0,17,0,-17
14955,1,1,169,2356,2187
14956,0,0,2,0,-2
14957,1,1,37,1387,1350
14958,0,0,134,0,-134
14959,1,1,200,1570,1370
14960,0,0,42,0,-42
14961,0,0,17,0,-17
14962,1,1,333,1328,995
14963,1,0,34,0,-34
14964,0,0,10,0,-10
14965,1,1,1232,1340,108
14966,0,0,54,0,-54
14967,0,0,16,0,-16
14968,0,0,130,0,-130
14969,1,0,10,0,-10
14970,1,0,9,0,-9
14971,1,1,295,1538,1243
14972,1,1,327,2465,2138
14973,0,0,21,0,-21
14974,0,0,118,0,-118
14975,0,0,73,0,-73
14976,0,0,4,0,-4
14977,0,0,13,0,-13
14978,1,1,118,1367,1249
14979,0,0,43,0,-43
14980,1,0,9,0,-9
14981,1,0,25,0,-25
14982,0,0,13,0,-13
14983,1,0,40,0,-40
14984,1,0,34,0,-34
14985,1,0,1,0,-1
14986,0,0,4,0,-4
14987,0,0,1,0,-1
14988,1,0,28,0,-28
14989,0,0,64,0,-64
14990,0,0,31,0,-31
14991,1,1,512,1690,1178
14992,0,0,39,0,-39
14993,0,0,3,0,-3
14994,0,0,78,0,-78
14995,1,1,1681,1350,-331
14996,1,0,14,0,-14
14997,1,0,48,0,-48
14998,0,0,94,0,-94
14999,1,0,4,0,-4
15000,1,1,469,1229,760
15001,1,0,127,0,-127
15002,0,0,48,0,-48
15003,0,0,41,0,-41
15004,1,1,1280,1858,578
15005,0,0,82,0,-82
15006,0,0,6,0,-6
15007,0,0,166,0,-166
15008,1,0,7,0,-7
15009,0,0,192,0,-192
15010,1,1,1120,1366,246
15011,1,0,8,0,-8
15012,1,0,45,0,-45
15013,0,0,53,0,-53
15014,0,0,9,0,-9
15015,1,1,1348,1467,119
15016,0,0,17,0,-17
15017,1,0,16,0,-16
15018,0,0,215,0,-215
15019,1,0,24,0,-24
15020,1,0,19,0,-19
15021,0,0,52,0,-52
15022,0,0,4,0,-4
15023,1,1,839,1244,405
15024,1,0,0,0,0
15025,0,0,36,0,-36
15026,0,0,35,0,-35
15027,1,1,328,1379,1051
15028,1,1,163,1268,1105
15029,0,0,53,0,-53
15030,0,0,31,0,-31
15031,0,0,186,0,-186
15032,1,1,700,1287,587
15033,1,1,1714,1280,-434
15034,0,0,20,0,-20
15035,0,0,26,0,-26
15036,0,0,68,0,-68
15037,1,0,2,0,-2
15038,1,0,12,0,-12
15039,1,0,91,0,-91
15040,1,0,2,0,-2
15041,1,1,549,1362,813
15042,1,1,427,1400,973
15043,0,0,3,0,-3
15044,1,1,273,1262,989
15045,1,0,53,0,-53
15046,1,1,1336,1894,558
15047,1,1,93,1632,1539
15048,1,0,91,0,-91
15049,1,1,1244,1303,59
15050,1,1,301,1308,1007
15051,1,0,23,0,-23
15052,0,0,79,0,-79
15053,0,0,17,0,-17
15054,1,0,148,0,-148
15055,0,0,11,0,-11
15056,1,0,5,0,-5
15057,0,0,3,0,-3
15058,0,0,28,0,-28
15059,1,0,32,0,-32
15060,1,1,563,1243,680
15061,0,0,7,0,-7
15062,1,0,49,0,-49
15063,1,1,344,1239,895
15064,1,1,416,1228,812
15065,0,0,24,0,-24
15066,0,0,10,0,-10
15067,0,0,9,0,-9
15068,0,0,39,0,-39
15069,0,0,81,0,-81
15070,0,0,37,0,-37
15071,1,1,200,1629,1429
15072,1,1,141,1215,1074
15073,0,0,4,0,-4
15074,1,1,294,1275,981
15075,1,0,3,0,-3
15076,1,1,967,1346,379
15077,1,1,857,1411,554
15078,0,0,74,0,-74
15079,1,1,1315,1323,8
15080,0,0,2,0,-2
15081,1,0,15,0,-15
15082,1,0,0,0,0
15083,0,0,132,0,-132
15084,1,1,176,1701,1525
15085,1,1,329,1345,1016
15086,1,1,803,1467,664
15087,0,0,74,0,-74
15088,1,1,418,2327,1909
15089,1,1,1009,1280,271
15090,0,0,18,0,-18
15091,1,1,382,1264,882
15092,1,1,84,1225,1141
15093,0,0,16,0,-16
15094,1,1,754,3418,2664
15095,0,0,4,0,-4
15096,1,1,313,1300,987
15097,0,0,4,0,-4
15098,0,0,44,0,-44
15099,1,1,772,2400,1628
15100,0,0,26,0,-26
15101,1,0,38,0,-38
15102,1,0,131,0,-131
15103,1,1,169,2256,2087
15104,1,0,16,0,-16
15105,1,1,230,1289,1059
15106,1,1,105,1531,1426
15107,1,0,11,0,-11
15108,0,0,75,0,-75
15109,0,0,32,0,-32
15110,1,1,588,1327,739
15111,1,0,70,0,-70
15112,1,0,3,0,-3
15113,1,1,169,1435,1266
15114,1,1,1244,2190,946
15115,0,0,39,0,-39
15116,1,1,123,1258,1135
15117,1,0,68,0,-68
15118,0,0,122,0,-122
15119,0,0,18,0,-18
15120,0,0,14,0,-14
15121,0,0,5,0,-5
15122,1,0,51,0,-51
15123,0,0,56,0,-56
15124,1,1,170,1489,1319
15125,0,0,9,0,-9
15126,1,0,4,0,-4
15127,1,1,678,1250,572
15128,0,0,20,0,-20
15129,1,0,67,0,-67
15130,1,1,671,1461,790
15131,1,0,1,0,-1
15132,0,0,17,0,-17
15133,0,0,111,0,-111
15134,1,1,501,1236,735
15135,1,1,3,1434,1431
15136,1,1,942,1255,313
15137,0,0,24,0,-24
15138,0,0,54,0,-54
15139,0,0,15,0,-15
15140,1,0,10,0,-10
15141,0,0,2,0,-2
15142,1,1,1288,1423,135
15143,1,0,21,0,-21
15144,0,0,37,0,-37
15145,0,0,4,0,-4
15146,0,0,10,0,-10
15147,1,0,25,0,-25
15148,0,0,91,0,-91
15149,0,0,116,0,-116
15150,0,0,85,0,-85
15151,0,0,15,0,-15
15152,1,1,121,1398,1277
15153,1,0,68,0,-68
15154,0,0,64,0,-64
15155,1,1,472,1397,925
15156,0,0,78,0,-78
15157,1,1,458,2205,1747
15158,1,0,9,0,-9
15159,1,0,31,0,-31
15160,0,0,46,0,-46
15161,1,0,31,0,-31
15162,1,1,515,1275,760
15163,0,0,20,0,-20
15164,0,0,93,0,-93
15165,0,0,56,0,-56
15166,0,0,74,0,-74
15167,0,0,37,0,-37
15168,0,0,34,0,-34
15169,1,0,33,0,-33
15170,1,0,25,0,-25
15171,1,0,25,0,-25
15172,1,0,14,0,-14
15173,0,0,6,0,-6
15174,1,0,3,0,-3
15175,1,0,4,0,-4
15176,1,0,21,0,-21
15177,1,1,294,1456,1162
15178,0,0,26,0,-26
15179,1,1,445,1344,899
15180,0,0,24,0,-24
15181,0,0,42,0,-42
15182,1,0,8,0,-8
15183,0,0,75,0,-75
15184,1,1,425,1269,844
15185,0,0,26,0,-26
15186,0,0,26,0,-26
15187,0,0,30,0,-30
15188,1,1,791,1520,729
15189,0,0,91,0,-91
15190,1,1,279,1550,1271
15191,0,0,52,0,-52
15192,1,0,38,0,-38
15193,0,0,58,0,-58
15194,0,0,2,0,-2
15195,1,0,116,0,-116
15196,0,0,96,0,-96
15197,1,0,100,0,-100
15198,0,0,74,0,-74
15199,0,0,89,0,-89
15200,0,0,10,0,-10
15201,1,1,250,1269,1019
15202,1,1,232,2610,2378
15203,1,1,163,1239,1076
15204,1,1,194,1230,1036
15205,1,0,194,0,-194
15206,1,0,106,0,-106
15207,1,1,575,3418,2843
15208,0,0,2,0,-2
15209,1,0,58,0,-58
15210,1,1,283,1710,1427
15211,0,0,64,0,-64
15212,0,0,240,0,-240
15213,0,0,10,0,-10
15214,0,0,84,0,-84
15215,1,1,225,1315,1090
15216,1,0,3,0,-3
15217,1,0,2,0,-2
15218,1,1,85,1304,1219
15219,1,1,79,1991,1912
15220,1,0,127,0,-127
15221,1,0,83,0,-83
15222,1,1,1086,1687,601
15223,1,1,1054,1368,314
15224,1,1,314,1212,898
15225,0,0,68,0,-68
15226,1,0,110,0,-110
15227,0,0,28,0,-28
15228,0,0,35,0,-35
15229,0,0,37,0,-37
15230,0,0,118,0,-118
15231,0,0,8,0,-8
15232,1,1,33,1338,1305
15233,1,1,250,1246,996
15234,1,1,159,1724,1565
15235,0,0,17,0,-17
15236,0,0,66,0,-66
15237,0,0,85,0,-85
15238,0,0,93,0,-93
15239,1,1,227,1200,973
15240,1,0,88,0,-88
15241,1,0,22,0,-22
15242,1,0,67,0,-67
15243,0,0,114,0,-114
15244,1,0,35,0,-35
15245,0,0,35,0,-35
15246,0,0,99,0,-99
15247,1,0,118,0,-118
15248,1,0,35,0,-35
15249,0,0,4,0,-4
15250,0,0,10,0,-10
15251,0,0,6,0,-6
15252,1,1,559,1975,1416
15253,0,0,300,0,-300
15254,0,0,62,0,-62
15255,0,0,23,0,-23
15256,1,1,1057,1402,345
15257,1,0,169,0,-169
15258,0,0,145,0,-145
15259,0,0,98,0,-98
15260,0,0,33,0,-33
15261,1,1,146,1344,1198
15262,1,0,212,0,-212
15263,1,0,28,0,-28
15264,1,0,114,0,-114
15265,0,0,14,0,-14
15266,1,1,639,1330,691
15267,0,0,82,0,-82
15268,1,1,150,1565,1415
15269,0,0,5,0,-5
15270,1,1,329,1451,1122
15271,0,0,11,0,-11
15272,1,1,199,1263,1064
15273,1,1,1725,1366,-359
15274,1,0,32,0,-32
15275,0,0,156,0,-156
15276,0,0,8,0,-8
15277,0,0,67,0,-67
15278,1,0,40,0,-40
15279,0,0,66,0,-66
15280,1,1,319,1451,1132
15281,0,0,12,0,-12
15282,0,0,188,0,-188
15283,0,0,60,0,-60
15284,0,0,257,0,-257
15285,1,1,822,1632,810
15286,0,0,31,0,-31
15287,1,0,14,0,-14
15288,0,0,33,0,-33
15289,1,1,404,1351,947
15290,0,0,36,0,-36
15291,1,1,1233,1230,-3
15292,0,0,84,0,-84
15293,0,0,44,0,-44
15294,1,0,15,0,-15
15295,1,0,37,0,-37
15296,1,1,17,1755,1738
15297,1,1,678,1637,959
15298,1,1,178,1227,1049
15299,1,0,19,0,-19
15300,0,0,68,0,-68
15301,0,0,49,0,-49
15302,1,1,774,1212,438
15303,0,0,47,0,-47
15304,1,0,60,0,-60
15305,1,0,95,0,-95
15306,1,1,796,1327,531
15307,1,0,58,0,-58
15308,1,0,34,0,-34
15309,1,1,600,2181,1581
15310,1,0,125,0,-125
15311,1,0,4,0,-4
15312,1,1,896,1700,804
15313,0,0,39,0,-39
15314,1,1,370,1227,857
15315,1,0,95,0,-95
15316,0,0,57,0,-57
15317,0,0,22,0,-22
15318,1,0,58,0,-58
15319,1,1,242,1299,1057
15320,1,0,17,0,-17
15321,0,0,3,0,-3
15322,0,0,108,0,-108
15323,1,0,3,0,-3
15324,1,1,872,1226,354
15325,1,1,732,1495,763
15326,1,0,85,0,-85
15327,1,1,426,1246,820
15328,1,0,47,0,-47
15329,1,1,1826,1300,-526
15330,1,0,25,0,-25
15331,1,0,40,0,-40
15332,0,0,90,0,-90
15333,0,0,200,0,-200
15334,1,0,58,0,-58
15335,1,0,83,0,-83
15336,1,1,1000,1681,681
15337,1,0,122,0,-122
15338,0,0,39,0,-39
15339,1,0,55,0,-55
15340,1,1,797,1527,730
15341,0,0,7,0,-7
15342,1,1,1020,1223,203
15343,1,1,653,1499,846
15344,1,0,17,0,-17
15345,1,0,55,0,-55
15346,1,1,714,1595,881
15347,1,0,13,0,-13
15348,0,0,24,0,-24
15349,1,1,109,1244,1135
15350,1,1,111,1222,1111
15351,1,0,1,0,-1
15352,1,1,104,1394,1290
15353,1,0,105,0,-105
15354,1,0,66,0,-66
15355,0,0,75,0,-75
15356,1,1,1115,1219,104
15357,1,1,1548,1865,317
15358,0,0,15,0,-15
15359,0,0,28,0,-28
15360,0,0,37,0,-37
15361,1,0,2,0,-2
15362,0,0,29,0,-29
15363,1,0,0,0,0
15364,1,1,113,3045,2932
15365,0,0,32,0,-32
15366,1,0,168,0,-168
15367,0,0,6,0,-6
15368,1,0,111,0,-111
15369,1,0,65,0,-65
15370,0,0,22,0,-22
15371,0,0,262,0,-262
15372,1,0,38,0,-38
15373,1,0,0,0,0
15374,0,0,136,0,-136
15375,0,0,85,0,-85
15376,1,0,20,0,-20
15377,1,0,8,0,-8
15378,0,0,104,0,-104
15379,0,0,120,0,-120
15380,1,0,4,0,-4
15381,0,0,21,0,-21
15382,0,0,106,0,-106
15383,1,1,709,1270,561
15384,1,0,34,0,-34
15385,0,0,71,0,-71
15386,1,0,56,0,-56
15387,1,0,46,0,-46
15388,1,0,45,0,-45
15389,0,0,98,0,-98
15390,1,0,16,0,-16
15391,0,0,147,0,-147
15392,1,1,152,1931,1779
15393,1,0,112,0,-112
15394,1,0,44,0,-44
15395,1,1,306,1648,1342
15396,1,0,21,0,-21
15397,1,0,30,0,-30
15398,0,0,46,0,-46
15399,1,0,67,0,-67
15400,0,0,97,0,-97
15401,0,0,75,0,-75
15402,1,0,86,0,-86
15403,1,0,0,0,0
15404,0,0,99,0,-99
15405,1,0,5,0,-5
15406,1,0,14,0,-14
15407,1,0,189,0,-189
15408,0,0,8,0,-8
15409,1,0,19,0,-19
15410,1,0,59,0,-59
15411,1,1,362,2665,2303
15412,1,0,29,0,-29
15413,1,1,392,1336,944
15414,1,1,211,1647,1436
15415,1,0,27,0,-27
15416,1,0,20,0,-20
15417,0,0,32,0,-32
15418,1,0,43,0,-43
15419,1,1,550,1483,933
15420,1,0,41,0,-41
15421,1,1,962,1377,415
15422,1,1,118,1798,1680
15423,0,0,18,0,-18
15424,0,0,66,0,-66
15425,0,0,5,0,-5
15426,1,0,23,0,-23
15427,0,0,18,0,-18
15428,1,0,127,0,-127
15429,0,0,33,0,-33
15430,0,0,78,0,-78
15431,0,0,23,0,-23
15432,0,0,38,0,-38
15433,1,0,124,0,-124
15434,0,0,20,0,-20
15435,1,0,1,0,-1
15436,1,0,22,0,-22
15437,0,0,27,0,-27
15438,1,0,170,0,-170
15439,1,1,94,3272,3178
15440,0,0,6,0,-6
15441,1,0,154,0,-154
15442,1,0,107,0,-107
15443,1,0,35,0,-35
15444,1,0,53,0,-53
15445,0,0,67,0,-67
15446,0,0,86,0,-86
15447,1,0,77,0,-77
15448,0,0,10,0,-10
15449,1,1,315,1551,1236
15450,0,0,12,0,-12
15451,0,0,13,0,-13
15452,0,0,33,0,-33
15453,1,1,534,1300,766
15454,1,1,709,1545,836
15455,1,1,1553,1766,213
15456,1,1,251,1379,1128
15457,0,0,112,0,-112
15458,1,1,237,1313,1076
15459,1,1,206,1388,1182
15460,0,0,10,0,-10
15461,1,0,26,0,-26
15462,1,0,22,0,-22
15463,0,0,7,0,-7
15464,0,0,75,0,-75
15465,1,0,38,0,-38
15466,1,1,495,3375,2880
15467,0,0,117,0,-117
15468,0,0,7,0,-7
15469,1,1,271,1349,1078
15470,0,0,15,0,-15
15471,1,1,243,1410,1167
15472,1,0,60,0,-60
15473,0,0,31,0,-31
15474,1,0,51,0,-51
15475,1,0,105,0,-105
15476,1,0,36,0,-36
15477,1,0,44,0,-44
15478,0,0,2,0,-2
15479,1,1,1787,1320,-467
15480,0,0,41,0,-41
15481,0,0,5,0,-5
15482,1,1,617,1233,616
15483,0,0,58,0,-58
15484,1,1,391,1352,961
15485,1,1,381,1263,882
15486,0,0,6,0,-6
15487,1,1,79,1203,1124
15488,1,1,802,1379,577
15489,1,1,425,7877,7452
15490,1,0,62,0,-62
15491,1,0,23,0,-23
15492,0,0,217,0,-217
15493,1,0,34,0,-34
15494,0,0,129,0,-129
15495,1,0,224,0,-224
15496,1,0,119,0,-119
15497,0,0,7,0,-7
15498,1,1,98,1283,1185
15499,1,0,84,0,-84
15500,0,0,52,0,-52
15501,0,0,49,0,-49
15502,0,0,105,0,-105
15503,0,0,7,0,-7
15504,1,1,1077,1547,470
15505,0,0,97,0,-97
15506,1,0,27,0,-27
15507,1,1,172,1377,1205
15508,1,0,19,0,-19
15509,1,0,30,0,-30
15510,0,0,35,0,-35
15511,1,0,180,0,-180
15512,1,1,1756,1445,-311
15513,0,0,13,0,-13
15514,1,1,324,1379,1055
15515,1,0,127,0,-127
15516,0,0,64,0,-64
15517,1,0,143,0,-143
15518,1,0,92,0,-92
15519,1,1,301,1225,924
15520,0,0,61,0,-61
15521,1,1,898,3044,2146
15522,1,1,397,2913,2516
15523,1,0,48,0,-48
15524,0,0,34,0,-34
15525,1,0,15,0,-15
15526,1,0,32,0,-32
15527,1,0,10,0,-10
15528,1,1,866,1377,511
15529,1,0,24,0,-24
15530,0,0,147,0,-147
15531,1,0,106,0,-106
15532,1,0,10,0,-10
15533,0,0,0,0,0
15534,1,1,111,1208,1097
15535,0,0,0,0,0
15536,1,0,37,0,-37
15537,1,1,919,1629,710
15538,0,0,25,0,-25
15539,1,0,30,0,-30
15540,1,0,13,0,-13
15541,0,0,107,0,-107
15542,1,0,18,0,-18
15543,1,1,642,1343,701
15544,1,1,526,1267,741
15545,0,0,18,0,-18
15546,0,0,53,0,-53
15547,0,0,49,0,-49
15548,1,0,6,0,-6
15549,1,0,151,0,-151
15550,1,1,939,1209,270
15551,1,0,78,0,-78
15552,0,0,6,0,-6
15553,1,1,2224,1641,-583
15554,0,0,127,0,-127
15555,0,0,110,0,-110
15556,0,0,62,0,-62
15557,0,0,66,0,-66
15558,1,0,18,0,-18
15559,0,0,39,0,-39
15560,1,1,1156,1314,158
15561,1,0,81,0,-81
15562,1,1,146,1727,1581
15563,1,1,840,1548,708
15564,1,0,76,0,-76
15565,0,0,48,0,-48
15566,0,0,20,0,-20
15567,1,0,12,0,-12
15568,1,0,43,0,-43
15569,1,1,528,1217,689
15570,1,0,85,0,-85
15571,1,0,29,0,-29
15572,0,0,40,0,-40
15573,0,0,1,0,-1
15574,1,1,418,1319,901
15575,1,1,235,1250,1015
15576,0,0,9,0,-9
15577,0,0,46,0,-46
15578,1,0,10,0,-10
15579,0,0,33,0,-33
15580,1,1,304,1389,1085
15581,0,0,45,0,-45
15582,0,0,52,0,-52
15583,0,0,27,0,-27
15584,1,1,1416,1322,-94
15585,0,0,60,0,-60
15586,0,0,14,0,-14
15587,0,0,31,0,-31
15588,0,0,88,0,-88
15589,1,1,1063,1644,581
15590,1,0,11,0,-11
15591,0,0,44,0,-44
15592,1,0,9,0,-9
15593,0,0,30,0,-30
15594,1,1,1255,1853,598
15595,0,0,118,0,-118
15596,1,1,1179,1258,79
15597,0,0,194,0,-194
15598,1,0,19,0,-19
15599,0,0,120,0,-120
15600,0,0,13,0,-13
15601,0,0,131,0,-131
15602,0,0,78,0,-78
15603,0,0,70,0,-70
15604,1,0,57,0,-57
15605,1,1,1516,1444,-72
15606,0,0,7,0,-7
15607,1,1,1746,1328,-418
15608,0,0,28,0,-28
15609,1,0,29,0,-29
15610,0,0,28,0,-28
15611,0,0,53,0,-53
15612,0,0,101,0,-101
15613,0,0,13,0,-13
15614,0,0,24,0,-24
15615,0,0,31,0,-31
15616,0,0,24,0,-24
15617,0,0,0,0,0
15618,1,0,2,0,-2
15619,0,0,12,0,-12
15620,1,1,198,2529,2331
15621,0,0,13,0,-13
15622,1,0,8,0,-8
15623,1,1,1161,1464,303
15624,0,0,36,0,-36
15625,1,0,40,0,-40
15626,1,0,37,0,-37
15627,1,0,132,0,-132
15628,0,0,73,0,-73
15629,0,0,44,0,-44
15630,0,0,17,0,-17
15631,1,0,20,0,-20
15632,1,0,68,0,-68
15633,0,0,70,0,-70
15634,1,1,46,1803,1757
15635,0,0,20,0,-20
15636,0,0,26,0,-26
15637,0,0,85,0,-85
15638,0,0,25,0,-25
15639,1,1,47,1576,1529
15640,1,1,456,1200,744
15641,1,0,14,0,-14
15642,0,0,30,0,-30
15643,1,1,965,3141,2176
15644,0,0,20,0,-20
15645,1,1,298,1478,1180
15646,1,0,4,0,-4
15647,1,1,924,1476,552
15648,0,0,15,0,-15
15649,1,1,404,1299,895
15650,1,1,522,1279,757
15651,0,0,31,0,-31
15652,1,0,10,0,-10
15653,0,0,103,0,-103
15654,0,0,7,0,-7
15655,0,0,26,0,-26
15656,0,0,8,0,-8
15657,1,0,7,0,-7
15658,1,0,56,0,-56
15659,1,1,801,1435,634
15660,1,0,68,0,-68
15661,1,0,22,0,-22
15662,1,0,30,0,-30
15663,0,0,3,0,-3
15664,1,0,23,0,-23
15665,1,0,25,0,-25
15666,1,0,1,0,-1
15667,1,1,97,1394,1297
15668,0,0,3,0,-3
15669,0,0,40,0,-40
15670,0,0,2,0,-2
15671,1,1,367,1881,1514
15672,0,0,32,0,-32
15673,0,0,24,0,-24
15674,1,1,2201,1463,-738
15675,1,0,25,0,-25
15676,1,0,21,0,-21
15677,0,0,51,0,-51
15678,1,1,474,1367,893
15679,0,0,2,0,-2
15680,0,0,15,0,-15
15681,1,1,737,1328,591
15682,1,1,411,1426,1015
15683,1,0,9,0,-9
15684,1,0,9,0,-9
15685,0,0,82,0,-82
15686,1,1,195,3218,3023
15687,1,1,226,1471,1245
15688,1,0,17,0,-17
15689,0,0,44,0,-44
15690,0,0,17,0,-17
15691,0,0,80,0,-80
15692,1,1,180,1369,1189
15693,1,1,1063,1292,229
15694,1,0,93,0,-93
15695,1,1,480,1454,974
15696,0,0,2,0,-2
15697,0,0,27,0,-27
15698,1,1,1257,1273,16
15699,1,0,55,0,-55
15700,0,0,158,0,-158
15701,1,1,318,1502,1184
15702,0,0,15,0,-15
15703,1,0,35,0,-35
15704,0,0,1,0,-1
15705,0,0,67,0,-67
15706,0,0,40,0,-40
15707,0,0,6,0,-6
15708,0,0,37,0,-37
15709,1,1,1397,1583,186
15710,1,0,24,0,-24
15711,0,0,147,0,-147
15712,1,0,20,0,-20
15713,0,0,145,0,-145
15714,0,0,14,0,-14
15715,1,1,553,1547,994
15716,0,0,61,0,-61
15717,1,0,89,0,-89
15718,1,0,46,0,-46
15719,0,0,175,0,-175
15720,0,0,165,0,-165
15721,0,0,8,0,-8
15722,0,0,50,0,-50
15723,1,1,1652,3122,1470
15724,1,1,1748,1348,-400
15725,1,1,2169,1368,-801
15726,1,1,699,1213,514
15727,1,0,63,0,-63
15728,0,0,36,0,-36
15729,1,1,1045,1211,166
15730,0,0,1,0,-1
15731,0,0,11,0,-11
15732,1,1,188,1740,1552
15733,1,0,13,0,-13
15734,1,0,73,0,-73
15735,0,0,126,0,-126
15736,1,1,262,1404,1142
15737,1,0,1,0,-1
15738,1,1,1589,1282,-307
15739,1,0,15,0,-15
15740,1,1,146,1207,1061
15741,1,0,5,0,-5
15742,1,1,40,1295,1255
15743,0,0,19,0,-19
15744,1,0,32,0,-32
15745,0,0,65,0,-65
15746,0,0,195,0,-195
15747,0,0,94,0,-94
15748,1,1,365,1270,905
15749,1,1,174,1522,1348
15750,0,0,12,0,-12
15751,0,0,10,0,-10
15752,1,1,732,1614,882
15753,1,1,248,1264,1016
15754,1,1,1231,1276,45
15755,1,1,468,2525,2057
15756,1,0,87,0,-87
15757,1,0,20,0,-20
15758,0,0,37,0,-37
15759,1,0,0,0,0
15760,1,0,103,0,-103
15761,0,0,50,0,-50
15762,1,0,22,0,-22
15763,0,0,22,0,-22
15764,1,0,8,0,-8
15765,0,0,66,0,-66
15766,1,0,1,0,-1
15767,0,0,31,0,-31
15768,1,0,23,0,-23
15769,1,1,4254,2360,-1894
15770,1,1,838,1205,367
15771,0,0,149,0,-149
15772,0,0,67,0,-67
15773,1,1,1108,1668,560
15774,1,0,125,0,-125
15775,0,0,21,0,-21
15776,1,1,176,1400,1224
15777,1,0,4,0,-4
15778,1,0,17,0,-17
15779,0,0,4,0,-4
15780,0,0,66,0,-66
15781,1,0,7,0,-7
15782,1,1,600,1362,762
15783,1,1,436,1294,858
15784,0,0,14,0,-14
15785,0,0,19,0,-19
15786,0,0,74,0,-74
15787,0,0,113,0,-113
15788,0,0,36,0,-36
15789,0,0,67,0,-67
15790,0,0,36,0,-36
15791,0,0,115,0,-115
15792,1,1,302,1274,972
15793,0,0,14,0,-14
15794,0,0,210,0,-210
15795,1,0,16,0,-16
15796,0,0,57,0,-57
15797,1,1,1312,2298,986
15798,0,0,32,0,-32
15799,1,1,901,1331,430
15800,0,0,30,0,-30
15801,1,0,12,0,-12
15802,0,0,28,0,-28
15803,0,0,12,0,-12
15804,1,0,62,0,-62
15805,0,0,27,0,-27
15806,0,0,36,0,-36
15807,1,1,328,2007,1679
15808,1,1,747,2132,1385
15809,1,0,102,0,-102
15810,1,1,419,2216,1797
15811,1,0,35,0,-35
15812,1,0,31,0,-31
15813,1,0,19,0,-19
15814,0,0,66,0,-66
15815,1,1,1080,1254,174
15816,1,1,98,2355,2257
15817,0,0,20,0,-20
15818,1,0,8,0,-8
15819,1,0,45,0,-45
15820,1,1,693,1260,567
15821,1,1,336,1770,1434
15822,1,1,483,2018,1535
15823,1,1,89,1250,1161
15824,0,0,37,0,-37
15825,1,1,1056,1705,649
15826,0,0,197,0,-197
15827,1,0,116,0,-116
15828,1,0,0,0,0
15829,0,0,95,0,-95
15830,1,0,0,0,0
15831,1,0,36,0,-36
15832,1,1,1613,1489,-124
15833,0,0,51,0,-51
15834,0,0,23,0,-23
15835,0,0,6,0,-6
15836,1,0,121,0,-121
15837,1,1,259,1264,1005
15838,1,1,443,1578,1135
15839,1,0,170,0,-170
15840,0,0,44,0,-44
15841,0,0,43,0,-43
15842,0,0,24,0,-24
15843,0,0,55,0,-55
15844,1,0,27,0,-27
15845,0,0,25,0,-25
15846,1,0,5,0,-5
15847,1,1,914,2149,1235
15848,0,0,21,0,-21
15849,0,0,188,0,-188
15850,1,0,79,0,-79
15851,1,0,7,0,-7
15852,1,0,24,0,-24
15853,1,0,69,0,-69
15854,0,0,45,0,-45
15855,1,0,49,0,-49
15856,1,1,152,1645,1493
15857,0,0,2,0,-2
15858,0,0,34,0,-34
15859,0,0,3,0,-3
15860,1,0,59,0,-59
15861,1,1,60,1578,1518
15862,1,1,37,1236,1199
15863,1,1,1152,1248,96
15864,1,0,16,0,-16
15865,1,0,54,0,-54
15866,1,0,16,0,-16
15867,1,0,36,0,-36
15868,1,0,11,0,-11
15869,1,1,386,2137,1751
15870,1,1,1596,1547,-49
15871,0,0,6,0,-6
15872,1,1,60,1365,1305
15873,1,0,79,0,-79
15874,0,0,88,0,-88
15875,0,0,36,0,-36
15876,0,0,38,0,-38
15877,0,0,9,0,-9
15878,1,0,17,0,-17
15879,0,0,64,0,-64
15880,0,0,66,0,-66
15881,0,0,6,0,-6
15882,1,0,68,0,-68
15883,1,1,168,1338,1170
15884,1,0,4,0,-4
15885,1,1,1156,1225,69
15886,0,0,1,0,-1
15887,1,0,25,0,-25
15888,1,0,2,0,-2
15889,1,1,2708,1371,-1337
15890,1,0,18,0,-18
15891,1,0,73,0,-73
15892,1,1,815,1252,437
15893,1,1,364,1202,838
15894,1,0,59,0,-59
15895,1,0,149,0,-149
15896,0,0,114,0,-114
15897,0,0,4,0,-4
15898,0,0,169,0,-169
15899,1,1,757,1576,819
15900,1,1,694,2017,1323
15901,1,1,677,1666,989
15902,1,1,241,1396,1155
15903,0,0,33,0,-33
15904,0,0,46,0,-46
15905,1,1,2403,1375,-1028
15906,1,1,233,1255,1022
15907,1,0,29,0,-29
15908,1,0,58,0,-58
15909,0,0,13,0,-13
15910,1,1,65,1935,1870
15911,1,0,33,0,-33
15912,1,0,13,0,-13
15913,1,1,794,1353,559
15914,1,0,46,0,-46
15915,1,0,53,0,-53
15916,0,0,79,0,-79
15917,0,0,76,0,-76
15918,1,1,1729,1985,256
15919,1,1,61,1666,1605
15920,1,1,92,1773,1681
15921,1,0,2,0,-2
15922,1,0,44,0,-44
15923,1,1,426,1280,854
15924,1,0,125,0,-125
15925,0,0,7,0,-7
15926,0,0,137,0,-137
15927,1,0,2,0,-2
15928,0,0,49,0,-49
15929,0,0,43,0,-43
15930,1,1,284,1473,1189
15931,1,0,80,0,-80
15932,1,1,315,1392,1077
15933,1,1,636,1768,1132
15934,1,0,2,0,-2
15935,1,0,23,0,-23
15936,0,0,7,0,-7
15937,0,0,31,0,-31
15938,1,1,313,1665,1352
15939,1,1,54,1253,1199
15940,1,0,55,0,-55
15941,0,0,5,0,-5
15942,1,0,144,0,-144
15943,1,0,60,0,-60
15944,0,0,21,0,-21
15945,1,0,5,0,-5
15946,1,0,48,0,-48
15947,1,1,625,1353,728
15948,0,0,113,0,-113
15949,0,0,98,0,-98
15950,0,0,42,0,-42
15951,1,0,81,0,-81
15952,1,1,515,1464,949
15953,0,0,36,0,-36
15954,1,1,452,1650,1198
15955,1,1,315,3491,3176
15956,1,0,44,0,-44
15957,0,0,22,0,-22
15958,1,1,709,1264,555
15959,1,1,396,1400,1004
15960,0,0,51,0,-51
15961,1,0,59,0,-59
15962,1,1,197,1536,1339
15963,0,0,46,0,-46
15964,0,0,147,0,-147
15965,1,0,6,0,-6
15966,0,0,39,0,-39
15967,1,1,199,1258,1059
15968,1,1,128,1481,1353
15969,1,0,52,0,-52
15970,1,0,30,0,-30
15971,1,0,60,0,-60
15972,0,0,39,0,-39
15973,1,1,335,1305,970
15974,1,1,451,1686,1235
15975,1,0,89,0,-89
15976,1,1,153,1296,1143
15977,0,0,33,0,-33
15978,0,0,112,0,-112
15979,1,1,846,1275,429
15980,0,0,15,0,-15
15981,1,0,200,0,-200
15982,0,0,88,0,-88
15983,1,0,56,0,-56
15984,1,0,55,0,-55
15985,0,0,35,0,-35
15986,0,0,65,0,-65
15987,1,1,355,5751,5396
15988,0,0,22,0,-22
15989,0,0,46,0,-46
15990,1,1,692,1226,534
15991,0,0,40,0,-40
15992,0,0,80,0,-80
15993,0,0,21,0,-21
15994,1,0,7,0,-7
15995,1,0,108,0,-108
15996,0,0,21,0,-21
15997,0,0,40,0,-40
15998,1,1,114,1589,1475
15999,0,0,5,0,-5
16000,1,1,556,1950,1394
16001,1,0,71,0,-71
16002,1,1,232,1996,1764
16003,1,0,40,0,-40
16004,0,0,22,0,-22
16005,1,1,721,1380,659
16006,1,0,12,0,-12
16007,1,0,9,0,-9
16008,0,0,21,0,-21
16009,1,1,478,1725,1247
16010,1,0,61,0,-61
16011,0,0,39,0,-39
16012,0,0,29,0,-29
16013,1,0,17,0,-17
16014,0,0,85,0,-85
16015,1,1,166,1244,1078
16016,0,0,16,0,-16
16017,1,0,102,0,-102
16018,1,1,570,1273,703
16019,1,1,1164,1207,43
16020,1,0,92,0,-92
16021,0,0,7,0,-7
16022,0,0,22,0,-22
16023,0,0,4,0,-4
16024,1,1,630,2854,2224
16025,0,0,84,0,-84
16026,0,0,52,0,-52
16027,0,0,115,0,-115
16028,1,1,2414,1690,-724
16029,1,0,1,0,-1
16030,0,0,7,0,-7
16031,1,0,9,0,-9
16032,1,0,19,0,-19
16033,1,1,155,1536,1381
16034,0,0,39,0,-39
16035,1,1,787,1244,457
16036,1,1,957,1495,538
16037,0,0,154,0,-154
16038,0,0,53,0,-53
16039,1,1,834,1649,815
16040,0,0,63,0,-63
16041,1,1,139,1414,1275
16042,1,1,58,1384,1326
16043,0,0,65,0,-65
16044,1,1,262,1201,939
16045,0,0,29,0,-29
16046,1,0,36,0,-36
16047,1,1,531,1353,822
16048,1,1,379,1234,855
16049,0,0,155,0,-155
16050,0,0,2,0,-2
16051,1,0,14,0,-14
16052,1,1,171,1330,1159
16053,0,0,13,0,-13
16054,0,0,47,0,-47
16055,0,0,96,0,-96
16056,1,1,489,1440,951
16057,0,0,100,0,-100
16058,1,1,405,1527,1122
16059,1,1,184,1456,1272
16060,1,1,434,1320,886
16061,0,0,13,0,-13
16062,1,1,712,1539,827
16063,1,0,29,0,-29
16064,0,0,22,0,-22
16065,1,0,7,0,-7
16066,1,0,186,0,-186
16067,0,0,17,0,-17
16068,0,0,46,0,-46
16069,0,0,26,0,-26
16070,0,0,9,0,-9
16071,0,0,36,0,-36
16072,1,1,438,1207,769
16073,1,0,48,0,-48
16074,0,0,23,0,-23
16075,1,1,837,1373,536
16076,0,0,134,0,-134
16077,1,1,2110,1758,-352
16078,1,1,310,1642,1332
16079,1,1,266,1420,1154
16080,1,0,11,0,-11
16081,0,0,9,0,-9
16082,0,0,48,0,-48
16083,0,0,35,0,-35
16084,1,0,5,0,-5
16085,0,0,156,0,-156
16086,1,0,25,0,-25
16087,1,0,19,0,-19
16088,1,1,97,3186,3089
16089,1,0,87,0,-87
16090,0,0,1,0,-1
16091,0,0,42,0,-42
16092,1,0,77,0,-77
16093,0,0,3,0,-3
16094,1,0,66,0,-66
16095,0,0,45,0,-45
16096,1,1,687,1332,645
16097,1,1,170,1214,1044
16098,1,1,388,1834,1446
16099,1,0,102,0,-102
16100,0,0,32,0,-32
16101,1,0,100,0,-100
16102,0,0,2,0,-2
16103,0,0,31,0,-31
16104,0,0,4,0,-4
16105,0,0,61,0,-61
16106,1,1,461,1207,746
16107,1,0,56,0,-56
16108,1,0,32,0,-32
16109,0,0,25,0,-25
16110,1,1,148,1423,1275
16111,1,0,31,0,-31
16112,0,0,20,0,-20
16113,1,0,46,0,-46
16114,1,1,212,1830,1618
16115,0,0,21,0,-21
16116,1,0,22,0,-22
16117,1,0,23,0,-23
16118,0,0,15,0,-15
16119,0,0,3,0,-3
16120,0,0,258,0,-258
16121,1,0,141,0,-141
16122,0,0,13,0,-13
16123,0,0,75,0,-75
16124,0,0,12,0,-12
16125,1,0,38,0,-38
16126,1,1,534,1297,763
16127,1,1,546,1213,667
16128,1,0,122,0,-122
16129,1,1,1174,1658,484
16130,1,0,23,0,-23
16131,0,0,33,0,-33
16132,1,0,45,0,-45
16133,0,0,68,0,-68
16134,1,1,354,2065,1711
16135,1,0,82,0,-82
16136,1,0,161,0,-161
16137,0,0,3,0,-3
16138,0,0,21,0,-21
16139,0,0,401,0,-401
16140,0,0,14,0,-14
16141,0,0,27,0,-27
16142,0,0,2,0,-2
16143,1,1,931,1672,741
16144,1,0,20,0,-20
16145,1,0,127,0,-127
16146,0,0,23,0,-23
16147,0,0,189,0,-189
16148,1,1,161,1272,1111
16149,1,1,220,2576,2356
16150,0,0,122,0,-122
16151,0,0,21,0,-21
16152,1,0,14,0,-14
16153,1,1,23,3927,3904
16154,0,0,127,0,-127
16155,1,0,22,0,-22
16156,1,0,7,0,-7
16157,0,0,16,0,-16
16158,1,0,98,0,-98
16159,0,0,42,0,-42
16160,0,0,79,0,-79
16161,0,0,11,0,-11
16162,0,0,16,0,-16
16163,0,0,15,0,-15
16164,0,0,20,0,-20
16165,1,0,5,0,-5
16166,1,0,112,0,-112
16167,1,1,129,1359,1230
16168,1,0,5,0,-5
16169,1,1,980,1362,382
16170,1,0,9,0,-9
16171,0,0,7,0,-7
16172,1,1,184,1259,1075
16173,0,0,135,0,-135
16174,0,0,7,0,-7
16175,1,0,24,0,-24
16176,1,0,21,0,-21
16177,1,0,14,0,-14
16178,1,1,671,1233,562
16179,0,0,6,0,-6
16180,0,0,18,0,-18
16181,1,0,9,0,-9
16182,0,0,27,0,-27
16183,0,0,12,0,-12
16184,1,1,248,1251,1003
16185,1,0,12,0,-12
16186,1,0,12,0,-12
16187,0,0,56,0,-56
16188,1,1,295,1286,991
16189,1,0,27,0,-27
16190,1,1,43,1564,1521
16191,0,0,0,0,0
16192,1,0,139,0,-139
16193,1,1,416,1949,1533
16194,1,0,52,0,-52
16195,0,0,6,0,-6
16196,0,0,33,0,-33
16197,0,0,51,0,-51
16198,1,1,116,1594,1478
16199,1,1,817,1431,614
16200,0,0,37,0,-37
16201,1,0,36,0,-36
16202,1,0,52,0,-52
16203,0,0,17,0,-17
16204,1,0,68,0,-68
16205,1,1,180,1640,1460
16206,0,0,48,0,-48
16207,1,0,0,0,0
16208,0,0,21,0,-21
16209,0,0,101,0,-101
16210,1,0,14,0,-14
16211,1,0,8,0,-8
16212,1,0,43,0,-43
16213,1,1,754,1930,1176
16214,0,0,3,0,-3
16215,1,0,42,0,-42
16216,1,0,74,0,-74
16217,0,0,19,0,-19
16218,1,1,579,1875,1296
16219,0,0,34,0,-34
16220,0,0,41,0,-41
16221,1,1,342,1490,1148
16222,1,0,26,0,-26
16223,0,0,99,0,-99
16224,0,0,72,0,-72
16225,1,0,46,0,-46
16226,0,0,28,0,-28
16227,0,0,71,0,-71
16228,1,1,222,1467,1245
16229,0,0,69,0,-69
16230,1,1,171,1378,1207
16231,0,0,3,0,-3
16232,1,0,75,0,-75
16233,1,0,132,0,-132
16234,1,0,35,0,-35
16235,0,0,12,0,-12
16236,1,0,7,0,-7
16237,0,0,95,0,-95
16238,0,0,59,0,-59
16239,1,1,24,1284,1260
16240,0,0,31,0,-31
16241,0,0,21,0,-21
16242,1,0,76,0,-76
16243,1,0,56,0,-56
16244,0,0,25,0,-25
16245,1,1,256,1548,1292
16246,1,1,650,1417,767
16247,1,0,3,0,-3
16248,1,0,23,0,-23
16249,1,1,176,1362,1186
16250,0,0,65,0,-65
16251,1,0,22,0,-22
16252,0,0,47,0,-47
16253,0,0,6,0,-6
16254,1,1,762,1283,521
16255,0,0,50,0,-50
16256,1,1,136,1457,1321
16257,1,0,62,0,-62
16258,1,1,63,1271,1208
16259,1,1,347,1989,1642
16260,0,0,114,0,-114
16261,1,1,1206,1279,73
16262,1,0,95,0,-95
16263,1,1,38,1413,1375
16264,0,0,10,0,-10
16265,1,0,123,0,-123
16266,0,0,77,0,-77
16267,0,0,31,0,-31
16268,1,0,20,0,-20
16269,0,0,7,0,-7
16270,1,1,457,1588,1131
16271,1,1,809,1200,391
16272,0,0,28,0,-28
16273,1,0,44,0,-44
16274,1,1,227,1685,1458
16275,1,0,11,0,-11
16276,0,0,5,0,-5
16277,1,0,78,0,-78
16278,0,0,83,0,-83
16279,1,1,207,1250,1043
16280,1,1,887,1411,524
16281,1,0,31,0,-31
16282,0,0,71,0,-71
16283,0,0,36,0,-36
16284,0,0,34,0,-34
16285,1,1,906,1245,339
16286,1,1,1131,1421,290
16287,1,0,55,0,-55
16288,1,1,346,1387,1041
16289,1,0,159,0,-159
16290,1,0,89,0,-89
16291,1,0,25,0,-25
16292,1,0,80,0,-80
16293,1,1,170,1204,1034
16294,1,0,21,0,-21
16295,0,0,13,0,-13
16296,1,0,57,0,-57
16297,1,0,63,0,-63
16298,0,0,24,0,-24
16299,1,0,5,0,-5
16300,0,0,175,0,-175
16301,1,0,64,0,-64
16302,0,0,200,0,-200
16303,0,0,124,0,-124
16304,1,1,665,2121,1456
16305,0,0,22,0,-22
16306,1,1,462,2951,2489
16307,1,1,871,1744,873
16308,0,0,3,0,-3
16309,0,0,56,0,-56
16310,1,0,14,0,-14
16311,0,0,74,0,-74
16312,1,1,808,1355,547
16313,1,1,29,1813,1784
16314,1,1,539,1238,699
16315,0,0,30,0,-30
16316,0,0,39,0,-39
16317,1,0,3,0,-3
16318,0,0,8,0,-8
16319,1,0,48,0,-48
16320,1,0,10,0,-10
16321,0,0,47,0,-47
16322,1,0,20,0,-20
16323,1,1,431,1217,786
16324,1,1,446,1284,838
16325,1,0,53,0,-53
16326,1,1,78,1731,1653
16327,0,0,31,0,-31
16328,0,0,6,0,-6
16329,0,0,27,0,-27
16330,1,1,832,1466,634
16331,0,0,36,0,-36
16332,1,1,770,1708,938
16333,1,0,78,0,-78
16334,0,0,47,0,-47
16335,1,0,22,0,-22
16336,1,1,258,1344,1086
16337,0,0,10,0,-10
16338,1,1,238,1217,979
16339,0,0,5,0,-5
16340,0,0,109,0,-109
16341,1,1,80,1220,1140
16342,1,1,1229,1899,670
16343,0,0,35,0,-35
16344,1,1,524,1285,761
16345,1,1,583,1363,780
16346,1,1,506,1441,935
16347,0,0,16,0,-16
16348,1,0,25,0,-25
16349,0,0,42,0,-42
16350,0,0,7,0,-7
16351,0,0,109,0,-109
16352,0,0,16,0,-16
16353,0,0,21,0,-21
16354,0,0,12,0,-12
16355,0,0,39,0,-39
16356,1,1,161,1231,1070
16357,1,0,29,0,-29
16358,0,0,5,0,-5
16359,0,0,4,0,-4
16360,1,1,153,1310,1157
16361,0,0,9,0,-9
16362,1,1,758,1779,1021
16363,1,0,0,0,0
16364,0,0,257,0,-257
16365,1,1,133,1785,1652
16366,1,1,450,1215,765
16367,1,0,8,0,-8
16368,0,0,86,0,-86
16369,1,1,388,1420,1032
16370,1,0,79,0,-79
16371,0,0,31,0,-31
16372,1,1,108,1760,1652
16373,1,1,110,1580,1470
16374,0,0,19,0,-19
16375,1,0,12,0,-12
16376,1,1,77,1955,1878
16377,0,0,26,0,-26
16378,1,0,12,0,-12
16379,0,0,157,0,-157
16380,1,1,446,1203,757
16381,1,0,216,0,-216
16382,1,1,406,1245,839
16383,1,0,55,0,-55
16384,0,0,59,0,-59
16385,1,1,285,1633,1348
16386,1,1,1524,1800,276
16387,1,0,196,0,-196
16388,1,0,25,0,-25
16389,1,1,756,1486,730
16390,0,0,34,0,-34
16391,1,1,1698,1487,-211
16392,1,1,325,3185,2860
16393,1,0,13,0,-13
16394,1,1,1238,1216,-22
16395,1,0,23,0,-23
16396,0,0,4,0,-4
16397,0,0,243,0,-243
16398,1,1,506,1355,849
16399,0,0,2,0,-2
16400,0,0,78,0,-78
16401,0,0,224,0,-224
16402,0,0,9,0,-9
16403,1,0,53,0,-53
16404,1,1,311,1521,1210
16405,1,1,214,1346,1132
16406,1,0,52,0,-52
16407,1,0,17,0,-17
16408,0,0,29,0,-29
16409,1,1,325,1381,1056
16410,0,0,57,0,-57
16411,0,0,20,0,-20
16412,1,1,509,1218,709
16413,0,0,27,0,-27
16414,1,1,1403,1275,-128
16415,1,0,27,0,-27
16416,0,0,0,0,0
16417,1,0,165,0,-165
16418,0,0,10,0,-10
16419,0,0,31,0,-31
16420,1,1,396,1274,878
16421,1,1,703,1241,538
16422,1,1,764,1546,782
16423,1,1,299,1688,1389
16424,1,0,3,0,-3
16425,1,0,31,0,-31
16426,0,0,204,0,-204
16427,1,0,8,0,-8
16428,0,0,2,0,-2
16429,1,0,33,0,-33
16430,1,0,61,0,-61
16431,0,0,68,0,-68
16432,1,0,166,0,-166
16433,0,0,48,0,-48
16434,1,0,20,0,-20
16435,0,0,87,0,-87
16436,1,1,1843,1480,-363
16437,1,0,11,0,-11
16438,1,0,156,0,-156
16439,0,0,78,0,-78
16440,1,0,44,0,-44
16441,0,0,26,0,-26
16442,1,0,27,0,-27
16443,0,0,53,0,-53
16444,0,0,61,0,-61
16445,1,0,89,0,-89
16446,1,1,789,1203,414
16447,0,0,129,0,-129
16448,0,0,46,0,-46
16449,0,0,37,0,-37
16450,0,0,49,0,-49
16451,1,0,25,0,-25
16452,0,0,67,0,-67
16453,0,0,18,0,-18
16454,1,1,63,2173,2110
16455,1,1,45,1316,1271
16456,1,0,58,0,-58
16457,1,0,6,0,-6
16458,0,0,24,0,-24
16459,0,0,44,0,-44
16460,1,0,16,0,-16
16461,1,0,109,0,-109
16462,1,0,31,0,-31
16463,1,0,84,0,-84
16464,0,0,54,0,-54
16465,1,1,1491,1220,-271
16466,1,1,136,1337,1201
16467,1,0,14,0,-14
16468,1,0,176,0,-176
16469,0,0,27,0,-27
16470,1,1,27,1697,1670
16471,1,1,357,1619,1262
16472,0,0,16,0,-16
16473,1,1,1164,1831,667
16474,1,0,141,0,-141
16475,0,0,4,0,-4
16476,0,0,77,0,-77
16477,1,0,85,0,-85
16478,0,0,37,0,-37
16479,1,1,233,2016,1783
16480,1,0,55,0,-55
16481,1,0,69,0,-69
16482,1,0,86,0,-86
16483,0,0,87,0,-87
16484,0,0,81,0,-81
16485,1,1,785,1452,667
16486,1,0,14,0,-14
16487,0,0,0,0,0
16488,0,0,7,0,-7
16489,1,0,49,0,-49
16490,1,0,21,0,-21
16491,1,1,667,2027,1360
16492,1,0,70,0,-70
16493,0,0,66,0,-66
16494,1,0,91,0,-91
16495,1,0,71,0,-71
16496,1,0,17,0,-17
16497,1,0,271,0,-271
16498,1,0,37,0,-37
16499,0,0,48,0,-48
16500,0,0,28,0,-28
16501,1,1,596,2828,2232
16502,0,0,13,0,-13
16503,1,0,0,0,0
16504,0,0,35,0,-35
16505,0,0,22,0,-22
16506,1,1,915,1387,472
16507,1,1,1322,1202,-120
16508,1,0,39,0,-39
16509,0,0,67,0,-67
16510,1,1,410,1478,1068
16511,1,0,31,0,-31
16512,1,1,519,1296,777
16513,0,0,2,0,-2
16514,0,0,12,0,-12
16515,0,0,68,0,-68
16516,1,0,14,0,-14
16517,1,0,9,0,-9
16518,0,0,48,0,-48
16519,0,0,18,0,-18
16520,0,0,18,0,-18
16521,1,0,35,0,-35
16522,0,0,5,0,-5
16523,1,0,33,0,-33
16524,1,0,1,0,-1
16525,1,0,32,0,-32
16526,1,1,497,1764,1267
16527,0,0,15,0,-15
16528,1,0,18,0,-18
16529,1,1,588,1886,1298
16530,1,0,33,0,-33
16531,1,1,450,1280,830
16532,1,0,63,0,-63
16533,1,1,1919,2201,282
16534,1,0,45,0,-45
16535,1,1,68,1506,1438
16536,1,1,722,1259,537
16537,0,0,8,0,-8
16538,1,0,23,0,-23
16539,0,0,177,0,-177
16540,0,0,71,0,-71
16541,0,0,53,0,-53
16542,1,1,482,1290,808
16543,0,0,33,0,-33
16544,1,1,356,1501,1145
16545,1,1,233,1317,1084
16546,0,0,189,0,-189
16547,0,0,47,0,-47
16548,1,0,97,0,-97
16549,0,0,28,0,-28
16550,1,1,1265,2127,862
16551,1,0,7,0,-7
16552,1,1,1354,1268,-86
16553,0,0,59,0,-59
16554,1,0,37,0,-37
16555,1,0,4,0,-4
16556,0,0,40,0,-40
16557,0,0,32,0,-32
16558,1,1,477,1376,899
16559,0,0,64,0,-64
16560,1,1,137,1572,1435
16561,1,0,55,0,-55
16562,0,0,2,0,-2
16563,1,0,9,0,-9
16564,0,0,31,0,-31
16565,0,0,43,0,-43
16566,1,1,386,1204,818
16567,0,0,29,0,-29
16568,0,0,112,0,-112
16569,0,0,115,0,-115
16570,0,0,139,0,-139
16571,1,1,262,1452,1190
16572,1,0,25,0,-25
16573,1,1,494,1521,1027
16574,1,0,37,0,-37
16575,1,1,125,1575,1450
16576,1,0,7,0,-7
16577,0,0,10,0,-10
16578,1,1,888,1259,371
16579,1,1,329,1477,1148
16580,1,0,36,0,-36
16581,1,1,979,1460,481
16582,1,1,205,1659,1454
16583,0,0,59,0,-59
16584,0,0,14,0,-14
16585,1,1,63,1350,1287
16586,1,0,20,0,-20
16587,1,1,215,1237,1022
16588,0,0,24,0,-24
16589,1,1,1133,1796,663
16590,1,0,77,0,-77
16591,1,1,801,1421,620
16592,1,0,19,0,-19
16593,1,1,454,1241,787
16594,1,1,291,1219,928
16595,1,0,37,0,-37
16596,0,0,75,0,-75
16597,0,0,151,0,-151
16598,1,0,16,0,-16
16599,1,1,17,1209,1192
16600,1,1,211,1378,1167
16601,1,1,178,1310,1132
16602,1,0,26,0,-26
16603,0,0,73,0,-73
16604,1,1,155,1984,1829
16605,1,1,458,1343,885
16606,0,0,53,0,-53
16607,1,1,622,1604,982
16608,1,0,291,0,-291
16609,0,0,132,0,-132
16610,0,0,21,0,-21
16611,0,0,6,0,-6
16612,0,0,5,0,-5
16613,1,0,9,0,-9
16614,1,0,8,0,-8
16615,0,0,46,0,-46
16616,0,0,12,0,-12
16617,1,1,480,1297,817
16618,1,0,1,0,-1
16619,1,1,30,1220,1190
16620,1,1,44,1224,1180
16621,1,0,1,0,-1
16622,0,0,57,0,-57
16623,1,0,2,0,-2
16624,1,0,327,0,-327
16625,0,0,9,0,-9
16626,0,0,64,0,-64
16627,1,1,276,1334,1058
16628,1,1,1026,2422,1396
16629,1,1,798,2249,1451
16630,1,0,103,0,-103
16631,1,1,849,1576,727
16632,0,0,46,0,-46
16633,0,0,45,0,-45
16634,1,1,412,4329,3917
16635,1,0,24,0,-24
16636,0,0,305,0,-305
16637,0,0,87,0,-87
16638,1,0,216,0,-216
16639,1,0,187,0,-187
16640,1,1,229,1539,1310
16641,1,0,99,0,-99
16642,0,0,11,0,-11
16643,1,0,8,0,-8
16644,1,1,197,1219,1022
16645,1,0,82,0,-82
16646,1,0,1,0,-1
16647,1,0,17,0,-17
16648,1,0,75,0,-75
16649,0,0,133,0,-133
16650,1,0,14,0,-14
16651,0,0,35,0,-35
16652,1,0,10,0,-10
16653,1,1,397,1256,859
16654,0,0,69,0,-69
16655,1,1,771,2640,1869
16656,0,0,31,0,-31
16657,1,1,363,1352,989
16658,1,1,100,1229,1129
16659,1,1,373,1575,1202
16660,0,0,5,0,-5
16661,1,0,34,0,-34
16662,1,0,77,0,-77
16663,0,0,49,0,-49
16664,1,1,263,1537,1274
16665,0,0,5,0,-5
16666,0,0,28,0,-28
16667,0,0,82,0,-82
16668,0,0,91,0,-91
16669,1,0,17,0,-17
16670,0,0,29,0,-29
16671,0,0,83,0,-83
16672,1,0,31,0,-31
16673,0,0,2,0,-2
16674,1,1,196,1239,1043
16675,1,0,64,0,-64
16676,1,0,24,0,-24
16677,1,0,43,0,-43
16678,1,0,7,0,-7
16679,1,0,63,0,-63
16680,0,0,30,0,-30
16681,1,0,40,0,-40
16682,1,0,41,0,-41
16683,1,1,70,1573,1503
16684,0,0,33,0,-33
16685,1,0,0,0,0
16686,1,0,1,0,-1
16687,1,0,10,0,-10
16688,0,0,130,0,-130
16689,1,0,35,0,-35
16690,1,0,36,0,-36
16691,0,0,27,0,-27
16692,0,0,24,0,-24
16693,1,1,35,1369,1334
16694,1,0,16,0,-16
16695,0,0,84,0,-84
16696,0,0,21,0,-21
16697,1,0,12,0,-12
16698,0,0,33,0,-33
16699,0,0,56,0,-56
16700,1,0,105,0,-105
16701,0,0,38,0,-38
16702,1,0,2,0,-2
16703,1,0,102,0,-102
16704,1,0,45,0,-45
16705,1,1,334,1211,877
16706,1,0,23,0,-23
16707,1,0,8,0,-8
16708,0,0,1,0,-1
16709,1,0,68,0,-68
16710,1,1,571,2087,1516
16711,0,0,16,0,-16
16712,1,0,1,0,-1
16713,0,0,184,0,-184
16714,1,0,5,0,-5
16715,0,0,22,0,-22
16716,1,1,839,1276,437
16717,0,0,3,0,-3
16718,0,0,25,0,-25
16719,0,0,135,0,-135
16720,0,0,18,0,-18
16721,1,0,29,0,-29
16722,0,0,46,0,-46
16723,1,1,567,2419,1852
16724,0,0,13,0,-13
16725,1,1,1051,1420,369
16726,0,0,176,0,-176
16727,1,1,520,1473,953
16728,0,0,27,0,-27
16729,0,0,55,0,-55
16730,1,1,578,1241,663
16731,0,0,12,0,-12
16732,1,0,14,0,-14
16733,1,0,55,0,-55
16734,1,1,2510,1537,-973
16735,0,0,25,0,-25
16736,1,1,330,1728,1398
16737,1,1,47,1602,1555
16738,0,0,3,0,-3
16739,1,1,406,1969,1563
16740,1,1,321,1221,900
16741,1,1,1628,1240,-388
16742,1,0,8,0,-8
16743,0,0,110,0,-110
16744,0,0,2,0,-2
16745,1,0,153,0,-153
16746,0,0,58,0,-58
16747,0,0,112,0,-112
16748,0,0,67,0,-67
16749,0,0,79,0,-79
16750,0,0,40,0,-40
16751,1,1,344,1465,1121
16752,1,0,28,0,-28
16753,1,1,859,1316,457
16754,0,0,63,0,-63
16755,0,0,124,0,-124
16756,1,0,149,0,-149
16757,0,0,2,0,-2
16758,1,1,473,1338,865
16759,0,0,10,0,-10
16760,1,0,1,0,-1
16761,1,0,91,0,-91
16762,0,0,48,0,-48
16763,1,1,979,1259,280
16764,1,0,38,0,-38
16765,0,0,13,0,-13
16766,0,0,7,0,-7
16767,0,0,12,0,-12
16768,1,1,417,1325,908
16769,0,0,192,0,-192
16770,1,0,39,0,-39
16771,0,0,4,0,-4
16772,0,0,26,0,-26
16773,1,1,215,1358,1143
16774,1,0,46,0,-46
16775,1,1,1720,1366,-354
16776,1,0,19,0,-19
16777,1,1,689,1482,793
16778,1,0,150,0,-150
16779,1,1,780,1332,552
16780,1,1,320,1285,965
16781,0,0,0,0,0
16782,0,0,42,0,-42
16783,0,0,17,0,-17
16784,1,1,345,1215,870
16785,1,1,342,1820,1478
16786,1,0,88,0,-88
16787,0,0,27,0,-27
16788,0,0,13,0,-13
16789,0,0,40,0,-40
16790,1,0,51,0,-51
16791,0,0,0,0,0
16792,1,0,9,0,-9
16793,1,0,36,0,-36
16794,0,0,7,0,-7
16795,1,0,56,0,-56
16796,0,0,202,0,-202
16797,1,0,12,0,-12
16798,0,0,21,0,-21
16799,0,0,18,0,-18
16800,1,0,128,0,-128
16801,1,1,690,1203,513
16802,1,0,5,0,-5
16803,1,1,373,1296,923
16804,1,0,8,0,-8
16805,1,1,574,1850,1276
16806,0,0,29,0,-29
16807,0,0,146,0,-146
16808,1,1,652,1408,756
16809,1,1,465,1515,1050
16810,0,0,29,0,-29
16811,0,0,54,0,-54
16812,1,0,26,0,-26
16813,1,1,262,1418,1156
16814,1,0,27,0,-27
16815,0,0,37,0,-37
16816,1,0,45,0,-45
16817,0,0,44,0,-44
16818,0,0,196,0,-196
16819,1,0,26,0,-26
16820,1,0,52,0,-52
16821,1,0,43,0,-43
16822,1,0,10,0,-10
16823,0,0,51,0,-51
16824,1,0,27,0,-27
16825,1,0,0,0,0
16826,1,1,102,1343,1241
16827,1,0,59,0,-59
16828,1,0,27,0,-27
16829,1,1,699,1675,976
16830,0,0,26,0,-26
16831,1,1,314,1229,915
16832,0,0,17,0,-17
16833,0,0,6,0,-6
16834,0,0,29,0,-29
16835,0,0,9,0,-9
16836,1,1,160,1312,1152
16837,1,0,5,0,-5
16838,0,0,63,0,-63
16839,0,0,52,0,-52
16840,1,1,21,2129,2108
16841,0,0,15,0,-15
16842,0,0,66,0,-66
16843,1,0,14,0,-14
16844,1,1,192,1317,1125
16845,1,0,16,0,-16
16846,0,0,26,0,-26
16847,1,0,4,0,-4
16848,0,0,28,0,-28
16849,1,1,300,1237,937
16850,1,0,42,0,-42
16851,1,1,165,1312,1147
16852,1,1,54,1205,1151
16853,1,1,216,1257,1041
16854,1,1,1748,2096,348
16855,0,0,72,0,-72
16856,0,0,95,0,-95
16857,0,0,46,0,-46
16858,1,1,2183,1287,-896
16859,1,1,1034,1812,778
16860,1,1,28,1371,1343
16861,1,1,818,2718,1900
16862,0,0,113,0,-113
16863,0,0,24,0,-24
16864,0,0,6,0,-6
16865,1,1,144,1576,1432
16866,0,0,51,0,-51
16867,0,0,30,0,-30
16868,1,0,6,0,-6
16869,0,0,59,0,-59
16870,1,0,11,0,-11
16871,1,1,87,2431,2344
16872,1,0,124,0,-124
16873,0,0,31,0,-31
16874,1,1,699,1894,1195
16875,1,1,152,1327,1175
16876,1,1,111,1275,1164
16877,0,0,169,0,-169
16878,1,0,1,0,-1
16879,1,0,63,0,-63
16880,1,0,4,0,-4
16881,1,0,26,0,-26
16882,1,1,1005,1609,604
16883,1,1,628,1231,603
16884,1,1,365,1435,1070
16885,0,0,11,0,-11
16886,0,0,35,0,-35
16887,1,0,37,0,-37
16888,0,0,3,0,-3
16889,1,0,27,0,-27
16890,1,1,323,1311,988
16891,0,0,9,0,-9
16892,1,1,982,1979,997
16893,1,1,2190,1326,-864
16894,0,0,87,0,-87
16895,1,1,776,1335,559
16896,1,1,1282,1738,456
16897,1,0,14,0,-14
16898,1,1,530,1412,882
16899,1,1,205,1312,1107
16900,0,0,13,0,-13
16901,0,0,52,0,-52
16902,0,0,20,0,-20
16903,1,0,162,0,-162
16904,0,0,1,0,-1
16905,0,0,33,0,-33
16906,1,0,39,0,-39
16907,1,1,252,2364,2112
16908,0,0,18,0,-18
16909,0,0,34,0,-34
16910,1,0,119,0,-119
16911,0,0,231,0,-231
16912,1,1,160,2280,2120
16913,0,0,10,0,-10
16914,0,0,13,0,-13
16915,1,1,39,1845,1806
16916,0,0,60,0,-60
16917,0,0,31,0,-31
16918,1,1,78,1432,1354
16919,1,0,7,0,-7
16920,0,0,66,0,-66
16921,0,0,23,0,-23
16922,0,0,19,0,-19
16923,1,1,117,1684,1567
16924,0,0,123,0,-123
16925,0,0,6,0,-6
16926,1,0,10,0,-10
16927,1,1,172,1573,1401
16928,1,1,604,2608,2004
16929,0,0,89,0,-89
16930,1,0,74,0,-74
16931,0,0,11,0,-11
16932,1,0,213,0,-213
16933,1,0,77,0,-77
16934,1,1,131,1483,1352
16935,0,0,27,0,-27
16936,1,0,4,0,-4
16937,1,1,186,1454,1268
16938,0,0,40,0,-40
16939,0,0,4,0,-4
16940,1,1,148,1209,1061
16941,1,1,481,1306,825
16942,0,0,32,0,-32
16943,0,0,9,0,-9
16944,0,0,11,0,-11
16945,0,0,5,0,-5
16946,0,0,126,0,-126
16947,1,1,82,1555,1473
16948,1,1,613,1333,720
16949,0,0,7,0,-7
16950,1,0,50,0,-50
16951,1,1,548,3085,2537
16952,1,1,280,1201,921
16953,0,0,75,0,-75
16954,1,1,669,1537,868
16955,1,1,621,1520,899
16956,1,1,100,2021,1921
16957,0,0,201,0,-201
16958,1,1,1443,1380,-63
16959,1,1,263,1234,971
16960,1,1,387,1703,1316
16961,0,0,39,0,-39
16962,1,0,1,0,-1
16963,1,0,33,0,-33
16964,1,0,53,0,-53
16965,0,0,109,0,-109
16966,0,0,14,0,-14
16967,1,0,6,0,-6
16968,1,1,888,1644,756
16969,1,1,588,1270,682
16970,1,1,146,1447,1301
16971,1,1,1518,1393,-125
16972,1,0,101,0,-101
16973,0,0,52,0,-52
16974,1,0,54,0,-54
16975,0,0,46,0,-46
16976,1,1,3372,1418,-1954
16977,0,0,13,0,-13
16978,1,0,19,0,-19
16979,1,1,871,1395,524
16980,1,0,37,0,-37
16981,1,1,92,1757,1665
16982,0,0,35,0,-35
16983,0,0,25,0,-25
16984,1,1,223,1344,1121
16985,0,0,39,0,-39
16986,1,0,15,0,-15
16987,1,1,1097,1702,605
16988,1,0,14,0,-14
16989,1,0,111,0,-111
16990,1,0,24,0,-24
16991,1,1,43,1690,1647
16992,0,0,44,0,-44
16993,0,0,17,0,-17
16994,0,0,27,0,-27
16995,1,0,114,0,-114
16996,1,0,40,0,-40
16997,1,1,768,1202,434
16998,1,1,598,3080,2482
16999,1,0,35,0,-35
17000,0,0,56,0,-56
17001,1,0,74,0,-74
17002,1,1,512,1635,1123
17003,1,0,96,0,-96
17004,1,0,21,0,-21
17005,1,1,984,1211,227
17006,0,0,3,0,-3
17007,1,0,49,0,-49
17008,1,1,106,1339,1233
17009,1,0,96,0,-96
17010,1,1,281,1232,951
17011,1,1,413,2124,1711
17012,0,0,39,0,-39
17013,0,0,117,0,-117
17014,1,0,38,0,-38
17015,1,0,87,0,-87
17016,1,1,177,1305,1128
17017,1,0,91,0,-91
17018,1,0,11,0,-11
17019,0,0,129,0,-129
17020,0,0,64,0,-64
17021,1,0,111,0,-111
17022,0,0,2,0,-2
17023,0,0,83,0,-83
17024,0,0,162,0,-162
17025,1,0,25,0,-25
17026,1,1,162,2070,1908
17027,1,0,29,0,-29
17028,0,0,77,0,-77
17029,1,0,85,0,-85
17030,0,0,47,0,-47
17031,1,0,23,0,-23
17032,1,0,1,0,-1
17033,0,0,53,0,-53
17034,0,0,2,0,-2
17035,1,0,61,0,-61
17036,1,1,166,1281,1115
17037,1,1,25,1357,1332
17038,0,0,155,0,-155
17039,1,1,758,10837,10079
17040,1,1,741,1719,978
17041,1,0,52,0,-52
17042,0,0,10,0,-10
17043,1,1,675,1290,615
17044,1,1,491,1398,907
17045,1,1,1732,1278,-454
17046,0,0,14,0,-14
17047,1,1,486,1344,858
17048,0,0,21,0,-21
17049,0,0,31,0,-31
17050,0,0,22,0,-22
17051,1,0,14,0,-14
17052,1,0,3,0,-3
17053,0,0,99,0,-99
17054,1,1,543,1377,834
17055,1,0,48,0,-48
17056,1,0,98,0,-98
17057,1,0,85,0,-85
17058,1,1,427,1509,1082
17059,0,0,47,0,-47
17060,1,0,26,0,-26
17061,1,0,235,0,-235
17062,0,0,158,0,-158
17063,0,0,45,0,-45
17064,1,1,145,1231,1086
17065,1,0,46,0,-46
17066,0,0,121,0,-121
17067,1,0,209,0,-209
17068,1,0,18,0,-18
17069,0,0,51,0,-51
17070,1,0,44,0,-44
17071,0,0,29,0,-29
17072,1,0,26,0,-26
17073,1,0,11,0,-11
17074,0,0,15,0,-15
17075,1,0,133,0,-133
17076,0,0,65,0,-65
17077,0,0,16,0,-16
17078,1,0,10,0,-10
17079,1,1,773,1602,829
17080,1,0,319,0,-319
17081,0,0,55,0,-55
17082,1,1,169,1618,1449
17083,1,1,1154,1668,514
17084,0,0,27,0,-27
17085,1,1,475,1481,1006
17086,1,1,119,1202,1083
17087,0,0,9,0,-9
17088,1,1,484,3077,2593
17089,1,0,5,0,-5
17090,0,0,35,0,-35
17091,1,0,20,0,-20
17092,1,0,43,0,-43
17093,0,0,18,0,-18
17094,0,0,147,0,-147
17095,1,0,94,0,-94
17096,0,0,15,0,-15
17097,1,0,35,0,-35
17098,1,1,376,1211,835
17099,0,0,5,0,-5
17100,1,0,55,0,-55
17101,1,1,185,2157,1972
17102,0,0,23,0,-23
17103,1,0,22,0,-22
17104,1,1,1038,1282,244
17105,1,0,32,0,-32
17106,1,1,907,1521,614
17107,0,0,85,0,-85
17108,1,0,49,0,-49
17109,0,0,8,0,-8
17110,0,0,111,0,-111
17111,0,0,94,0,-94
17112,0,0,191,0,-191
17113,1,0,87,0,-87
17114,0,0,47,0,-47
17115,1,0,30,0,-30
17116,0,0,24,0,-24
17117,1,0,152,0,-152
17118,0,0,61,0,-61
17119,1,0,44,0,-44
17120,0,0,0,0,0
17121,1,1,1091,2376,1285
17122,0,0,84,0,-84
17123,1,0,5,0,-5
17124,1,0,69,0,-69
17125,1,0,15,0,-15
17126,1,0,15,0,-15
17127,1,1,485,2414,1929
17128,1,1,515,1295,780
17129,0,0,54,0,-54
17130,0,0,65,0,-65
17131,0,0,21,0,-21
17132,1,1,276,1432,1156
17133,1,0,80,0,-80
17134,1,0,40,0,-40
17135,1,1,554,1326,772
17136,1,1,801,1346,545
17137,1,1,643,2597,1954
17138,0,0,21,0,-21
17139,1,0,27,0,-27
17140,1,0,0,0,0
17141,1,1,537,1882,1345
17142,1,1,805,1982,1177
17143,0,0,83,0,-83
17144,1,1,247,1499,1252
17145,0,0,50,0,-50
17146,1,0,38,0,-38
17147,1,1,496,1802,1306
17148,1,0,13,0,-13
17149,1,0,38,0,-38
17150,1,1,764,1805,1041
17151,0,0,6,0,-6
17152,0,0,0,0,0
17153,0,0,48,0,-48
17154,1,1,243,1503,1260
17155,1,0,39,0,-39
17156,0,0,115,0,-115
17157,1,1,491,2085,1594
17158,1,1,1440,1682,242
17159,1,1,129,1276,1147
17160,1,0,31,0,-31
17161,0,0,60,0,-60
17162,1,1,663,1281,618
17163,1,0,82,0,-82
17164,0,0,22,0,-22
17165,1,0,34,0,-34
17166,0,0,91,0,-91
17167,1,0,19,0,-19
17168,1,0,52,0,-52
17169,1,1,364,1471,1107
17170,1,0,55,0,-55
17171,1,1,1222,1326,104
17172,0,0,21,0,-21
17173,1,1,133,2117,1984
17174,0,0,1,0,-1
17175,1,0,96,0,-96
17176,1,0,32,0,-32
17177,1,0,28,0,-28
17178,1,1,426,1347,921
17179,0,0,63,0,-63
17180,1,1,1294,1300,6
17181,1,0,3,0,-3
17182,1,0,40,0,-40
17183,1,1,582,1863,1281
17184,1,0,59,0,-59
17185,1,1,182,1214,1032
17186,0,0,44,0,-44
17187,0,0,34,0,-34
17188,0,0,55,0,-55
17189,1,1,152,1330,1178
17190,0,0,34,0,-34
17191,0,0,61,0,-61
17192,1,0,104,0,-104
17193,0,0,43,0,-43
17194,0,0,55,0,-55
17195,0,0,13,0,-13
17196,1,0,2,0,-2
17197,1,0,11,0,-11
17198,1,1,1255,1635,380
17199,1,0,78,0,-78
17200,1,0,111,0,-111
17201,1,1,835,1246,411
17202,1,1,428,2649,2221
17203,1,0,60,0,-60
17204,1,0,63,0,-63
17205,0,0,19,0,-19
17206,1,0,14,0,-14
17207,1,0,38,0,-38
17208,1,0,20,0,-20
17209,0,0,150,0,-150
17210,1,1,58,1525,1467
17211,1,0,107,0,-107
17212,1,0,4,0,-4
17213,1,1,162,2965,2803
17214,0,0,60,0,-60
17215,1,0,47,0,-47
17216,1,1,1462,1578,116
17217,1,1,70,1215,1145
17218,1,0,55,0,-55
17219,0,0,7,0,-7
17220,1,1,276,1275,999
17221,1,1,478,1539,1061
17222,0,0,44,0,-44
17223,1,0,21,0,-21
17224,0,0,218,0,-218
17225,0,0,65,0,-65
17226,0,0,52,0,-52
17227,1,0,102,0,-102
17228,1,1,214,1256,1042
17229,0,0,26,0,-26
17230,1,0,45,0,-45
17231,0,0,122,0,-122
17232,1,0,124,0,-124
17233,1,0,98,0,-98
17234,0,0,125,0,-125
17235,1,0,12,0,-12
17236,0,0,127,0,-127
17237,0,0,60,0,-60
17238,1,1,424,1210,786
17239,0,0,35,0,-35
17240,0,0,23,0,-23
17241,0,0,20,0,-20
17242,1,1,272,1200,928
17243,0,0,34,0,-34
17244,0,0,35,0,-35
17245,0,0,34,0,-34
17246,1,1,636,1347,711
17247,1,0,64,0,-64
17248,0,0,45,0,-45
17249,1,0,19,0,-19
17250,0,0,32,0,-32
17251,1,0,9,0,-9
17252,0,0,101,0,-101
17253,1,0,11,0,-11
17254,0,0,28,0,-28
17255,0,0,25,0,-25
17256,1,1,823,1674,851
17257,1,0,78,0,-78
17258,0,0,54,0,-54
17259,0,0,61,0,-61
17260,1,0,52,0,-52
17261,1,0,19,0,-19
17262,1,1,241,1206,965
17263,1,0,53,0,-53
17264,0,0,58,0,-58
17265,1,1,412,1289,877
17266,1,1,781,1340,559
17267,0,0,31,0,-31
17268,1,0,69,0,-69
17269,1,1,64,1400,1336
17270,0,0,79,0,-79
17271,0,0,112,0,-112
17272,0,0,42,0,-42
17273,1,0,4,0,-4
17274,1,0,61,0,-61
17275,1,0,142,0,-142
17276,0,0,59,0,-59
17277,1,1,571,1575,1004
17278,0,0,32,0,-32
17279,1,1,824,1304,480
17280,1,0,36,0,-36
17281,1,0,9,0,-9
17282,0,0,26,0,-26
17283,0,0,48,0,-48
17284,1,1,1687,1419,-268
17285,0,0,7,0,-7
17286,1,0,41,0,-41
17287,0,0,67,0,-67
17288,0,0,50,0,-50
17289,1,1,285,1247,962
17290,0,0,19,0,-19
17291,1,1,189,1505,1316
17292,0,0,8,0,-8
17293,1,1,494,1313,819
17294,0,0,43,0,-43
17295,0,0,19,0,-19
17296,1,0,31,0,-31
17297,1,0,61,0,-61
17298,0,0,19,0,-19
17299,1,0,68,0,-68
17300,1,1,1223,1754,531
17301,1,0,78,0,-78
17302,0,0,30,0,-30
17303,1,1,724,1328,604
17304,0,0,3,0,-3
17305,0,0,19,0,-19
17306,0,0,21,0,-21
17307,0,0,63,0,-63
17308,0,0,10,0,-10
17309,1,1,61,1545,1484
17310,0,0,28,0,-28
17311,1,0,11,0,-11
17312,1,0,52,0,-52
17313,0,0,113,0,-113
17314,0,0,41,0,-41
17315,0,0,18,0,-18
17316,0,0,117,0,-117
17317,1,1,452,1289,837
17318,1,1,1698,1664,-34
17319,1,1,518,1458,940
17320,1,1,513,1385,872
17321,1,0,75,0,-75
17322,1,0,72,0,-72
17323,1,1,58,1672,1614
17324,0,0,11,0,-11
17325,1,1,170,1357,1187
17326,1,1,599,1890,1291
17327,1,0,15,0,-15
17328,0,0,81,0,-81
17329,1,1,90,1554,1464
17330,1,0,83,0,-83
17331,0,0,139,0,-139
17332,1,0,0,0,0
17333,0,0,20,0,-20
17334,1,0,50,0,-50
17335,1,1,1040,1292,252
17336,1,1,858,1245,387
17337,1,0,111,0,-111
17338,1,1,238,1488,1250
17339,0,0,116,0,-116
17340,1,0,24,0,-24
17341,1,0,146,0,-146
17342,1,1,400,2350,1950
17343,0,0,2,0,-2
17344,1,0,24,0,-24
17345,1,0,113,0,-113
17346,1,1,142,1860,1718
17347,0,0,15,0,-15
17348,1,0,61,0,-61
17349,1,1,156,1963,1807
17350,0,0,44,0,-44
17351,0,0,5,0,-5
17352,1,0,94,0,-94
17353,0,0,221,0,-221
17354,1,1,469,1274,805
17355,1,0,0,0,0
17356,0,0,72,0,-72
17357,0,0,81,0,-81
17358,1,0,10,0,-10
17359,1,0,38,0,-38
17360,0,0,5,0,-5
17361,1,0,8,0,-8
17362,1,1,775,1734,959
17363,1,0,83,0,-83
17364,1,0,6,0,-6
17365,1,1,294,2556,2262
17366,0,0,6,0,-6
17367,1,1,98,1484,1386
17368,0,0,4,0,-4
17369,1,0,5,0,-5
17370,0,0,94,0,-94
17371,1,0,24,0,-24
17372,0,0,35,0,-35
17373,0,0,57,0,-57
17374,0,0,0,0,0
17375,1,0,198,0,-198
17376,0,0,61,0,-61
17377,1,1,358,1726,1368
17378,1,1,1006,1533,527
17379,0,0,17,0,-17
17380,0,0,0,0,0
17381,0,0,67,0,-67
17382,1,0,1,0,-1
17383,0,0,62,0,-62
17384,1,1,270,1288,1018
17385,1,0,37,0,-37
17386,1,1,835,2265,1430
17387,1,0,44,0,-44
17388,0,0,26,0,-26
17389,0,0,19,0,-19
17390,0,0,26,0,-26
17391,1,1,1792,1316,-476
17392,0,0,88,0,-88
17393,1,0,3,0,-3
17394,0,0,7,0,-7
17395,1,0,21,0,-21
17396,0,0,51,0,-51
17397,1,0,56,0,-56
17398,1,1,90,1221,1131
17399,0,0,6,0,-6
17400,0,0,49,0,-49
17401,1,1,831,1378,547
17402,0,0,63,0,-63
17403,1,0,51,0,-51
17404,0,0,72,0,-72
17405,0,0,57,0,-57
17406,1,1,486,1247,761
17407,1,0,11,0,-11
17408,1,0,40,0,-40
17409,0,0,35,0,-35
17410,1,0,52,0,-52
17411,1,1,761,1999,1238
17412,0,0,3,0,-3
17413,1,0,6,0,-6
17414,0,0,111,0,-111
17415,0,0,7,0,-7
17416,0,0,51,0,-51
17417,1,1,440,1349,909
17418,1,0,0,0,0
17419,1,0,0,0,0
17420,0,0,77,0,-77
17421,0,0,176,0,-176
17422,1,1,451,1244,793
17423,0,0,27,0,-27
17424,1,1,1307,1773,466
17425,0,0,23,0,-23
17426,1,1,1254,1553,299
17427,1,0,7,0,-7
17428,1,1,377,1558,1181
17429,0,0,20,0,-20
17430,1,0,16,0,-16
17431,1,0,7,0,-7
17432,0,0,21,0,-21
17433,1,1,2570,1625,-945
17434,1,1,719,1262,543
17435,0,0,34,0,-34
17436,1,0,35,0,-35
17437,0,0,2,0,-2
17438,1,0,54,0,-54
17439,1,1,42,1811,1769
17440,0,0,128,0,-128
17441,1,0,3,0,-3
17442,1,0,9,0,-9
17443,1,1,373,1839,1466
17444,1,1,584,2108,1524
17445,0,0,6,0,-6
17446,1,1,604,1701,1097
17447,0,0,56,0,-56
17448,0,0,46,0,-46
17449,1,1,1153,1782,629
17450,0,0,26,0,-26
17451,1,1,431,1521,1090
17452,1,0,12,0,-12
17453,0,0,94,0,-94
17454,1,1,433,1754,1321
17455,0,0,47,0,-47
17456,1,1,1515,1976,461
17457,1,0,79,0,-79
17458,0,0,9,0,-9
17459,1,0,37,0,-37
17460,1,1,593,1467,874
17461,0,0,75,0,-75
17462,1,1,509,1357,848
17463,0,0,4,0,-4
17464,1,0,27,0,-27
17465,0,0,10,0,-10
17466,1,0,1,0,-1
17467,0,0,17,0,-17
17468,1,1,5,1301,1296
17469,0,0,19,0,-19
17470,0,0,31,0,-31
17471,1,1,616,1275,659
17472,1,1,367,1228,861
17473,0,0,24,0,-24
17474,1,1,139,1285,1146
17475,1,1,1385,1240,-145
17476,0,0,1,0,-1
17477,1,1,885,1258,373
17478,1,1,125,1368,1243
17479,1,0,30,0,-30
17480,0,0,15,0,-15
17481,1,0,20,0,-20
17482,0,0,37,0,-37
17483,1,1,417,1663,1246
17484,1,1,728,1366,638
17485,0,0,25,0,-25
17486,1,1,522,1331,809
17487,1,1,115,2049,1934
17488,1,1,111,1361,1250
17489,1,0,24,0,-24
17490,0,0,21,0,-21
17491,1,0,4,0,-4
17492,1,1,585,1304,719
17493,1,1,1094,1275,181
17494,0,0,28,0,-28
17495,1,1,117,1299,1182
17496,0,0,20,0,-20
17497,0,0,118,0,-118
17498,0,0,15,0,-15
17499,1,1,52,1429,1377
17500,1,0,185,0,-185
17501,1,0,0,0,0
17502,1,0,26,0,-26
17503,0,0,6,0,-6
17504,1,0,121,0,-121
17505,0,0,138,0,-138
17506,0,0,63,0,-63
17507,0,0,35,0,-35
17508,0,0,3,0,-3
17509,1,0,73,0,-73
17510,0,0,146,0,-146
17511,0,0,45,0,-45
17512,0,0,92,0,-92
17513,1,1,89,1281,1192
17514,1,0,2,0,-2
17515,1,1,120,1787,1667
17516,1,0,141,0,-141
17517,1,1,668,1360,692
17518,1,1,1287,1214,-73
17519,1,1,306,1201,895
17520,1,0,12,0,-12
17521,0,0,111,0,-111
17522,0,0,66,0,-66
17523,1,0,9,0,-9
17524,0,0,22,0,-22
17525,0,0,25,0,-25
17526,0,0,64,0,-64
17527,1,1,193,2488,2295
17528,0,0,45,0,-45
17529,1,0,60,0,-60
17530,1,1,144,1907,1763
17531,1,0,13,0,-13
17532,1,1,291,3203,2912
17533,0,0,85,0,-85
17534,1,1,475,1230,755
17535,1,1,206,1570,1364
17536,1,0,9,0,-9
17537,1,1,72,1756,1684
17538,1,1,720,1951,1231
17539,0,0,23,0,-23
17540,1,0,19,0,-19
17541,0,0,28,0,-28
17542,1,1,388,1503,1115
17543,0,0,5,0,-5
17544,0,0,55,0,-55
17545,1,0,3,0,-3
17546,0,0,97,0,-97
17547,1,0,35,0,-35
17548,0,0,6,0,-6
17549,0,0,38,0,-38
17550,0,0,27,0,-27
17551,1,0,15,0,-15
17552,0,0,53,0,-53
17553,1,1,194,1555,1361
17554,1,1,57,1509,1452
17555,0,0,70,0,-70
17556,0,0,69,0,-69
17557,1,0,6,0,-6
17558,0,0,48,0,-48
17559,0,0,155,0,-155
17560,0,0,3,0,-3
17561,1,1,772,1424,652
17562,1,0,55,0,-55
17563,1,1,894,1773,879
17564,0,0,88,0,-88
17565,1,1,609,1576,967
17566,1,0,105,0,-105
17567,1,0,49,0,-49
17568,0,0,58,0,-58
17569,0,0,25,0,-25
17570,0,0,56,0,-56
17571,1,1,376,1372,996
17572,1,1,1295,1276,-19
17573,1,0,5,0,-5
17574,0,0,42,0,-42
17575,0,0,52,0,-52
17576,0,0,64,0,-64
17577,0,0,39,0,-39
17578,1,1,649,1522,873
17579,0,0,121,0,-121
17580,1,0,4,0,-4
17581,0,0,7,0,-7
17582,1,0,1,0,-1
17583,1,0,8,0,-8
17584,0,0,83,0,-83
17585,0,0,86,0,-86
17586,0,0,46,0,-46
17587,0,0,40,0,-40
17588,1,1,298,1993,1695
17589,1,1,256,1322,1066
17590,0,0,6,0,-6
17591,1,1,534,1239,705
17592,0,0,40,0,-40
17593,0,0,33,0,-33
17594,0,0,123,0,-123
17595,1,1,481,1222,741
17596,0,0,44,0,-44
17597,1,1,217,1933,1716
17598,0,0,14,0,-14
17599,1,1,824,1429,605
17600,1,0,197,0,-197
17601,1,0,0,0,0
17602,1,0,34,0,-34
17603,0,0,28,0,-28
17604,1,1,1211,1218,7
17605,1,0,43,0,-43
17606,1,0,9,0,-9
17607,0,0,23,0,-23
17608,1,0,301,0,-301
17609,0,0,25,0,-25
17610,0,0,22,0,-22
17611,0,0,3,0,-3
17612,1,0,96,0,-96
17613,0,0,20,0,-20
17614,0,0,16,0,-16
17615,1,1,1381,1209,-172
17616,1,1,364,1350,986
17617,1,0,0,0,0
17618,1,1,10,1424,1414
17619,1,1,286,1395,1109
17620,1,1,756,2330,1574
17621,1,1,1140,1626,486
17622,1,0,45,0,-45
17623,1,1,87,1437,1350
17624,0,0,47,0,-47
17625,0,0,1,0,-1
17626,0,0,176,0,-176
17627,1,1,1138,1223,85
17628,1,0,12,0,-12
17629,1,0,25,0,-25
17630,1,1,555,1308,753
17631,1,0,1,0,-1
17632,1,1,337,1271,934
17633,1,0,2,0,-2
17634,1,0,67,0,-67
17635,0,0,19,0,-19
17636,1,0,21,0,-21
17637,0,0,77,0,-77
17638,1,0,1,0,-1
17639,1,0,55,0,-55
17640,0,0,39,0,-39
17641,0,0,43,0,-43
17642,0,0,124,0,-124
17643,1,1,864,1274,410
17644,0,0,19,0,-19
17645,0,0,111,0,-111
17646,0,0,20,0,-20
17647,1,1,1176,1297,121
17648,1,1,561,1438,877
17649,1,0,16,0,-16
17650,0,0,23,0,-23
17651,1,1,481,1906,1425
17652,0,0,105,0,-105
17653,0,0,184,0,-184
17654,1,0,114,0,-114
17655,1,0,124,0,-124
17656,0,0,39,0,-39
17657,0,0,4,0,-4
17658,1,1,147,1270,1123
17659,1,1,493,1245,752
17660,0,0,55,0,-55
17661,1,0,24,0,-24
17662,1,1,1325,1241,-84
17663,0,0,85,0,-85
17664,1,1,507,1293,786
17665,1,0,27,0,-27
17666,1,0,12,0,-12
17667,1,1,192,1294,1102
17668,0,0,68,0,-68
17669,1,0,72,0,-72
17670,1,0,159,0,-159
17671,0,0,6,0,-6
17672,0,0,50,0,-50
17673,1,1,122,1363,1241
17674,1,1,618,1360,742
17675,0,0,5,0,-5
17676,1,0,1,0,-1
17677,0,0,44,0,-44
17678,1,1,301,1485,1184
17679,0,0,27,0,-27
17680,0,0,59,0,-59
17681,1,1,69,1507,1438
17682,1,0,95,0,-95
17683,1,0,41,0,-41
17684,0,0,131,0,-131
17685,1,0,73,0,-73
17686,0,0,207,0,-207
17687,0,0,215,0,-215
17688,1,1,692,1233,541
17689,0,0,1,0,-1
17690,1,0,9,0,-9
17691,1,1,430,1628,1198
17692,0,0,212,0,-212
17693,1,0,61,0,-61
17694,1,1,501,1471,970
17695,1,1,154,1333,1179
17696,1,1,259,1343,1084
17697,1,1,227,1686,1459
17698,1,1,624,1216,592
17699,1,1,81,1754,1673
17700,0,0,6,0,-6
17701,1,0,0,0,0
17702,1,1,336,1378,1042
17703,1,0,8,0,-8
17704,0,0,89,0,-89
17705,1,0,10,0,-10
17706,1,1,286,1224,938
17707,1,0,0,0,0
17708,0,0,16,0,-16
17709,0,0,32,0,-32
17710,0,0,65,0,-65
17711,1,1,610,1223,613
17712,1,1,610,1621,1011
17713,0,0,7,0,-7
17714,0,0,100,0,-100
17715,1,1,818,1286,468
17716,0,0,53,0,-53
17717,0,0,30,0,-30
17718,0,0,52,0,-52
17719,1,0,143,0,-143
17720,0,0,37,0,-37
17721,1,1,477,1302,825
17722,1,0,12,0,-12
17723,0,0,39,0,-39
17724,0,0,41,0,-41
17725,0,0,118,0,-118
17726,0,0,1,0,-1
17727,1,0,101,0,-101
17728,1,1,783,1301,518
17729,1,0,42,0,-42
17730,0,0,26,0,-26
17731,1,1,708,1207,499
17732,1,1,40,1284,1244
17733,0,0,60,0,-60
17734,0,0,32,0,-32
17735,0,0,57,0,-57
17736,0,0,47,0,-47
17737,1,1,1190,1863,673
17738,1,1,207,1538,1331
17739,0,0,15,0,-15
17740,1,0,56,0,-56
17741,1,1,1161,1678,517
17742,1,1,302,1393,1091
17743,1,1,2617,1248,-1369
17744,0,0,11,0,-11
17745,1,0,33,0,-33
17746,0,0,9,0,-9
17747,0,0,8,0,-8
17748,0,0,54,0,-54
17749,1,1,158,1317,1159
17750,1,1,1036,2464,1428
17751,1,1,259,1817,1558
17752,0,0,24,0,-24
17753,1,0,5,0,-5
17754,1,0,152,0,-152
17755,1,0,19,0,-19
17756,0,0,44,0,-44
17757,0,0,56,0,-56
17758,1,0,5,0,-5
17759,1,0,42,0,-42
17760,0,0,58,0,-58
17761,1,1,104,1279,1175
17762,1,1,468,2212,1744
17763,1,0,53,0,-53
17764,1,0,190,0,-190
17765,0,0,20,0,-20
17766,0,0,53,0,-53
17767,0,0,75,0,-75
17768,0,0,13,0,-13
17769,0,0,4,0,-4
17770,1,1,312,1662,1350
17771,0,0,35,0,-35
17772,0,0,30,0,-30
17773,0,0,60,0,-60
17774,0,0,274,0,-274
17775,0,0,18,0,-18
17776,1,1,508,1257,749
17777,0,0,167,0,-167
17778,1,1,973,1284,311
17779,0,0,40,0,-40
17780,0,0,113,0,-113
17781,1,0,11,0,-11
17782,1,1,87,1395,1308
17783,1,0,13,0,-13
17784,0,0,1,0,-1
17785,0,0,57,0,-57
17786,0,0,32,0,-32
17787,1,0,54,0,-54
17788,0,0,65,0,-65
17789,0,0,2,0,-2
17790,0,0,24,0,-24
17791,1,1,1434,1227,-207
17792,1,1,940,1556,616
17793,1,1,898,1279,381
17794,1,0,41,0,-41
17795,1,1,112,1330,1218
17796,0,0,106,0,-106
17797,1,1,713,1292,579
17798,0,0,25,0,-25
17799,0,0,29,0,-29
17800,0,0,37,0,-37
17801,1,1,283,1351,1068
17802,1,0,38,0,-38
17803,0,0,31,0,-31
17804,0,0,105,0,-105
17805,1,0,30,0,-30
17806,1,0,46,0,-46
17807,1,0,23,0,-23
17808,1,1,273,1849,1576
17809,0,0,101,0,-101
17810,0,0,54,0,-54
17811,1,0,39,0,-39
17812,1,1,892,1224,332
17813,0,0,119,0,-119
17814,1,0,53,0,-53
17815,1,0,27,0,-27
17816,1,1,83,1457,1374
17817,0,0,0,0,0
17818,0,0,38,0,-38
17819,1,0,44,0,-44
17820,1,1,387,1474,1087
17821,1,1,169,1519,1350
17822,1,0,179,0,-179
17823,1,1,99,1691,1592
17824,1,1,670,2087,1417
17825,0,0,16,0,-16
17826,1,1,317,1345,1028
17827,1,0,108,0,-108
17828,0,0,202,0,-202
17829,1,1,275,1343,1068
17830,1,1,1424,1352,-72
17831,0,0,7,0,-7
17832,1,1,681,1349,668
17833,1,0,11,0,-11
17834,0,0,58,0,-58
17835,1,0,302,0,-302
17836,1,1,440,1301,861
17837,0,0,2,0,-2
17838,0,0,1,0,-1
17839,0,0,33,0,-33
17840,0,0,15,0,-15
17841,0,0,74,0,-74
17842,1,1,105,1345,1240
17843,1,0,3,0,-3
17844,1,0,67,0,-67
17845,1,0,51,0,-51
17846,1,1,1076,1962,886
17847,1,1,453,1599,1146
17848,1,1,378,7180,6802
17849,1,1,578,1519,941
17850,0,0,5,0,-5
17851,0,0,13,0,-13
17852,0,0,160,0,-160
17853,1,0,8,0,-8
17854,1,0,68,0,-68
17855,1,0,97,0,-97
17856,1,1,926,1337,411
17857,1,0,37,0,-37
17858,0,0,11,0,-11
17859,0,0,41,0,-41
17860,1,0,60,0,-60
17861,1,0,33,0,-33
17862,0,0,20,0,-20
17863,0,0,48,0,-48
17864,0,0,21,0,-21
17865,1,0,38,0,-38
17866,1,0,15,0,-15
17867,0,0,23,0,-23
17868,0,0,21,0,-21
17869,0,0,33,0,-33
17870,1,1,183,1561,1378
17871,1,1,2963,1201,-1762
17872,1,1,976,1336,360
17873,1,1,395,1268,873
17874,1,0,48,0,-48
17875,0,0,122,0,-122
17876,0,0,2,0,-2
17877,0,0,16,0,-16
17878,1,1,148,1566,1418
17879,0,0,50,0,-50
17880,0,0,15,0,-15
17881,1,0,74,0,-74
17882,1,0,26,0,-26
17883,1,1,1428,1221,-207
17884,1,0,42,0,-42
17885,0,0,3,0,-3
17886,1,1,470,1436,966
17887,0,0,19,0,-19
17888,1,1,193,2046,1853
17889,1,1,1004,1801,797
17890,1,1,6,1288,1282
17891,1,1,794,1359,565
17892,1,1,164,2028,1864
17893,0,0,25,0,-25
17894,0,0,100,0,-100
17895,1,0,72,0,-72
17896,1,0,7,0,-7
17897,0,0,68,0,-68
17898,1,0,9,0,-9
17899,1,0,4,0,-4
17900,1,1,112,1298,1186
17901,1,0,3,0,-3
17902,1,1,226,1261,1035
17903,1,0,16,0,-16
17904,0,0,45,0,-45
17905,1,1,867,1288,421
17906,1,0,31,0,-31
17907,1,0,58,0,-58
17908,1,0,36,0,-36
17909,0,0,79,0,-79
17910,1,0,129,0,-129
17911,1,1,205,1255,1050
17912,1,1,91,2581,2490
17913,1,1,233,1754,1521
17914,1,0,17,0,-17
17915,0,0,30,0,-30
17916,1,1,44,1313,1269
17917,1,0,81,0,-81
17918,0,0,26,0,-26
17919,0,0,24,0,-24
17920,0,0,3,0,-3
17921,1,0,3,0,-3
17922,0,0,24,0,-24
17923,1,0,20,0,-20
17924,1,1,44,1289,1245
17925,1,1,587,1254,667
17926,0,0,24,0,-24
17927,1,1,524,1915,1391
17928,0,0,98,0,-98
17929,1,1,86,1607,1521
17930,1,1,448,2584,2136
17931,0,0,7,0,-7
17932,1,1,401,1587,1186
17933,1,1,22,1484,1462
17934,0,0,55,0,-55
17935,1,0,29,0,-29
17936,1,0,19,0,-19
17937,1,1,43,1409,1366
17938,0,0,243,0,-243
17939,1,1,138,1931,1793
17940,1,1,450,1213,763
17941,0,0,10,0,-10
17942,1,0,40,0,-40
17943,1,1,155,1660,1505
17944,0,0,93,0,-93
17945,1,1,279,1336,1057
17946,1,0,14,0,-14
17947,1,0,8,0,-8
17948,0,0,15,0,-15
17949,1,1,519,1358,839
17950,0,0,142,0,-142
17951,1,0,29,0,-29
17952,1,1,1498,1393,-105
17953,0,0,41,0,-41
17954,0,0,46,0,-46
17955,1,1,562,1424,862
17956,0,0,59,0,-59
17957,1,0,6,0,-6
17958,0,0,13,0,-13
17959,1,0,95,0,-95
17960,0,0,0,0,0
17961,0,0,26,0,-26
17962,0,0,37,0,-37
17963,0,0,33,0,-33
17964,1,1,642,1493,851
17965,1,1,909,1710,801
17966,1,1,130,1652,1522
17967,1,0,52,0,-52
17968,1,1,256,1317,1061
17969,0,0,7,0,-7
17970,0,0,75,0,-75
17971,0,0,34,0,-34
17972,0,0,31,0,-31
17973,1,0,154,0,-154
17974,0,0,58,0,-58
17975,1,1,463,1512,1049
17976,1,1,1493,2227,734
17977,1,1,199,1359,1160
17978,1,1,551,1219,668
17979,1,0,10,0,-10
17980,1,0,68,0,-68
17981,1,1,674,2068,1394
17982,1,1,939,1327,388
17983,0,0,1,0,-1
17984,1,0,100,0,-100
17985,0,0,80,0,-80
17986,1,0,21,0,-21
17987,1,0,46,0,-46
17988,1,1,190,1493,1303
17989,1,1,464,1280,816
17990,1,0,4,0,-4
17991,0,0,11,0,-11
17992,1,1,127,1342,1215
17993,1,0,30,0,-30
17994,0,0,17,0,-17
17995,1,0,9,0,-9
17996,1,0,35,0,-35
17997,1,1,676,1689,1013
17998,0,0,41,0,-41
17999,0,0,111,0,-111
18000,1,0,79,0,-79
18001,1,1,845,1789,944
18002,1,1,30,1227,1197
18003,1,1,400,2078,1678
18004,0,0,42,0,-42
18005,1,0,34,0,-34
18006,1,0,108,0,-108
18007,1,1,543,1301,758
18008,1,0,9,0,-9
18009,0,0,58,0,-58
18010,1,0,11,0,-11
18011,1,1,763,1591,828
18012,0,0,10,0,-10
18013,1,0,33,0,-33
18014,0,0,111,0,-111
18015,0,0,12,0,-12
18016,1,0,40,0,-40
18017,1,1,351,1361,1010
18018,1,0,161,0,-161
18019,0,0,22,0,-22
18020,0,0,14,0,-14
18021,0,0,11,0,-11
18022,1,1,738,1819,1081
18023,1,1,165,2064,1899
18024,0,0,35,0,-35
18025,0,0,6,0,-6
18026,0,0,29,0,-29
18027,1,0,15,0,-15
18028,0,0,31,0,-31
18029,0,0,56,0,-56
18030,1,1,107,1742,1635
18031,1,0,36,0,-36
18032,1,1,412,1201,789
18033,1,1,57,1595,1538
18034,1,0,15,0,-15
18035,0,0,29,0,-29
18036,0,0,18,0,-18
18037,1,0,88,0,-88
18038,0,0,26,0,-26
18039,0,0,7,0,-7
18040,1,1,624,1417,793
18041,1,0,12,0,-12
18042,1,1,343,1779,1436
18043,0,0,22,0,-22
18044,0,0,51,0,-51
18045,0,0,16,0,-16
18046,1,1,441,1291,850
18047,1,1,388,2426,2038
18048,1,1,1124,1447,323
18049,1,0,147,0,-147
18050,1,0,56,0,-56
18051,1,1,712,1700,988
18052,1,0,4,0,-4
18053,0,0,2,0,-2
18054,1,0,102,0,-102
18055,1,1,247,1551,1304
18056,1,0,174,0,-174
18057,1,0,146,0,-146
18058,0,0,54,0,-54
18059,1,1,1205,1278,73
18060,1,0,13,0,-13
18061,0,0,41,0,-41
18062,0,0,0,0,0
18063,0,0,26,0,-26
18064,0,0,12,0,-12
18065,0,0,5,0,-5
18066,1,0,9,0,-9
18067,0,0,15,0,-15
18068,0,0,109,0,-109
18069,0,0,18,0,-18
18070,1,0,15,0,-15
18071,1,0,59,0,-59
18072,1,1,1750,1281,-469
18073,1,0,81,0,-81
18074,0,0,62,0,-62
18075,1,1,560,1570,1010
18076,0,0,3,0,-3
18077,1,0,16,0,-16
18078,1,0,71,0,-71
18079,0,0,65,0,-65
18080,0,0,35,0,-35
18081,1,1,1088,1338,250
18082,0,0,3,0,-3
18083,0,0,32,0,-32
18084,0,0,85,0,-85
18085,0,0,63,0,-63
18086,1,1,446,3331,2885
18087,0,0,70,0,-70
18088,1,0,41,0,-41
18089,1,0,14,0,-14
18090,1,1,702,1286,584
18091,1,1,425,1339,914
18092,0,0,115,0,-115
18093,1,1,222,1689,1467
18094,0,0,12,0,-12
18095,1,0,2,0,-2
18096,1,1,354,1238,884
18097,1,1,479,1328,849
18098,0,0,34,0,-34
18099,0,0,137,0,-137
18100,1,1,1092,1627,535
18101,1,1,672,1455,783
18102,1,1,187,1210,1023
18103,0,0,5,0,-5
18104,1,0,11,0,-11
18105,1,1,284,1652,1368
18106,1,0,43,0,-43
18107,0,0,144,0,-144
18108,1,0,46,0,-46
18109,1,1,59,2033,1974
18110,1,0,62,0,-62
18111,1,0,51,0,-51
18112,1,0,168,0,-168
18113,1,1,302,1732,1430
18114,1,0,33,0,-33
18115,1,0,110,0,-110
18116,1,0,8,0,-8
18117,0,0,59,0,-59
18118,1,0,5,0,-5
18119,0,0,23,0,-23
18120,1,1,380,1292,912
18121,1,0,32,0,-32
18122,1,1,517,2056,1539
18123,1,0,50,0,-50
18124,1,0,25,0,-25
18125,0,0,85,0,-85
18126,0,0,126,0,-126
18127,1,0,182,0,-182
18128,0,0,29,0,-29
18129,0,0,6,0,-6
18130,0,0,75,0,-75
18131,0,0,1,0,-1
18132,0,0,98,0,-98
18133,1,1,86,1943,1857
18134,0,0,116,0,-116
18135,0,0,42,0,-42
18136,1,0,174,0,-174
18137,1,1,694,1514,820
18138,1,0,78,0,-78
18139,1,0,74,0,-74
18140,1,1,395,1251,856
18141,1,0,117,0,-117
18142,0,0,60,0,-60
18143,1,1,584,1376,792
18144,0,0,162,0,-162
18145,1,0,12,0,-12
18146,1,1,236,1507,1271
18147,0,0,48,0,-48
18148,0,0,31,0,-31
18149,0,0,135,0,-135
18150,1,0,20,0,-20
18151,1,0,64,0,-64
18152,1,1,115,1464,1349
18153,1,1,169,1782,1613
18154,1,0,40,0,-40
18155,1,0,21,0,-21
18156,1,0,11,0,-11
18157,0,0,121,0,-121
18158,1,0,69,0,-69
18159,1,0,11,0,-11
18160,0,0,2,0,-2
18161,1,0,38,0,-38
18162,0,0,12,0,-12
18163,0,0,32,0,-32
18164,1,1,205,1299,1094
18165,1,0,45,0,-45
18166,1,0,9,0,-9
18167,1,0,1,0,-1
18168,1,1,460,1205,745
18169,1,0,6,0,-6
18170,0,0,8,0,-8
18171,0,0,74,0,-74
18172,0,0,6,0,-6
18173,1,0,21,0,-21
18174,0,0,135,0,-135
18175,0,0,73,0,-73
18176,1,0,27,0,-27
18177,1,0,45,0,-45
18178,1,0,19,0,-19
18179,1,0,28,0,-28
18180,1,1,215,1941,1726
18181,1,1,2252,1325,-927
18182,0,0,30,0,-30
18183,0,0,7,0,-7
18184,1,1,561,1386,825
18185,1,0,22,0,-22
18186,1,0,29,0,-29
18187,1,0,29,0,-29
18188,1,0,97,0,-97
18189,0,0,86,0,-86
18190,1,0,32,0,-32
18191,1,1,119,1214,1095
18192,1,0,161,0,-161
18193,1,0,2,0,-2
18194,1,0,9,0,-9
18195,1,1,929,1366,437
18196,0,0,223,0,-223
18197,1,1,1116,1859,743
18198,1,1,956,1304,348
18199,1,1,184,1604,1420
18200,1,1,250,2064,1814
18201,1,0,57,0,-57
18202,1,1,81,1942,1861
18203,1,1,688,1330,642
18204,1,1,713,1317,604
18205,1,0,45,0,-45
18206,0,0,136,0,-136
18207,1,0,119,0,-119
18208,1,0,28,0,-28
18209,0,0,2,0,-2
18210,0,0,60,0,-60
18211,0,0,67,0,-67
18212,0,0,24,0,-24
18213,1,1,339,2068,1729
18214,0,0,0,0,0
18215,1,1,1778,1289,-489
18216,1,0,95,0,-95
18217,1,1,125,1810,1685
18218,0,0,107,0,-107
18219,1,0,5,0,-5
18220,1,0,50,0,-50
18221,0,0,45,0,-45
18222,1,1,766,1347,581
18223,0,0,7,0,-7
18224,0,0,15,0,-15
18225,0,0,105,0,-105
18226,1,1,529,1331,802
18227,1,0,2,0,-2
18228,1,1,364,1512,1148
18229,0,0,21,0,-21
18230,0,0,5,0,-5
18231,1,0,109,0,-109
18232,0,0,130,0,-130
18233,0,0,22,0,-22
18234,0,0,4,0,-4
18235,0,0,82,0,-82
18236,0,0,123,0,-123
18237,0,0,26,0,-26
18238,1,1,177,2614,2437
18239,0,0,38,0,-38
18240,1,0,9,0,-9
18241,1,1,277,1241,964
18242,0,0,71,0,-71
18243,1,1,272,1867,1595
18244,1,0,20,0,-20
18245,1,1,684,1393,709
18246,1,1,162,1235,1073
18247,1,0,15,0,-15
18248,1,1,319,1915,1596
18249,1,0,36,0,-36
18250,0,0,18,0,-18
18251,0,0,73,0,-73
18252,1,0,23,0,-23
18253,0,0,38,0,-38
18254,1,1,2186,1467,-719
18255,1,0,63,0,-63
18256,1,1,35,1541,1506
18257,0,0,19,0,-19
18258,0,0,31,0,-31
18259,1,1,19,2580,2561
18260,1,0,50,0,-50
18261,1,0,12,0,-12
18262,0,0,28,0,-28
18263,0,0,5,0,-5
18264,1,0,55,0,-55
18265,0,0,124,0,-124
18266,0,0,76,0,-76
18267,0,0,29,0,-29
18268,1,0,109,0,-109
18269,0,0,52,0,-52
18270,0,0,64,0,-64
18271,1,1,1018,1371,353
18272,1,1,80,1344,1264
18273,1,0,44,0,-44
18274,0,0,27,0,-27
18275,1,1,257,1464,1207
18276,1,0,20,0,-20
18277,1,1,492,1252,760
18278,1,1,711,1427,716
18279,0,0,47,0,-47
18280,1,0,35,0,-35
18281,1,0,47,0,-47
18282,0,0,23,0,-23
18283,1,1,377,2259,1882
18284,1,0,61,0,-61
18285,1,0,32,0,-32
18286,1,1,519,1603,1084
18287,0,0,72,0,-72
18288,0,0,9,0,-9
18289,0,0,108,0,-108
18290,0,0,109,0,-109
18291,1,0,85,0,-85
18292,1,0,28,0,-28
18293,1,0,260,0,-260
18294,1,1,42,1217,1175
18295,1,0,62,0,-62
18296,1,1,120,1544,1424
18297,1,1,1599,1377,-222
18298,0,0,14,0,-14
18299,1,0,105,0,-105
18300,1,1,1141,1430,289
18301,0,0,46,0,-46
18302,1,1,1262,2171,909
18303,0,0,182,0,-182
18304,0,0,8,0,-8
18305,0,0,2,0,-2
18306,0,0,11,0,-11
18307,1,1,299,1320,1021
18308,0,0,20,0,-20
18309,1,1,634,1502,868
18310,1,1,248,1353,1105
18311,1,1,2311,1320,-991
18312,1,1,596,1352,756
18313,1,1,431,1339,908
18314,0,0,168,0,-168
18315,1,1,145,1622,1477
18316,1,1,156,1436,1280
18317,0,0,14,0,-14
18318,0,0,55,0,-55
18319,0,0,1,0,-1
18320,0,0,13,0,-13
18321,0,0,40,0,-40
18322,0,0,17,0,-17
18323,1,0,5,0,-5
18324,1,0,17,0,-17
18325,0,0,19,0,-19
18326,1,0,35,0,-35
18327,0,0,22,0,-22
18328,1,0,16,0,-16
18329,0,0,11,0,-11
18330,0,0,71,0,-71
18331,0,0,38,0,-38
18332,1,1,231,1347,1116
18333,0,0,115,0,-115
18334,0,0,18,0,-18
18335,0,0,62,0,-62
18336,1,0,2,0,-2
18337,1,1,606,1331,725
18338,1,0,1,0,-1
18339,0,0,2,0,-2
18340,1,0,13,0,-13
18341,1,1,162,1354,1192
18342,1,0,69,0,-69
18343,1,0,80,0,-80
18344,1,0,26,0,-26
18345,0,0,57,0,-57
18346,1,1,572,1210,638
18347,0,0,45,0,-45
18348,1,0,105,0,-105
18349,0,0,47,0,-47
18350,1,1,206,2012,1806
18351,1,0,68,0,-68
18352,1,1,879,1452,573
18353,0,0,89,0,-89
18354,0,0,26,0,-26
18355,1,1,145,1245,1100
18356,0,0,52,0,-52
18357,0,0,9,0,-9
18358,1,0,24,0,-24
18359,1,0,45,0,-45
18360,0,0,59,0,-59
18361,1,0,82,0,-82
18362,1,1,722,1734,1012
18363,0,0,6,0,-6
18364,0,0,148,0,-148
18365,1,0,48,0,-48
18366,1,0,41,0,-41
18367,1,1,806,1969,1163
18368,0,0,38,0,-38
18369,1,1,234,1302,1068
18370,1,0,4,0,-4
18371,1,0,53,0,-53
18372,0,0,125,0,-125
18373,1,0,137,0,-137
18374,1,1,264,1289,1025
18375,1,1,1992,1832,-160
18376,1,1,1313,1213,-100
18377,0,0,29,0,-29
18378,1,0,18,0,-18
18379,0,0,50,0,-50
18380,0,0,56,0,-56
18381,1,0,14,0,-14
18382,1,1,197,1431,1234
18383,0,0,61,0,-61
18384,0,0,46,0,-46
18385,1,0,16,0,-16
18386,1,1,816,1462,646
18387,1,0,152,0,-152
18388,0,0,175,0,-175
18389,1,1,39,1252,1213
18390,0,0,24,0,-24
18391,1,1,1491,1561,70
18392,0,0,65,0,-65
18393,0,0,186,0,-186
18394,1,0,66,0,-66
18395,1,1,74,3577,3503
18396,0,0,63,0,-63
18397,0,0,33,0,-33
18398,1,0,47,0,-47
18399,0,0,8,0,-8
18400,1,1,2564,1257,-1307
18401,1,1,74,1273,1199
18402,0,0,8,0,-8
18403,0,0,78,0,-78
18404,0,0,79,0,-79
18405,0,0,37,0,-37
18406,1,0,1,0,-1
18407,0,0,33,0,-33
18408,0,0,4,0,-4
18409,0,0,13,0,-13
18410,1,0,30,0,-30
18411,1,0,10,0,-10
18412,1,0,108,0,-108
18413,1,1,636,2018,1382
18414,0,0,189,0,-189
18415,0,0,94,0,-94
18416,0,0,47,0,-47
18417,1,1,1118,1599,481
18418,0,0,16,0,-16
18419,0,0,34,0,-34
18420,1,1,554,1327,773
18421,1,1,2470,1440,-1030
18422,0,0,17,0,-17
18423,1,0,41,0,-41
18424,0,0,5,0,-5
18425,0,0,35,0,-35
18426,1,1,363,1419,1056
18427,1,0,2,0,-2
18428,1,0,58,0,-58
18429,0,0,4,0,-4
18430,0,0,1,0,-1
18431,1,0,1,0,-1
18432,1,0,11,0,-11
18433,1,0,79,0,-79
18434,1,0,43,0,-43
18435,1,1,1805,1875,70
18436,0,0,27,0,-27
18437,0,0,65,0,-65
18438,0,0,32,0,-32
18439,0,0,60,0,-60
18440,1,0,26,0,-26
18441,1,0,13,0,-13
18442,0,0,7,0,-7
18443,0,0,32,0,-32
18444,1,0,9,0,-9
18445,0,0,87,0,-87
18446,0,0,21,0,-21
18447,1,0,31,0,-31
18448,1,0,38,0,-38
18449,1,0,23,0,-23
18450,1,0,23,0,-23
18451,1,0,38,0,-38
18452,0,0,51,0,-51
18453,1,0,12,0,-12
18454,1,1,1324,1419,95
18455,1,0,67,0,-67
18456,0,0,6,0,-6
18457,1,0,8,0,-8
18458,0,0,28,0,-28
18459,0,0,30,0,-30
18460,0,0,147,0,-147
18461,0,0,3,0,-3
18462,1,0,52,0,-52
18463,1,0,4,0,-4
18464,1,0,26,0,-26
18465,1,1,897,1779,882
18466,1,0,149,0,-149
18467,0,0,89,0,-89
18468,0,0,28,0,-28
18469,1,1,1411,1467,56
18470,0,0,68,0,-68
18471,0,0,30,0,-30
18472,1,1,239,1450,1211
18473,0,0,78,0,-78
18474,1,1,1809,2692,883
18475,0,0,89,0,-89
18476,1,1,478,2258,1780
18477,0,0,8,0,-8
18478,1,1,89,1698,1609
18479,1,0,97,0,-97
18480,0,0,15,0,-15
18481,0,0,12,0,-12
18482,0,0,52,0,-52
18483,0,0,0,0,0
18484,1,1,448,1311,863
18485,0,0,88,0,-88
18486,1,0,37,0,-37
18487,1,0,70,0,-70
18488,1,0,51,0,-51
18489,1,1,533,1588,1055
18490,0,0,29,0,-29
18491,1,1,77,3226,3149
18492,1,0,120,0,-120
18493,0,0,59,0,-59
18494,1,0,64,0,-64
18495,1,0,55,0,-55
18496,1,0,33,0,-33
18497,0,0,32,0,-32
18498,0,0,54,0,-54
18499,1,1,663,1914,1251
18500,0,0,0,0,0
18501,1,1,57,1270,1213
18502,0,0,43,0,-43
18503,1,1,464,1447,983
18504,1,1,400,1407,1007
18505,1,1,386,2106,1720
18506,1,1,155,2293,2138
18507,0,0,11,0,-11
18508,1,1,416,1411,995
18509,0,0,43,0,-43
18510,0,0,53,0,-53
18511,1,1,137,1456,1319
18512,0,0,37,0,-37
18513,0,0,46,0,-46
18514,1,1,536,1266,730
18515,1,1,239,1251,1012
18516,0,0,4,0,-4
18517,0,0,41,0,-41
18518,1,0,237,0,-237
18519,1,0,54,0,-54
18520,1,1,299,1437,1138
18521,0,0,11,0,-11
18522,1,1,1385,1318,-67
18523,1,1,191,1280,1089
18524,1,0,27,0,-27
18525,1,1,396,1249,853
18526,0,0,5,0,-5
18527,1,1,590,1842,1252
18528,0,0,245,0,-245
18529,0,0,19,0,-19
18530,1,0,100,0,-100
18531,0,0,25,0,-25
18532,1,1,1391,1298,-93
18533,1,0,79,0,-79
18534,0,0,74,0,-74
18535,0,0,48,0,-48
18536,0,0,99,0,-99
18537,0,0,18,0,-18
18538,0,0,150,0,-150
18539,1,0,2,0,-2
18540,1,1,444,1400,956
18541,0,0,11,0,-11
18542,1,1,594,1222,628
18543,1,1,920,1480,560
18544,1,1,845,1251,406
18545,1,1,159,7198,7039
18546,0,0,13,0,-13
18547,1,0,33,0,-33
18548,1,0,4,0,-4
18549,0,0,8,0,-8
18550,0,0,23,0,-23
18551,1,0,16,0,-16
18552,0,0,111,0,-111
18553,1,0,13,0,-13
18554,1,1,82,1295,1213
18555,1,0,105,0,-105
18556,1,0,104,0,-104
18557,1,0,10,0,-10
18558,0,0,59,0,-59
18559,0,0,34,0,-34
18560,1,0,9,0,-9
18561,0,0,2,0,-2
18562,0,0,19,0,-19
18563,0,0,6,0,-6
18564,0,0,21,0,-21
18565,1,1,594,1313,719
18566,1,0,27,0,-27
18567,0,0,8,0,-8
18568,1,0,86,0,-86
18569,1,0,60,0,-60
18570,1,1,518,1829,1311
18571,1,0,12,0,-12
18572,1,0,24,0,-24
18573,1,1,591,1475,884
18574,1,0,13,0,-13
18575,0,0,5,0,-5
18576,0,0,37,0,-37
18577,1,1,473,2392,1919
18578,0,0,11,0,-11
18579,1,0,140,0,-140
18580,1,1,203,2406,2203
18581,0,0,53,0,-53
18582,0,0,24,0,-24
18583,1,1,110,1274,1164
18584,1,1,1796,1328,-468
18585,1,1,78,1528,1450
18586,1,0,174,0,-174
18587,0,0,53,0,-53
18588,1,0,4,0,-4
18589,1,0,24,0,-24
18590,1,0,45,0,-45
18591,1,0,2,0,-2
18592,1,1,2730,1444,-1286
18593,0,0,6,0,-6
18594,1,0,19,0,-19
18595,1,0,100,0,-100
18596,0,0,226,0,-226
18597,0,0,16,0,-16
18598,1,1,244,1338,1094
18599,0,0,104,0,-104
18600,0,0,15,0,-15
18601,0,0,72,0,-72
18602,0,0,71,0,-71
18603,0,0,35,0,-35
18604,1,1,426,1397,971
18605,1,0,28,0,-28
18606,1,0,24,0,-24
18607,0,0,63,0,-63
18608,0,0,49,0,-49
18609,0,0,64,0,-64
18610,1,1,992,1591,599
18611,0,0,113,0,-113
18612,1,1,106,2589,2483
18613,1,0,47,0,-47
18614,1,1,28,1425,1397
18615,0,0,103,0,-103
18616,0,0,80,0,-80
18617,1,1,289,1399,1110
18618,1,1,43,1333,1290
18619,1,0,13,0,-13
18620,1,0,35,0,-35
18621,1,0,5,0,-5
18622,1,1,266,1325,1059
18623,1,0,35,0,-35
18624,1,0,81,0,-81
18625,0,0,73,0,-73
18626,1,0,3,0,-3
18627,1,0,38,0,-38
18628,0,0,207,0,-207
18629,0,0,17,0,-17
18630,0,0,21,0,-21
18631,0,0,57,0,-57
18632,1,0,27,0,-27
18633,1,0,17,0,-17
18634,1,0,1,0,-1
18635,1,1,1443,1620,177
18636,1,0,60,0,-60
18637,0,0,13,0,-13
18638,1,1,1228,1415,187
18639,1,1,1065,1454,389
18640,1,1,397,1382,985
18641,0,0,23,0,-23
18642,0,0,31,0,-31
18643,1,1,661,1811,1150
18644,1,1,221,2096,1875
18645,0,0,123,0,-123
18646,0,0,43,0,-43
18647,1,0,46,0,-46
18648,1,0,5,0,-5
18649,1,1,470,1881,1411
18650,1,1,318,1222,904
18651,1,0,49,0,-49
18652,1,0,13,0,-13
18653,0,0,223,0,-223
18654,0,0,8,0,-8
18655,1,0,65,0,-65
18656,1,0,8,0,-8
18657,0,0,14,0,-14
18658,0,0,146,0,-146
18659,1,0,27,0,-27
18660,1,0,32,0,-32
18661,1,0,40,0,-40
18662,0,0,34,0,-34
18663,0,0,40,0,-40
18664,0,0,8,0,-8
18665,0,0,26,0,-26
18666,0,0,51,0,-51
18667,1,0,3,0,-3
18668,1,1,508,1665,1157
18669,0,0,232,0,-232
18670,0,0,44,0,-44
18671,0,0,71,0,-71
18672,1,0,2,0,-2
18673,0,0,52,0,-52
18674,1,0,67,0,-67
18675,0,0,8,0,-8
18676,0,0,35,0,-35
18677,1,1,1185,1213,28
18678,1,1,373,1790,1417
18679,1,0,81,0,-81
18680,1,0,32,0,-32
18681,1,1,342,1282,940
18682,1,0,166,0,-166
18683,1,1,182,1310,1128
18684,1,1,44,1295,1251
18685,1,1,215,1658,1443
18686,1,1,542,1569,1027
18687,0,0,16,0,-16
18688,1,1,1452,1357,-95
18689,1,1,322,1214,892
18690,0,0,37,0,-37
18691,1,0,94,0,-94
18692,0,0,2,0,-2
18693,0,0,3,0,-3
18694,1,0,45,0,-45
18695,0,0,116,0,-116
18696,1,0,23,0,-23
18697,1,1,293,1349,1056
18698,1,1,250,1289,1039
18699,0,0,86,0,-86
18700,1,1,583,1965,1382
18701,0,0,34,0,-34
18702,1,1,95,1764,1669
18703,1,0,66,0,-66
18704,0,0,7,0,-7
18705,1,1,269,1239,970
18706,0,0,57,0,-57
18707,0,0,27,0,-27
18708,0,0,13,0,-13
18709,1,0,1,0,-1
18710,1,1,193,1288,1095
18711,1,0,73,0,-73
18712,1,1,984,1418,434
18713,0,0,31,0,-31
18714,0,0,149,0,-149
18715,0,0,7,0,-7
18716,1,1,784,1296,512
18717,0,0,22,0,-22
18718,1,0,33,0,-33
18719,0,0,7,0,-7
18720,1,0,78,0,-78
18721,0,0,0,0,0
18722,1,1,1206,1266,60
18723,0,0,34,0,-34
18724,1,0,99,0,-99
18725,0,0,6,0,-6
18726,1,1,400,1461,1061
18727,1,0,24,0,-24
18728,1,0,63,0,-63
18729,1,0,24,0,-24
18730,1,1,1208,1744,536
18731,1,1,541,1768,1227
18732,0,0,9,0,-9
18733,0,0,91,0,-91
18734,0,0,8,0,-8
18735,0,0,10,0,-10
18736,0,0,11,0,-11
18737,1,1,289,1331,1042
18738,1,0,0,0,0
18739,0,0,127,0,-127
18740,1,1,112,1870,1758
18741,1,1,141,2436,2295
18742,1,0,54,0,-54
18743,1,0,32,0,-32
18744,1,1,1926,4183,2257
18745,1,0,5,0,-5
18746,1,1,1554,2374,820
18747,1,0,19,0,-19
18748,0,0,60,0,-60
18749,1,0,140,0,-140
18750,1,0,0,0,0
18751,0,0,10,0,-10
18752,0,0,19,0,-19
18753,1,1,380,1204,824
18754,1,1,482,1279,797
18755,1,0,108,0,-108
18756,1,0,91,0,-91
18757,0,0,33,0,-33
18758,0,0,9,0,-9
18759,1,1,136,2407,2271
18760,1,1,19,1252,1233
18761,1,1,887,1366,479
18762,0,0,17,0,-17
18763,1,0,93,0,-93
18764,0,0,12,0,-12
18765,0,0,28,0,-28
18766,0,0,13,0,-13
18767,1,1,42,2061,2019
18768,1,0,12,0,-12
18769,1,0,22,0,-22
18770,0,0,34,0,-34
18771,0,0,152,0,-152
18772,0,0,63,0,-63
18773,1,0,209,0,-209
18774,1,1,237,1403,1166
18775,0,0,18,0,-18
18776,1,1,229,1434,1205
18777,1,1,1726,1310,-416
18778,1,1,398,1374,976
18779,0,0,12,0,-12
18780,0,0,66,0,-66
18781,1,1,198,1445,1247
18782,1,1,811,1256,445
18783,1,0,0,0,0
18784,1,0,0,0,0
18785,0,0,22,0,-22
18786,1,0,77,0,-77
18787,1,0,0,0,0
18788,1,0,47,0,-47
18789,0,0,9,0,-9
18790,1,0,30,0,-30
18791,1,0,64,0,-64
18792,0,0,79,0,-79
18793,0,0,9,0,-9
18794,1,0,45,0,-45
18795,0,0,62,0,-62
18796,1,1,86,1366,1280
18797,1,1,162,1216,1054
18798,1,0,4,0,-4
18799,1,1,952,1261,309
18800,1,0,40,0,-40
18801,0,0,7,0,-7
18802,1,0,31,0,-31
18803,1,0,7,0,-7
18804,0,0,49,0,-49
18805,1,0,26,0,-26
18806,0,0,268,0,-268
18807,0,0,41,0,-41
18808,1,0,15,0,-15
18809,1,0,75,0,-75
18810,1,0,3,0,-3
18811,0,0,49,0,-49
18812,1,0,16,0,-16
18813,1,1,422,1887,1465
18814,0,0,43,0,-43
18815,0,0,22,0,-22
18816,0,0,0,0,0
18817,1,1,375,1687,1312
18818,0,0,38,0,-38
18819,0,0,9,0,-9
18820,1,1,369,1706,1337
18821,0,0,118,0,-118
18822,0,0,35,0,-35
18823,1,0,4,0,-4
18824,1,1,217,1377,1160
18825,0,0,20,0,-20
18826,1,1,1000,1219,219
18827,0,0,45,0,-45
18828,1,0,61,0,-61
18829,0,0,22,0,-22
18830,0,0,135,0,-135
18831,1,1,346,2485,2139
18832,0,0,10,0,-10
18833,1,1,570,1361,791
18834,1,0,41,0,-41
18835,1,0,140,0,-140
18836,0,0,14,0,-14
18837,1,1,132,2831,2699
18838,0,0,53,0,-53
18839,0,0,24,0,-24
18840,0,0,3,0,-3
18841,0,0,59,0,-59
18842,0,0,53,0,-53
18843,1,0,109,0,-109
18844,0,0,50,0,-50
18845,1,0,33,0,-33
18846,0,0,91,0,-91
18847,0,0,92,0,-92
18848,0,0,91,0,-91
18849,0,0,4,0,-4
18850,1,1,300,1562,1262
18851,1,1,780,1287,507
18852,0,0,81,0,-81
18853,0,0,194,0,-194
18854,0,0,28,0,-28
18855,0,0,48,0,-48
18856,0,0,67,0,-67
18857,0,0,86,0,-86
18858,0,0,18,0,-18
18859,1,0,98,0,-98
18860,1,1,613,1281,668
18861,0,0,18,0,-18
18862,1,1,1110,2011,901
18863,0,0,18,0,-18
18864,1,1,59,1286,1227
18865,1,0,91,0,-91
18866,0,0,9,0,-9
18867,1,1,353,1326,973
18868,1,0,9,0,-9
18869,0,0,20,0,-20
18870,1,0,34,0,-34
18871,0,0,143,0,-143
18872,1,1,395,1803,1408
18873,1,0,17,0,-17
18874,1,0,24,0,-24
18875,1,0,25,0,-25
18876,0,0,5,0,-5
18877,1,1,51,1234,1183
18878,0,0,136,0,-136
18879,1,1,109,1225,1116
18880,1,1,208,1203,995
18881,1,0,36,0,-36
18882,1,0,7,0,-7
18883,1,0,30,0,-30
18884,1,0,36,0,-36
18885,1,0,72,0,-72
18886,0,0,54,0,-54
18887,1,0,11,0,-11
18888,1,1,261,1701,1440
18889,1,0,45,0,-45
18890,1,0,41,0,-41
18891,0,0,5,0,-5
18892,1,0,10,0,-10
18893,1,1,615,2231,1616
18894,1,0,8,0,-8
18895,1,1,865,1245,380
18896,1,0,71,0,-71
18897,0,0,9,0,-9
18898,0,0,33,0,-33
18899,0,0,11,0,-11
18900,1,0,4,0,-4
18901,0,0,123,0,-123
18902,1,0,10,0,-10
18903,1,1,178,1237,1059
18904,0,0,1,0,-1
18905,0,0,5,0,-5
18906,1,0,42,0,-42
18907,0,0,54,0,-54
18908,1,0,30,0,-30
18909,1,1,70,1393,1323
18910,0,0,7,0,-7
18911,0,0,50,0,-50
18912,1,0,94,0,-94
18913,1,1,438,2360,1922
18914,1,0,46,0,-46
18915,1,0,57,0,-57
18916,0,0,86,0,-86
18917,0,0,174,0,-174
18918,1,1,175,1748,1573
18919,0,0,36,0,-36
18920,0,0,22,0,-22
18921,1,1,68,1271,1203
18922,0,0,5,0,-5
18923,1,0,5,0,-5
18924,1,1,269,4911,4642
18925,0,0,11,0,-11
18926,0,0,81,0,-81
18927,1,1,161,1545,1384
18928,1,0,8,0,-8
18929,1,1,917,1439,522
18930,1,0,18,0,-18
18931,1,0,50,0,-50
18932,1,0,68,0,-68
18933,1,0,40,0,-40
18934,0,0,10,0,-10
18935,1,0,27,0,-27
18936,0,0,120,0,-120
18937,0,0,4,0,-4
18938,0,0,147,0,-147
18939,1,1,50,1410,1360
18940,0,0,86,0,-86
18941,1,1,630,1400,770
18942,1,0,55,0,-55
18943,0,0,51,0,-51
18944,0,0,13,0,-13
18945,1,0,9,0,-9
18946,0,0,20,0,-20
18947,0,0,26,0,-26
18948,1,1,498,1462,964
18949,0,0,10,0,-10
18950,1,0,9,0,-9
18951,0,0,6,0,-6
18952,1,0,52,0,-52
18953,0,0,7,0,-7
18954,1,1,516,1311,795
18955,1,1,417,1455,1038
18956,0,0,13,0,-13
18957,1,1,68,2364,2296
18958,1,0,6,0,-6
18959,0,0,23,0,-23
18960,1,1,601,1397,796
18961,1,1,221,1413,1192
18962,0,0,54,0,-54
18963,1,1,471,1228,757
18964,1,1,1177,1419,242
18965,0,0,132,0,-132
18966,1,0,73,0,-73
18967,1,0,48,0,-48
18968,1,0,5,0,-5
18969,1,1,177,1404,1227
18970,1,0,19,0,-19
18971,1,0,2,0,-2
18972,0,0,64,0,-64
18973,1,1,773,2183,1410
18974,0,0,59,0,-59
18975,1,1,1135,1698,563
18976,1,0,30,0,-30
18977,0,0,14,0,-14
18978,0,0,27,0,-27
18979,1,0,33,0,-33
18980,1,0,29,0,-29
18981,1,0,13,0,-13
18982,0,0,79,0,-79
18983,1,1,92,1235,1143
18984,1,1,1026,3581,2555
18985,0,0,51,0,-51
18986,0,0,103,0,-103
18987,1,1,117,1374,1257
18988,1,0,48,0,-48
18989,0,0,22,0,-22
18990,0,0,23,0,-23
18991,0,0,9,0,-9
18992,0,0,11,0,-11
18993,1,1,423,2456,2033
18994,0,0,104,0,-104
18995,0,0,21,0,-21
18996,1,1,678,1785,1107
18997,1,1,539,1358,819
18998,0,0,29,0,-29
18999,1,0,13,0,-13
19000,0,0,11,0,-11
19001,0,0,25,0,-25
19002,1,1,1706,2235,529
19003,1,1,1164,1328,164
19004,0,0,59,0,-59
19005,1,0,78,0,-78
19006,1,0,51,0,-51
19007,0,0,26,0,-26
19008,0,0,35,0,-35
19009,1,1,813,1907,1094
19010,0,0,61,0,-61
19011,1,0,1,0,-1
19012,1,0,22,0,-22
19013,0,0,199,0,-199
19014,1,0,40,0,-40
19015,0,0,26,0,-26
19016,0,0,39,0,-39
19017,1,1,249,1345,1096
19018,1,0,19,0,-19
19019,1,1,566,1321,755
19020,1,1,290,2461,2171
19021,0,0,0,0,0
19022,1,0,83,0,-83
19023,1,1,728,1591,863
19024,1,1,70,1524,1454
19025,1,0,11,0,-11
19026,0,0,211,0,-211
19027,0,0,9,0,-9
19028,1,0,67,0,-67
19029,1,1,17,1912,1895
19030,0,0,33,0,-33
19031,1,0,11,0,-11
19032,1,0,1,0,-1
19033,1,0,1,0,-1
19034,0,0,160,0,-160
19035,1,0,4,0,-4
19036,1,0,14,0,-14
19037,1,0,8,0,-8
19038,0,0,40,0,-40
19039,1,1,410,1258,848
19040,1,1,82,1503,1421
19041,0,0,65,0,-65
19042,0,0,8,0,-8
19043,1,0,18,0,-18
19044,1,0,9,0,-9
19045,0,0,48,0,-48
19046,1,0,41,0,-41
19047,1,0,35,0,-35
19048,0,0,40,0,-40
19049,1,1,242,1411,1169
19050,1,1,365,1223,858
19051,1,1,567,1490,923
19052,0,0,14,0,-14
19053,0,0,9,0,-9
19054,1,0,33,0,-33
19055,1,1,101,1329,1228
19056,0,0,100,0,-100
19057,0,0,101,0,-101
19058,1,1,492,1401,909
19059,1,1,708,1416,708
19060,0,0,9,0,-9
19061,0,0,92,0,-92
19062,1,1,610,1873,1263
19063,0,0,2,0,-2
19064,0,0,18,0,-18
19065,1,0,5,0,-5
19066,1,0,19,0,-19
19067,1,1,170,1265,1095
19068,0,0,19,0,-19
19069,0,0,12,0,-12
19070,0,0,18,0,-18
19071,0,0,21,0,-21
19072,1,0,67,0,-67
19073,1,1,329,1304,975
19074,1,1,739,1329,590
19075,1,1,167,1322,1155
19076,1,1,90,1284,1194
19077,1,1,1156,1247,91
19078,1,1,2367,1331,-1036
19079,1,0,73,0,-73
19080,0,0,98,0,-98
19081,1,0,149,0,-149
19082,0,0,16,0,-16
19083,0,0,92,0,-92
19084,1,1,241,1223,982
19085,1,0,48,0,-48
19086,1,1,249,2358,2109
19087,1,1,99,1413,1314
19088,1,0,20,0,-20
19089,1,1,619,1426,807
19090,1,0,120,0,-120
19091,1,1,788,1549,761
19092,1,0,44,0,-44
19093,1,1,53,1852,1799
19094,0,0,76,0,-76
19095,0,0,45,0,-45
19096,0,0,16,0,-16
19097,0,0,174,0,-174
19098,1,1,176,1442,1266
19099,1,0,132,0,-132
19100,1,0,36,0,-36
19101,1,1,1746,1369,-377
19102,0,0,11,0,-11
19103,1,1,365,1255,890
19104,0,0,69,0,-69
19105,1,0,24,0,-24
19106,0,0,40,0,-40
19107,0,0,39,0,-39
19108,0,0,92,0,-92
19109,1,1,431,1996,1565
19110,1,1,288,1830,1542
19111,1,1,1848,2911,1063
19112,1,1,866,2352,1486
19113,0,0,45,0,-45
19114,1,0,149,0,-149
19115,1,0,0,0,0
19116,0,0,6,0,-6
19117,1,1,969,1299,330
19118,0,0,247,0,-247
19119,0,0,31,0,-31
19120,1,0,106,0,-106
19121,1,0,22,0,-22
19122,1,1,669,1394,725
19123,0,0,39,0,-39
19124,0,0,58,0,-58
19125,0,0,45,0,-45
19126,1,1,104,1203,1099
19127,1,1,42,1434,1392
19128,1,0,21,0,-21
19129,1,0,12,0,-12
19130,0,0,38,0,-38
19131,0,0,33,0,-33
19132,1,0,23,0,-23
19133,0,0,13,0,-13
19134,1,0,11,0,-11
19135,0,0,15,0,-15
19136,1,0,54,0,-54
19137,1,1,1386,1256,-130
19138,0,0,6,0,-6
19139,0,0,26,0,-26
19140,1,1,137,1318,1181
19141,1,1,1290,1385,95
19142,1,1,369,1608,1239
19143,1,0,10,0,-10
19144,1,0,9,0,-9
19145,1,1,657,1220,563
19146,0,0,29,0,-29
19147,1,1,460,1922,1462
19148,0,0,151,0,-151
19149,0,0,56,0,-56
19150,1,1,619,1362,743
19151,1,0,89,0,-89
19152,1,0,111,0,-111
19153,0,0,9,0,-9
19154,0,0,14,0,-14
19155,0,0,27,0,-27
19156,1,1,1052,1340,288
19157,0,0,58,0,-58
19158,0,0,10,0,-10
19159,1,0,35,0,-35
19160,1,1,205,1342,1137
19161,1,0,147,0,-147
19162,0,0,2,0,-2
19163,0,0,47,0,-47
19164,0,0,3,0,-3
19165,1,0,45,0,-45
19166,0,0,67,0,-67
19167,1,0,6,0,-6
19168,0,0,63,0,-63
19169,0,0,45,0,-45
19170,1,0,1,0,-1
19171,1,1,442,1322,880
19172,1,0,103,0,-103
19173,0,0,0,0,0
19174,1,0,19,0,-19
19175,1,1,469,1304,835
19176,1,1,502,2567,2065
19177,0,0,40,0,-40
19178,1,1,193,1369,1176
19179,1,1,660,1586,926
19180,1,1,172,1252,1080
19181,0,0,11,0,-11
19182,0,0,38,0,-38
19183,1,0,23,0,-23
19184,1,0,16,0,-16
19185,1,0,64,0,-64
19186,0,0,53,0,-53
19187,1,0,120,0,-120
19188,1,0,23,0,-23
19189,1,0,26,0,-26
19190,0,0,153,0,-153
19191,0,0,9,0,-9
19192,0,0,64,0,-64
19193,1,1,163,1453,1290
19194,0,0,64,0,-64
19195,1,0,24,0,-24
19196,1,0,111,0,-111
19197,1,1,532,1794,1262
19198,1,1,1008,1416,408
19199,1,1,194,1549,1355
19200,0,0,80,0,-80
19201,0,0,10,0,-10
19202,1,1,417,1378,961
19203,1,1,242,1201,959
19204,1,0,14,0,-14
19205,0,0,42,0,-42
19206,1,0,3,0,-3
19207,1,0,25,0,-25
19208,1,0,128,0,-128
19209,0,0,36,0,-36
19210,0,0,151,0,-151
19211,0,0,100,0,-100
19212,0,0,4,0,-4
19213,0,0,296,0,-296
19214,1,1,778,1413,635
19215,0,0,8,0,-8
19216,0,0,256,0,-256
19217,0,0,8,0,-8
19218,0,0,13,0,-13
19219,0,0,13,0,-13
19220,1,1,487,1310,823
19221,1,0,81,0,-81
19222,0,0,1,0,-1
19223,0,0,124,0,-124
19224,1,1,331,2350,2019
19225,0,0,66,0,-66
19226,0,0,14,0,-14
19227,0,0,4,0,-4
19228,1,1,520,1458,938
19229,1,1,101,1911,1810
19230,0,0,56,0,-56
19231,1,1,1014,1265,251
19232,0,0,6,0,-6
19233,1,1,739,1207,468
19234,1,0,73,0,-73
19235,1,1,640,1468,828
19236,0,0,25,0,-25
19237,0,0,24,0,-24
19238,1,1,275,1757,1482
19239,1,0,24,0,-24
19240,1,1,343,1611,1268
19241,0,0,4,0,-4
19242,0,0,33,0,-33
19243,0,0,27,0,-27
19244,1,0,22,0,-22
19245,1,0,37,0,-37
19246,1,0,67,0,-67
19247,1,1,635,1768,1133
19248,1,0,26,0,-26
19249,1,1,665,1455,790
19250,0,0,71,0,-71
19251,1,0,1,0,-1
19252,0,0,80,0,-80
19253,1,0,103,0,-103
19254,0,0,141,0,-141
19255,1,1,634,1263,629
19256,1,1,1197,1458,261
19257,0,0,3,0,-3
19258,1,1,12,1366,1354
19259,1,1,675,1212,537
19260,1,0,2,0,-2
19261,1,1,168,1304,1136
19262,1,0,1,0,-1
19263,1,1,747,1916,1169
19264,0,0,217,0,-217
19265,0,0,48,0,-48
19266,1,0,64,0,-64
19267,1,1,313,2002,1689
19268,0,0,55,0,-55
19269,1,0,6,0,-6
19270,0,0,8,0,-8
19271,1,1,1536,1481,-55
19272,0,0,56,0,-56
19273,1,0,106,0,-106
19274,1,1,959,1265,306
19275,0,0,60,0,-60
19276,0,0,5,0,-5
19277,1,1,917,1330,413
19278,1,1,506,2505,1999
19279,0,0,14,0,-14
19280,0,0,12,0,-12
19281,1,0,1,0,-1
19282,0,0,42,0,-42
19283,0,0,19,0,-19
19284,1,1,224,1342,1118
19285,1,1,782,1340,558
19286,1,0,47,0,-47
19287,0,0,27,0,-27
19288,0,0,89,0,-89
19289,0,0,6,0,-6
19290,1,1,2395,2459,64
19291,1,1,749,2190,1441
19292,0,0,39,0,-39
19293,0,0,173,0,-173
19294,1,1,304,1295,991
19295,1,0,121,0,-121
19296,1,0,9,0,-9
19297,1,0,153,0,-153
19298,0,0,60,0,-60
19299,0,0,119,0,-119
19300,1,1,27,1551,1524
19301,1,1,427,1491,1064
19302,1,1,791,2510,1719
19303,0,0,0,0,0
19304,0,0,25,0,-25
19305,0,0,151,0,-151
19306,1,1,1161,1294,133
19307,0,0,12,0,-12
19308,1,1,260,5397,5137
19309,1,0,15,0,-15
19310,1,1,1081,1224,143
19311,0,0,4,0,-4
19312,0,0,44,0,-44
19313,1,1,558,1209,651
19314,1,0,84,0,-84
19315,1,0,70,0,-70
19316,1,0,21,0,-21
19317,0,0,116,0,-116
19318,0,0,14,0,-14
19319,1,1,171,1445,1274
19320,1,1,73,1628,1555
19321,1,0,37,0,-37
19322,0,0,2,0,-2
19323,0,0,21,0,-21
19324,0,0,109,0,-109
19325,0,0,15,0,-15
19326,1,0,102,0,-102
19327,1,0,189,0,-189
19328,0,0,38,0,-38
19329,1,0,48,0,-48
19330,0,0,68,0,-68
19331,1,0,108,0,-108
19332,0,0,29,0,-29
19333,0,0,6,0,-6
19334,1,0,39,0,-39
19335,1,0,1,0,-1
19336,0,0,203,0,-203
19337,0,0,16,0,-16
19338,0,0,0,0,0
19339,1,1,810,1713,903
19340,1,1,117,1780,1663
19341,1,0,1,0,-1
19342,1,0,204,0,-204
19343,0,0,39,0,-39
19344,1,1,170,2068,1898
19345,1,1,544,2762,2218
19346,0,0,26,0,-26
19347,0,0,110,0,-110
19348,1,0,30,0,-30
19349,0,0,52,0,-52
19350,0,0,110,0,-110
19351,1,1,838,1725,887
19352,1,0,47,0,-47
19353,1,0,11,0,-11
19354,0,0,81,0,-81
19355,1,1,675,1380,705
19356,1,0,426,0,-426
19357,1,0,19,0,-19
19358,1,1,866,1208,342
19359,0,0,42,0,-42
19360,0,0,107,0,-107
19361,1,1,523,1759,1236
19362,1,0,9,0,-9
19363,0,0,4,0,-4
19364,1,0,44,0,-44
19365,1,0,28,0,-28
19366,1,1,206,1218,1012
19367,1,0,19,0,-19
19368,1,1,137,1507,1370
19369,1,0,14,0,-14
19370,1,1,260,1310,1050
19371,1,1,67,1304,1237
19372,1,1,524,1440,916
19373,0,0,80,0,-80
19374,1,1,60,1230,1170
19375,1,0,43,0,-43
19376,1,0,8,0,-8
19377,1,1,152,2023,1871
19378,0,0,105,0,-105
19379,1,1,40,1269,1229
19380,0,0,7,0,-7
19381,1,0,44,0,-44
19382,1,1,1138,1437,299
19383,1,0,51,0,-51
19384,1,1,369,2276,1907
19385,0,0,41,0,-41
19386,0,0,75,0,-75
19387,1,0,28,0,-28
19388,1,0,22,0,-22
19389,1,0,34,0,-34
19390,0,0,65,0,-65
19391,1,1,253,1232,979
19392,0,0,120,0,-120
19393,0,0,96,0,-96
19394,1,1,1000,1551,551
19395,0,0,20,0,-20
19396,1,0,28,0,-28
19397,1,0,15,0,-15
19398,1,0,37,0,-37
19399,0,0,26,0,-26
19400,0,0,25,0,-25
19401,0,0,51,0,-51
19402,0,0,16,0,-16
19403,0,0,24,0,-24
19404,1,0,3,0,-3
19405,0,0,5,0,-5
19406,1,1,280,1437,1157
19407,1,0,13,0,-13
19408,1,0,44,0,-44
19409,1,1,809,1383,574
19410,1,1,548,1836,1288
19411,1,1,626,1929,1303
19412,0,0,62,0,-62
19413,0,0,23,0,-23
19414,0,0,54,0,-54
19415,0,0,43,0,-43
19416,1,1,168,1312,1144
19417,0,0,70,0,-70
19418,1,0,66,0,-66
19419,0,0,95,0,-95
19420,0,0,49,0,-49
19421,0,0,12,0,-12
19422,1,1,321,1356,1035
19423,1,1,793,3417,2624
19424,0,0,31,0,-31
19425,0,0,4,0,-4
19426,1,1,490,1314,824
19427,1,0,62,0,-62
19428,1,1,151,1916,1765
19429,0,0,29,0,-29
19430,1,0,181,0,-181
19431,1,0,31,0,-31
19432,1,0,65,0,-65
19433,0,0,6,0,-6
19434,1,0,4,0,-4
19435,1,1,913,1327,414
19436,1,1,34,1321,1287
19437,1,1,119,1932,1813
19438,1,0,3,0,-3
19439,0,0,15,0,-15
19440,1,0,0,0,0
19441,1,1,652,1386,734
19442,1,0,4,0,-4
19443,1,1,554,1526,972
19444,1,0,53,0,-53
19445,1,0,6,0,-6
19446,0,0,24,0,-24
19447,0,0,83,0,-83
19448,0,0,33,0,-33
19449,0,0,2,0,-2
19450,0,0,84,0,-84
19451,1,1,485,1439,954
19452,0,0,5,0,-5
19453,0,0,17,0,-17
19454,1,1,459,4685,4226
19455,1,1,622,1218,596
19456,1,0,74,0,-74
19457,1,1,741,1631,890
19458,0,0,2,0,-2
19459,0,0,59,0,-59
19460,1,0,25,0,-25
19461,1,0,10,0,-10
19462,1,1,500,1303,803
19463,1,0,8,0,-8
19464,1,1,1283,1319,36
19465,1,0,5,0,-5
19466,1,1,415,1518,1103
19467,0,0,42,0,-42
19468,1,0,40,0,-40
19469,1,1,229,1602,1373
19470,1,0,1,0,-1
19471,0,0,103,0,-103
19472,0,0,14,0,-14
19473,1,0,66,0,-66
19474,0,0,3,0,-3
19475,1,1,2101,1723,-378
19476,0,0,62,0,-62
19477,1,1,681,1268,587
19478,1,0,52,0,-52
19479,1,1,217,1755,1538
19480,1,1,724,1339,615
19481,0,0,100,0,-100
19482,1,0,137,0,-137
19483,0,0,120,0,-120
19484,1,1,79,1216,1137
19485,0,0,11,0,-11
19486,0,0,50,0,-50
19487,0,0,146,0,-146
19488,0,0,35,0,-35
19489,0,0,93,0,-93
19490,1,0,1,0,-1
19491,1,0,82,0,-82
19492,1,1,18,1265,1247
19493,1,1,165,1693,1528
19494,1,1,589,1568,979
19495,0,0,40,0,-40
19496,1,0,46,0,-46
19497,1,1,695,1442,747
19498,1,1,659,1404,745
19499,0,0,76,0,-76
19500,0,0,4,0,-4
19501,0,0,0,0,0
19502,1,1,195,1331,1136
19503,1,0,52,0,-52
19504,1,0,88,0,-88
19505,1,0,178,0,-178
19506,1,0,10,0,-10
19507,0,0,68,0,-68
19508,0,0,56,0,-56
19509,1,1,443,1282,839
19510,1,1,364,1412,1048
19511,0,0,29,0,-29
19512,1,1,510,1737,1227
19513,0,0,30,0,-30
19514,0,0,63,0,-63
19515,1,1,864,1870,1006
19516,0,0,35,0,-35
19517,1,0,85,0,-85
19518,0,0,19,0,-19
19519,1,1,515,2129,1614
19520,1,1,536,1505,969
19521,0,0,17,0,-17
19522,1,0,43,0,-43
19523,0,0,124,0,-124
19524,0,0,101,0,-101
19525,1,0,10,0,-10
19526,1,0,2,0,-2
19527,0,0,45,0,-45
19528,0,0,177,0,-177
19529,1,1,140,1264,1124
19530,1,0,32,0,-32
19531,1,1,278,1214,936
19532,1,1,259,1462,1203
19533,0,0,56,0,-56
19534,1,0,14,0,-14
19535,0,0,62,0,-62
19536,1,0,13,0,-13
19537,0,0,29,0,-29
19538,0,0,9,0,-9
19539,0,0,25,0,-25
19540,1,0,7,0,-7
19541,0,0,2,0,-2
19542,1,0,101,0,-101
19543,1,0,20,0,-20
19544,1,0,5,0,-5
19545,1,0,11,0,-11
19546,1,1,111,1495,1384
19547,0,0,26,0,-26
19548,1,1,777,1717,940
19549,1,0,20,0,-20
19550,0,0,10,0,-10
19551,0,0,97,0,-97
19552,0,0,33,0,-33
19553,1,0,101,0,-101
19554,1,0,3,0,-3
19555,1,0,230,0,-230
19556,0,0,6,0,-6
19557,0,0,81,0,-81
19558,1,0,1,0,-1
19559,1,0,47,0,-47
19560,1,1,396,1948,1552
19561,1,0,66,0,-66
19562,1,1,546,1630,1084
19563,1,1,181,1462,1281
19564,1,1,72,1335,1263
19565,1,0,72,0,-72
19566,1,0,26,0,-26
19567,0,0,13,0,-13
19568,1,0,105,0,-105
19569,1,0,32,0,-32
19570,1,1,44,1267,1223
19571,1,1,1524,1423,-101
19572,0,0,18,0,-18
19573,0,0,66,0,-66
19574,1,0,0,0,0
19575,0,0,49,0,-49
19576,1,0,31,0,-31
19577,1,1,254,1353,1099
19578,1,1,1320,1405,85
19579,1,1,438,1506,1068
19580,0,0,47,0,-47
19581,1,1,273,1278,1005
19582,1,1,561,1316,755
19583,1,1,251,2027,1776
19584,0,0,40,0,-40
19585,0,0,78,0,-78
19586,1,0,15,0,-15
19587,1,0,57,0,-57
19588,1,0,3,0,-3
19589,0,0,37,0,-37
19590,1,0,85,0,-85
19591,0,0,48,0,-48
19592,1,1,163,1418,1255
19593,0,0,52,0,-52
19594,0,0,33,0,-33
19595,0,0,22,0,-22
19596,1,0,22,0,-22
19597,0,0,67,0,-67
19598,1,1,825,1671,846
19599,0,0,36,0,-36
19600,1,1,377,1604,1227
19601,1,0,213,0,-213
19602,1,1,791,1537,746
19603,1,1,474,1741,1267
19604,1,1,636,1381,745
19605,0,0,37,0,-37
19606,1,0,176,0,-176
19607,1,0,24,0,-24
19608,1,1,896,1456,560
19609,1,0,65,0,-65
19610,0,0,109,0,-109
19611,1,1,115,1326,1211
19612,0,0,296,0,-296
19613,1,1,504,1476,972
19614,1,0,33,0,-33
19615,1,1,56,1451,1395
19616,1,0,23,0,-23
19617,1,1,35,1233,1198
19618,1,0,2,0,-2
19619,1,0,25,0,-25
19620,0,0,23,0,-23
19621,1,1,571,1221,650
19622,1,0,7,0,-7
19623,1,1,82,1239,1157
19624,1,0,33,0,-33
19625,1,0,44,0,-44
19626,1,1,87,1640,1553
19627,0,0,125,0,-125
19628,1,1,1933,1246,-687
19629,0,0,12,0,-12
19630,0,0,56,0,-56
19631,1,1,295,1670,1375
19632,0,0,8,0,-8
19633,0,0,11,0,-11
19634,0,0,21,0,-21
19635,1,0,3,0,-3
19636,1,1,508,1512,1004
19637,1,1,495,2329,1834
19638,0,0,46,0,-46
19639,0,0,8,0,-8
19640,0,0,279,0,-279
19641,1,1,1202,1333,131
19642,1,0,51,0,-51
19643,1,1,983,2114,1131
19644,1,0,16,0,-16
19645,1,1,1089,1388,299
19646,1,1,74,2067,1993
19647,0,0,2,0,-2
19648,0,0,38,0,-38
19649,0,0,4,0,-4
19650,1,0,0,0,0
19651,1,0,14,0,-14
19652,0,0,24,0,-24
19653,1,0,17,0,-17
19654,1,1,2333,1460,-873
19655,1,0,190,0,-190
19656,1,1,240,1220,980
19657,1,0,5,0,-5
19658,1,0,15,0,-15
19659,1,1,787,1818,1031
19660,0,0,85,0,-85
19661,1,0,16,0,-16
19662,1,1,325,1296,971
19663,0,0,3,0,-3
19664,1,0,48,0,-48
19665,1,1,130,1288,1158
19666,1,0,226,0,-226
19667,1,1,687,1251,564
19668,1,0,177,0,-177
19669,1,0,25,0,-25
19670,0,0,77,0,-77
19671,1,0,68,0,-68
19672,1,1,120,1426,1306
19673,1,1,362,1207,845
19674,1,0,79,0,-79
19675,1,1,792,1210,418
19676,0,0,86,0,-86
19677,1,0,127,0,-127
19678,0,0,29,0,-29
19679,1,0,0,0,0
19680,1,1,1147,1552,405
19681,1,0,1,0,-1
19682,0,0,37,0,-37
19683,1,1,133,1823,1690
19684,1,0,29,0,-29
19685,1,1,542,1756,1214
19686,0,0,49,0,-49
19687,0,0,79,0,-79
19688,1,1,496,1257,761
19689,1,1,347,1357,1010
19690,1,0,0,0,0
19691,1,0,10,0,-10
19692,1,0,119,0,-119
19693,0,0,50,0,-50
19694,0,0,17,0,-17
19695,1,0,187,0,-187
19696,1,0,25,0,-25
19697,1,1,500,1529,1029
19698,1,1,654,1479,825
19699,1,0,8,0,-8
19700,1,0,1,0,-1
19701,0,0,72,0,-72
19702,0,0,54,0,-54
19703,1,0,9,0,-9
19704,1,0,37,0,-37
19705,1,1,662,2397,1735
19706,1,0,39,0,-39
19707,1,0,16,0,-16
19708,0,0,30,0,-30
19709,0,0,8,0,-8
19710,1,1,698,1227,529
19711,1,0,61,0,-61
19712,1,1,396,1510,1114
19713,0,0,13,0,-13
19714,0,0,7,0,-7
19715,1,1,1211,1271,60
19716,0,0,12,0,-12
19717,1,1,159,1323,1164
19718,1,1,197,1646,1449
19719,0,0,103,0,-103
19720,0,0,5,0,-5
19721,0,0,122,0,-122
19722,1,0,22,0,-22
19723,1,0,72,0,-72
19724,1,1,116,2213,2097
19725,1,0,4,0,-4
19726,1,0,84,0,-84
19727,0,0,9,0,-9
19728,0,0,8,0,-8
19729,0,0,6,0,-6
19730,0,0,43,0,-43
19731,0,0,47,0,-47
19732,1,0,99,0,-99
19733,1,1,814,1237,423
19734,0,0,78,0,-78
19735,1,1,1171,1352,181
19736,0,0,42,0,-42
19737,0,0,29,0,-29
19738,1,1,572,1279,707
19739,1,0,172,0,-172
19740,0,0,8,0,-8
19741,1,1,24,1564,1540
19742,1,0,47,0,-47
19743,0,0,36,0,-36
19744,1,1,94,1217,1123
19745,1,0,16,0,-16
19746,0,0,1,0,-1
19747,1,1,835,1605,770
19748,0,0,111,0,-111
19749,1,0,52,0,-52
19750,0,0,52,0,-52
19751,0,0,5,0,-5
19752,1,0,28,0,-28
19753,1,1,253,2227,1974
19754,1,0,63,0,-63
19755,1,1,1143,1652,509
19756,1,0,69,0,-69
19757,1,1,231,1203,972
19758,1,1,194,2911,2717
19759,1,0,22,0,-22
19760,1,0,47,0,-47
19761,0,0,9,0,-9
19762,0,0,4,0,-4
19763,1,1,413,1235,822
19764,1,0,24,0,-24
19765,1,1,90,1331,1241
19766,1,0,17,0,-17
19767,1,0,167,0,-167
19768,0,0,62,0,-62
19769,0,0,188,0,-188
19770,1,0,3,0,-3
19771,1,1,211,2524,2313
19772,1,0,55,0,-55
19773,0,0,51,0,-51
19774,0,0,42,0,-42
19775,0,0,155,0,-155
19776,1,0,40,0,-40
19777,0,0,21,0,-21
19778,1,1,770,1202,432
19779,0,0,100,0,-100
19780,0,0,4,0,-4
19781,0,0,70,0,-70
19782,0,0,11,0,-11
19783,1,1,998,1399,401
19784,1,1,1486,1306,-180
19785,1,0,29,0,-29
19786,1,0,5,0,-5
19787,0,0,71,0,-71
19788,1,1,339,1780,1441
19789,1,0,53,0,-53
19790,0,0,8,0,-8
19791,1,1,927,1232,305
19792,0,0,4,0,-4
19793,1,0,27,0,-27
19794,0,0,1,0,-1
19795,1,0,5,0,-5
19796,1,1,96,1352,1256
19797,0,0,0,0,0
19798,1,0,4,0,-4
19799,1,0,12,0,-12
19800,0,0,53,0,-53
19801,0,0,94,0,-94
19802,1,1,399,1352,953
19803,1,0,6,0,-6
19804,1,0,7,0,-7
19805,1,0,57,0,-57
19806,1,0,121,0,-121
19807,1,0,4,0,-4
19808,0,0,11,0,-11
19809,0,0,34,0,-34
19810,1,0,11,0,-11
19811,0,0,27,0,-27
19812,1,1,287,1223,936
19813,0,0,80,0,-80
19814,1,1,1513,1810,297
19815,1,1,1415,2839,1424
19816,1,1,577,1339,762
19817,1,1,687,1689,1002
19818,1,1,35,1821,1786
19819,1,0,28,0,-28
19820,0,0,31,0,-31
19821,1,0,9,0,-9
19822,1,0,105,0,-105
19823,0,0,42,0,-42
19824,0,0,57,0,-57
19825,0,0,68,0,-68
19826,0,0,118,0,-118
19827,1,1,128,1604,1476
19828,1,1,743,4462,3719
19829,1,0,9,0,-9
19830,1,0,42,0,-42
19831,0,0,17,0,-17
19832,0,0,31,0,-31
19833,1,1,373,1338,965
19834,0,0,77,0,-77
19835,1,0,26,0,-26
19836,0,0,52,0,-52
19837,1,0,5,0,-5
19838,1,1,2546,2188,-358
19839,1,1,225,2038,1813
19840,1,0,55,0,-55
19841,1,1,55,1633,1578
19842,1,0,134,0,-134
19843,0,0,135,0,-135
19844,0,0,113,0,-113
19845,1,0,47,0,-47
19846,0,0,16,0,-16
19847,0,0,14,0,-14
19848,1,0,80,0,-80
19849,0,0,20,0,-20
19850,1,0,15,0,-15
19851,1,1,102,1392,1290
19852,0,0,36,0,-36
19853,0,0,26,0,-26
19854,1,1,940,4102,3162
19855,0,0,158,0,-158
19856,1,1,249,1441,1192
19857,0,0,151,0,-151
19858,0,0,1,0,-1
19859,1,1,91,1434,1343
19860,0,0,10,0,-10
19861,0,0,66,0,-66
19862,1,0,4,0,-4
19863,1,1,2995,1492,-1503
19864,1,1,352,1313,961
19865,0,0,37,0,-37
19866,1,1,750,1375,625
19867,0,0,7,0,-7
19868,1,0,5,0,-5
19869,1,0,4,0,-4
19870,1,0,40,0,-40
19871,1,1,390,1304,914
19872,1,1,420,1217,797
19873,0,0,101,0,-101
19874,1,1,342,1756,1414
19875,0,0,39,0,-39
19876,0,0,11,0,-11
19877,0,0,7,0,-7
19878,1,0,168,0,-168
19879,1,0,86,0,-86
19880,1,0,120,0,-120
19881,1,0,16,0,-16
19882,1,1,952,2466,1514
19883,0,0,36,0,-36
19884,1,1,277,1227,950
19885,1,1,452,1318,866
19886,1,0,2,0,-2
19887,1,1,164,1439,1275
19888,1,1,36,2464,2428
19889,1,1,270,1515,1245
19890,1,1,175,1482,1307
19891,0,0,44,0,-44
19892,1,0,2,0,-2
19893,1,1,182,1430,1248
19894,1,0,6,0,-6
19895,1,0,11,0,-11
19896,1,1,595,1312,717
19897,0,0,54,0,-54
19898,1,1,37,1916,1879
19899,1,1,41,1266,1225
19900,0,0,60,0,-60
19901,1,1,505,1496,991
19902,1,1,88,2573,2485
19903,1,0,20,0,-20
19904,1,1,284,1531,1247
19905,0,0,82,0,-82
19906,1,0,67,0,-67
19907,1,1,290,1287,997
19908,1,1,314,1715,1401
19909,1,1,396,1955,1559
19910,0,0,3,0,-3
19911,0,0,2,0,-2
19912,0,0,6,0,-6
19913,0,0,73,0,-73
19914,0,0,7,0,-7
19915,1,1,776,1210,434
19916,0,0,13,0,-13
19917,1,1,184,1804,1620
19918,1,0,63,0,-63
19919,1,1,126,1540,1414
19920,0,0,40,0,-40
19921,1,0,30,0,-30
19922,1,0,63,0,-63
19923,1,0,17,0,-17
19924,1,1,22,1258,1236
19925,0,0,3,0,-3
19926,1,0,20,0,-20
19927,0,0,91,0,-91
19928,1,1,553,1256,703
19929,1,1,284,1783,1499
19930,1,0,50,0,-50
19931,1,1,668,1237,569
19932,1,1,1584,3347,1763
19933,0,0,21,0,-21
19934,0,0,24,0,-24
19935,0,0,29,0,-29
19936,1,0,41,0,-41
19937,1,0,5,0,-5
19938,0,0,86,0,-86
19939,0,0,25,0,-25
19940,0,0,44,0,-44
19941,0,0,85,0,-85
19942,1,1,522,2164,1642
19943,0,0,30,0,-30
19944,0,0,176,0,-176
19945,1,0,12,0,-12
19946,1,1,176,1268,1092
19947,1,1,506,1345,839
19948,1,0,10,0,-10
19949,0,0,51,0,-51
19950,0,0,8,0,-8
19951,1,1,200,3035,2835
19952,1,1,558,1336,778
19953,1,1,281,1306,1025
19954,1,0,4,0,-4
19955,1,0,81,0,-81
19956,0,0,53,0,-53
19957,1,0,9,0,-9
19958,1,1,212,1286,1074
19959,1,0,51,0,-51
19960,0,0,102,0,-102
19961,1,1,1466,1298,-168
19962,0,0,7,0,-7
19963,1,0,4,0,-4
19964,1,0,72,0,-72
19965,0,0,18,0,-18
19966,0,0,30,0,-30
19967,0,0,27,0,-27
19968,1,1,137,1985,1848
19969,1,1,1040,1581,541
19970,1,0,4,0,-4
19971,0,0,27,0,-27
19972,1,1,1122,1257,135
19973,1,0,34,0,-34
19974,1,1,329,1479,1150
19975,0,0,70,0,-70
19976,1,1,305,1599,1294
19977,0,0,32,0,-32
19978,0,0,110,0,-110
19979,1,1,843,1294,451
19980,1,1,327,1879,1552
19981,1,0,72,0,-72
19982,0,0,2,0,-2
19983,1,0,46,0,-46
19984,0,0,14,0,-14
19985,1,1,81,1422,1341
19986,0,0,1,0,-1
19987,1,1,909,1626,717
19988,0,0,44,0,-44
19989,1,0,41,0,-41
19990,1,1,625,1834,1209
19991,0,0,98,0,-98
19992,1,1,1287,1313,26
19993,0,0,8,0,-8
19994,1,0,2,0,-2
19995,1,0,21,0,-21
19996,0,0,76,0,-76
19997,1,0,34,0,-34
19998,1,0,3,0,-3
19999,1,0,23,0,-23
20000,1,0,60,0,-60
20001,0,0,0,0,0
20002,0,0,59,0,-59
20003,1,1,367,2032,1665
20004,1,0,10,0,-10
20005,0,0,13,0,-13
20006,1,0,6,0,-6
20007,0,0,27,0,-27
20008,0,0,110,0,-110
20009,1,0,31,0,-31
20010,0,0,41,0,-41
20011,1,0,110,0,-110
20012,1,1,147,1518,1371
20013,1,1,130,2122,1992
20014,0,0,49,0,-49
20015,1,1,678,1314,636
20016,1,1,186,1697,1511
20017,0,0,26,0,-26
20018,0,0,249,0,-249
20019,1,0,50,0,-50
20020,0,0,125,0,-125
20021,1,1,94,2118,2024
20022,0,0,29,0,-29
20023,1,1,434,2395,1961
20024,1,1,446,1281,835
20025,0,0,33,0,-33
20026,1,1,232,1396,1164
20027,1,1,803,2292,1489
20028,0,0,90,0,-90
20029,0,0,61,0,-61
20030,0,0,52,0,-52
20031,1,0,0,0,0
20032,0,0,33,0,-33
20033,1,1,447,1846,1399
20034,1,1,2496,1549,-947
20035,0,0,149,0,-149
20036,0,0,95,0,-95
20037,1,1,1599,1646,47
20038,1,1,364,1440,1076
20039,1,0,16,0,-16
20040,0,0,45,0,-45
20041,1,1,1166,2279,1113
20042,0,0,23,0,-23
20043,0,0,3,0,-3
20044,1,1,2046,1234,-812
20045,1,0,11,0,-11
20046,1,1,448,1529,1081
20047,0,0,15,0,-15
20048,0,0,37,0,-37
20049,1,1,166,1364,1198
20050,0,0,63,0,-63
20051,0,0,0,0,0
20052,1,1,1556,3834,2278
20053,0,0,19,0,-19
20054,1,0,10,0,-10
20055,1,1,250,1207,957
20056,1,1,488,2807,2319
20057,0,0,81,0,-81
20058,1,1,810,1744,934
20059,1,1,88,1206,1118
20060,1,1,322,1256,934
20061,0,0,32,0,-32
20062,0,0,2,0,-2
20063,1,1,654,1551,897
20064,0,0,41,0,-41
20065,1,0,37,0,-37
20066,0,0,28,0,-28
20067,1,0,221,0,-221
20068,1,1,101,1285,1184
20069,1,1,259,1630,1371
20070,1,1,527,1458,931
20071,0,0,211,0,-211
20072,0,0,193,0,-193
20073,1,0,42,0,-42
20074,0,0,36,0,-36
20075,1,0,20,0,-20
20076,0,0,11,0,-11
20077,0,0,241,0,-241
20078,0,0,116,0,-116
20079,1,1,323,1217,894
20080,0,0,15,0,-15
20081,0,0,21,0,-21
20082,0,0,8,0,-8
20083,1,0,167,0,-167
20084,1,0,9,0,-9
20085,1,0,37,0,-37
20086,1,1,1303,1297,-6
20087,1,1,1675,1366,-309
20088,1,1,1007,1419,412
20089,1,1,1072,1686,614
20090,1,1,654,1486,832
20091,1,0,2,0,-2
20092,0,0,51,0,-51
20093,1,0,36,0,-36
20094,1,0,37,0,-37
20095,0,0,6,0,-6
20096,0,0,9,0,-9
20097,1,0,21,0,-21
20098,0,0,120,0,-120
20099,1,1,725,1585,860
20100,0,0,51,0,-51
20101,1,1,2216,1372,-844
20102,1,1,1025,1415,390
20103,0,0,40,0,-40
20104,0,0,68,0,-68
20105,0,0,77,0,-77
20106,1,0,13,0,-13
20107,0,0,1,0,-1
20108,1,1,685,1200,515
20109,0,0,114,0,-114
20110,0,0,73,0,-73
20111,1,1,178,1281,1103
20112,0,0,5,0,-5
20113,0,0,15,0,-15
20114,1,0,43,0,-43
20115,0,0,25,0,-25
20116,0,0,30,0,-30
20117,1,1,481,1246,765
20118,1,1,370,1202,832
20119,1,1,950,1733,783
20120,1,0,46,0,-46
20121,1,0,0,0,0
20122,1,0,56,0,-56
20123,1,1,245,1290,1045
20124,1,0,21,0,-21
20125,1,1,775,1256,481
20126,0,0,7,0,-7
20127,0,0,10,0,-10
20128,1,0,78,0,-78
20129,1,0,20,0,-20
20130,1,1,199,1280,1081
20131,1,1,354,1380,1026
20132,1,0,8,0,-8
20133,1,1,145,1287,1142
20134,1,1,2362,1806,-556
20135,0,0,7,0,-7
20136,1,1,52,1548,1496
20137,1,0,120,0,-120
20138,0,0,15,0,-15
20139,1,0,8,0,-8
20140,0,0,59,0,-59
20141,1,1,177,1692,1515
20142,1,1,235,2094,1859
20143,1,0,9,0,-9
20144,1,1,53,1339,1286
20145,1,0,12,0,-12
20146,1,0,49,0,-49
20147,0,0,22,0,-22
20148,0,0,131,0,-131
20149,1,0,30,0,-30
20150,0,0,131,0,-131
20151,0,0,55,0,-55
20152,0,0,18,0,-18
20153,0,0,10,0,-10
20154,0,0,19,0,-19
20155,0,0,22,0,-22
20156,1,0,82,0,-82
20157,1,1,1129,1432,303
20158,1,0,44,0,-44
20159,1,0,133,0,-133
20160,0,0,57,0,-57
20161,1,1,459,1407,948
20162,1,1,1648,1264,-384
20163,0,0,4,0,-4
20164,0,0,20,0,-20
20165,0,0,24,0,-24
20166,1,0,38,0,-38
20167,1,1,2073,1300,-773
20168,1,1,11,1251,1240
20169,1,0,240,0,-240
20170,1,1,216,1802,1586
20171,1,0,30,0,-30
20172,1,0,53,0,-53
20173,0,0,23,0,-23
20174,0,0,93,0,-93
20175,0,0,58,0,-58
20176,0,0,7,0,-7
20177,1,0,13,0,-13
20178,1,0,20,0,-20
20179,1,1,148,1289,1141
20180,1,0,158,0,-158
20181,1,0,1,0,-1
20182,1,1,179,1271,1092
20183,1,1,72,1447,1375
20184,1,1,156,1333,1177
20185,0,0,37,0,-37
20186,1,0,180,0,-180
20187,0,0,61,0,-61
20188,1,0,4,0,-4
20189,0,0,19,0,-19
20190,0,0,24,0,-24
20191,1,0,186,0,-186
20192,1,1,132,1219,1087
20193,0,0,115,0,-115
20194,1,1,68,1522,1454
20195,1,1,266,1658,1392
20196,1,0,23,0,-23
20197,1,1,650,1612,962
20198,1,1,337,1369,1032
20199,1,0,9,0,-9
20200,1,1,63,1482,1419
20201,0,0,26,0,-26
20202,1,1,312,1459,1147
20203,1,1,266,1329,1063
20204,1,1,918,1215,297
20205,1,1,524,2592,2068
20206,1,0,38,0,-38
20207,0,0,56,0,-56
20208,0,0,5,0,-5
20209,0,0,14,0,-14
20210,1,0,2,0,-2
20211,0,0,187,0,-187
20212,0,0,142,0,-142
20213,1,1,980,1294,314
20214,1,1,1100,2209,1109
20215,1,0,19,0,-19
20216,0,0,46,0,-46
20217,0,0,25,0,-25
20218,1,0,12,0,-12
20219,0,0,30,0,-30
20220,0,0,51,0,-51
20221,1,0,17,0,-17
20222,0,0,29,0,-29
20223,1,1,384,1389,1005
20224,1,0,23,0,-23
20225,1,1,52,1743,1691
20226,1,1,50,1429,1379
20227,1,1,172,1794,1622
20228,1,1,242,1206,964
20229,1,1,84,1505,1421
20230,1,1,1354,1294,-60
20231,0,0,127,0,-127
20232,0,0,9,0,-9
20233,1,0,70,0,-70
20234,0,0,84,0,-84
20235,0,0,33,0,-33
20236,0,0,50,0,-50
20237,0,0,10,0,-10
20238,0,0,19,0,-19
20239,0,0,42,0,-42
20240,1,1,959,4862,3903
20241,1,0,14,0,-14
20242,0,0,22,0,-22
20243,1,0,4,0,-4
20244,1,1,226,1365,1139
20245,0,0,6,0,-6
20246,0,0,80,0,-80
20247,0,0,21,0,-21
20248,1,0,8,0,-8
20249,1,0,30,0,-30
20250,0,0,78,0,-78
20251,0,0,16,0,-16
20252,0,0,1,0,-1
20253,0,0,75,0,-75
20254,1,1,496,1212,716
20255,1,0,60,0,-60
20256,1,1,1064,2717,1653
20257,0,0,41,0,-41
20258,1,0,148,0,-148
20259,1,1,1481,1505,24
20260,0,0,10,0,-10
20261,0,0,63,0,-63
20262,1,1,263,1870,1607
20263,0,0,72,0,-72
20264,1,1,365,1493,1128
20265,1,0,17,0,-17
20266,1,0,13,0,-13
20267,1,1,542,1400,858
20268,1,0,70,0,-70
20269,0,0,101,0,-101
20270,1,1,385,1467,1082
20271,0,0,151,0,-151
20272,1,1,63,1329,1266
20273,0,0,27,0,-27
20274,1,0,2,0,-2
20275,0,0,16,0,-16
20276,0,0,14,0,-14
20277,0,0,34,0,-34
20278,1,1,134,1510,1376
20279,0,0,115,0,-115
20280,1,0,44,0,-44
20281,0,0,91,0,-91
20282,0,0,65,0,-65
20283,1,0,114,0,-114
20284,0,0,5,0,-5
20285,0,0,15,0,-15
20286,1,1,783,1347,564
20287,1,1,786,1304,518
20288,1,1,622,1337,715
20289,0,0,61,0,-61
20290,1,0,8,0,-8
20291,1,1,393,1426,1033
20292,1,0,65,0,-65
20293,1,1,1632,1234,-398
20294,1,1,314,1216,902
20295,1,1,226,2319,2093
20296,1,0,28,0,-28
20297,0,0,37,0,-37
20298,1,0,19,0,-19
20299,1,0,5,0,-5
20300,0,0,79,0,-79
20301,0,0,26,0,-26
20302,1,1,597,2338,1741
20303,1,0,37,0,-37
20304,1,1,112,1252,1140
20305,1,1,905,1744,839
20306,0,0,12,0,-12
20307,1,0,176,0,-176
20308,0,0,138,0,-138
20309,0,0,7,0,-7
20310,0,0,22,0,-22
20311,1,1,257,1642,1385
20312,1,1,368,1270,902
20313,1,1,153,1787,1634
20314,1,1,1854,1848,-6
20315,0,0,15,0,-15
20316,0,0,31,0,-31
20317,1,1,329,2602,2273
20318,1,0,45,0,-45
20319,0,0,50,0,-50
20320,1,0,13,0,-13
20321,1,1,394,1387,993
20322,0,0,10,0,-10
20323,1,0,277,0,-277
20324,1,0,41,0,-41
20325,1,0,10,0,-10
20326,1,1,73,1335,1262
20327,1,0,2,0,-2
20328,0,0,1,0,-1
20329,0,0,2,0,-2
20330,1,0,40,0,-40
20331,1,0,134,0,-134
20332,1,0,30,0,-30
20333,1,1,110,1249,1139
20334,1,0,0,0,0
20335,1,0,7,0,-7
20336,0,0,8,0,-8
20337,0,0,61,0,-61
20338,0,0,35,0,-35
20339,0,0,23,0,-23
20340,1,1,161,1230,1069
20341,1,0,5,0,-5
20342,1,0,76,0,-76
20343,1,1,271,2708,2437
20344,1,0,70,0,-70
20345,1,1,144,1388,1244
20346,0,0,16,0,-16
20347,0,0,8,0,-8
20348,0,0,41,0,-41
20349,0,0,4,0,-4
20350,1,1,249,1340,1091
20351,1,1,688,1457,769
20352,1,0,1,0,-1
20353,1,0,3,0,-3
20354,1,0,0,0,0
20355,1,0,157,0,-157
20356,0,0,71,0,-71
20357,0,0,78,0,-78
20358,0,0,2,0,-2
20359,1,0,6,0,-6
20360,0,0,167,0,-167
20361,1,1,49,2116,2067
20362,1,0,0,0,0
20363,1,1,209,1358,1149
20364,1,1,349,8394,8045
20365,0,0,4,0,-4
20366,1,0,109,0,-109
20367,0,0,42,0,-42
20368,1,1,1237,1373,136
20369,0,0,104,0,-104
20370,0,0,36,0,-36
20371,0,0,10,0,-10
20372,0,0,21,0,-21
20373,1,1,447,1948,1501
20374,1,1,883,1461,578
20375,1,1,411,1923,1512
20376,1,1,217,1722,1505
20377,0,0,17,0,-17
20378,1,1,1019,1819,800
20379,1,0,146,0,-146
20380,1,1,745,1619,874
20381,1,0,21,0,-21
20382,0,0,227,0,-227
20383,1,1,556,2298,1742
20384,0,0,36,0,-36
20385,0,0,28,0,-28
20386,1,0,0,0,0
20387,0,0,27,0,-27
20388,0,0,23,0,-23
20389,0,0,24,0,-24
20390,1,0,17,0,-17
20391,1,0,11,0,-11
20392,1,0,135,0,-135
20393,1,1,335,1250,915
20394,1,1,306,1431,1125
20395,1,1,139,2419,2280
20396,1,0,83,0,-83
20397,0,0,19,0,-19
20398,0,0,50,0,-50
20399,1,1,111,1526,1415
20400,1,1,169,1591,1422
20401,0,0,187,0,-187
20402,1,1,107,1469,1362
20403,1,0,20,0,-20
20404,0,0,146,0,-146
20405,1,0,8,0,-8
20406,0,0,31,0,-31
20407,0,0,59,0,-59
20408,1,0,120,0,-120
20409,1,1,1171,1424,253
20410,1,1,1194,1348,154
20411,1,1,346,1270,924
20412,1,1,526,1267,741
20413,1,0,28,0,-28
20414,1,1,363,1981,1618
20415,1,0,47,0,-47
20416,1,1,791,2362,1571
20417,1,0,5,0,-5
20418,0,0,59,0,-59
20419,0,0,66,0,-66
20420,1,0,78,0,-78
20421,0,0,67,0,-67
20422,0,0,26,0,-26
20423,1,1,496,1208,712
20424,1,0,98,0,-98
20425,0,0,49,0,-49
20426,1,0,28,0,-28
20427,0,0,70,0,-70
20428,1,1,566,1403,837
20429,0,0,33,0,-33
20430,0,0,78,0,-78
20431,1,1,485,1267,782
20432,1,1,468,1316,848
20433,1,1,793,1201,408
20434,1,1,293,1337,1044
20435,1,0,101,0,-101
20436,1,1,471,1326,855
20437,0,0,4,0,-4
20438,0,0,102,0,-102
20439,0,0,33,0,-33
20440,1,1,6,1361,1355
20441,1,0,129,0,-129
20442,0,0,71,0,-71
20443,1,1,1627,1348,-279
20444,1,1,249,3233,2984
20445,0,0,31,0,-31
20446,1,1,51,1832,1781
20447,0,0,53,0,-53
20448,1,0,56,0,-56
20449,1,0,76,0,-76
20450,1,1,773,1665,892
20451,0,0,31,0,-31
20452,0,0,19,0,-19
20453,1,1,141,1366,1225
20454,0,0,54,0,-54
20455,0,0,107,0,-107
20456,1,0,3,0,-3
20457,0,0,0,0,0
20458,1,1,65,1269,1204
20459,0,0,53,0,-53
20460,1,0,25,0,-25
20461,1,1,219,1307,1088
20462,0,0,17,0,-17
20463,1,1,355,1465,1110
20464,0,0,29,0,-29
20465,1,1,289,1253,964
20466,0,0,91,0,-91
20467,1,1,391,1248,857
20468,1,0,44,0,-44
20469,1,1,96,1206,1110
20470,0,0,82,0,-82
20471,1,0,191,0,-191
20472,1,0,30,0,-30
20473,1,0,58,0,-58
20474,1,1,426,1405,979
20475,0,0,12,0,-12
20476,1,0,154,0,-154
20477,0,0,32,0,-32
20478,1,1,331,1547,1216
20479,1,0,1,0,-1
20480,0,0,23,0,-23
20481,0,0,36,0,-36
20482,1,1,663,1455,792
20483,0,0,39,0,-39
20484,1,1,312,1800,1488
20485,1,0,21,0,-21
20486,1,0,1,0,-1
20487,0,0,95,0,-95
20488,1,1,483,1346,863
20489,1,0,44,0,-44
20490,0,0,18,0,-18
20491,1,0,37,0,-37
20492,1,1,383,1239,856
20493,0,0,39,0,-39
20494,1,0,92,0,-92
20495,0,0,19,0,-19
20496,0,0,99,0,-99
20497,0,0,86,0,-86
20498,1,0,101,0,-101
20499,0,0,41,0,-41
20500,0,0,8,0,-8
20501,1,1,292,1303,1011
20502,0,0,4,0,-4
20503,1,0,24,0,-24
20504,0,0,43,0,-43
20505,0,0,53,0,-53
20506,1,0,123,0,-123
20507,0,0,19,0,-19
20508,1,0,215,0,-215
20509,1,1,214,2350,2136
20510,1,0,4,0,-4
20511,0,0,52,0,-52
20512,1,0,26,0,-26
20513,1,0,42,0,-42
20514,0,0,126,0,-126
20515,0,0,28,0,-28
20516,0,0,65,0,-65
20517,0,0,64,0,-64
20518,1,1,830,1206,376
20519,0,0,8,0,-8
20520,0,0,34,0,-34
20521,0,0,285,0,-285
20522,1,0,4,0,-4
20523,1,1,700,1217,517
20524,0,0,146,0,-146
20525,1,0,12,0,-12
20526,0,0,128,0,-128
20527,0,0,129,0,-129
20528,1,1,1077,1389,312
20529,1,0,76,0,-76
20530,0,0,23,0,-23
20531,1,1,188,2157,1969
20532,1,0,20,0,-20
20533,1,0,0,0,0
20534,1,0,24,0,-24
20535,0,0,10,0,-10
20536,1,0,21,0,-21
20537,0,0,59,0,-59
20538,0,0,1,0,-1
20539,0,0,172,0,-172
20540,1,1,763,2385,1622
20541,1,0,31,0,-31
20542,0,0,63,0,-63
20543,1,1,310,1269,959
20544,1,0,39,0,-39
20545,1,1,2967,1296,-1671
20546,0,0,40,0,-40
20547,1,0,229,0,-229
20548,1,1,1311,1579,268
20549,1,0,41,0,-41
20550,0,0,55,0,-55
20551,0,0,19,0,-19
20552,0,0,2,0,-2
20553,1,1,852,1650,798
20554,0,0,12,0,-12
20555,1,0,62,0,-62
20556,1,0,31,0,-31
20557,0,0,2,0,-2
20558,0,0,6,0,-6
20559,1,0,146,0,-146
20560,0,0,79,0,-79
20561,1,0,43,0,-43
20562,0,0,13,0,-13
20563,0,0,41,0,-41
20564,1,0,41,0,-41
20565,0,0,304,0,-304
20566,1,1,263,1394,1131
20567,1,1,567,1253,686
20568,1,1,799,1308,509
20569,0,0,96,0,-96
20570,1,0,68,0,-68
20571,1,0,6,0,-6
20572,1,0,6,0,-6
20573,1,1,782,1200,418
20574,0,0,69,0,-69
20575,1,1,649,1211,562
20576,0,0,75,0,-75
20577,0,0,7,0,-7
20578,1,0,37,0,-37
20579,0,0,0,0,0
20580,1,0,89,0,-89
20581,0,0,127,0,-127
20582,0,0,11,0,-11
20583,1,1,48,1312,1264
20584,0,0,23,0,-23
20585,0,0,35,0,-35
20586,1,1,558,1281,723
20587,1,0,37,0,-37
20588,1,1,89,1325,1236
20589,1,1,201,1262,1061
20590,0,0,39,0,-39
20591,1,1,3241,3320,79
20592,1,1,541,1266,725
20593,0,0,71,0,-71
20594,1,1,195,2190,1995
20595,0,0,49,0,-49
20596,1,1,517,1246,729
20597,1,0,137,0,-137
20598,1,0,183,0,-183
20599,0,0,10,0,-10
20600,1,1,310,2061,1751
20601,1,1,213,1515,1302
20602,1,0,2,0,-2
20603,0,0,12,0,-12
20604,0,0,12,0,-12
20605,0,0,6,0,-6
20606,1,0,1,0,-1
20607,0,0,87,0,-87
20608,1,1,72,1304,1232
20609,1,0,37,0,-37
20610,1,1,173,1318,1145
20611,1,0,68,0,-68
20612,0,0,145,0,-145
20613,1,0,69,0,-69
20614,0,0,23,0,-23
20615,1,0,1,0,-1
20616,1,1,243,1278,1035
20617,1,0,153,0,-153
20618,0,0,71,0,-71
20619,1,0,35,0,-35
20620,1,1,23,2885,2862
20621,0,0,21,0,-21
20622,1,0,84,0,-84
20623,1,0,110,0,-110
20624,1,0,25,0,-25
20625,0,0,110,0,-110
20626,1,0,112,0,-112
20627,0,0,11,0,-11
20628,0,0,63,0,-63
20629,1,1,1006,1702,696
20630,0,0,11,0,-11
20631,1,0,42,0,-42
20632,1,0,34,0,-34
20633,1,1,335,2220,1885
20634,1,0,16,0,-16
20635,1,1,861,1268,407
20636,1,0,9,0,-9
20637,0,0,105,0,-105
20638,1,1,200,1691,1491
20639,1,1,704,2033,1329
20640,1,0,4,0,-4
20641,1,1,225,2009,1784
20642,1,1,630,1452,822
20643,1,0,90,0,-90
20644,0,0,60,0,-60
20645,1,0,83,0,-83
20646,1,0,34,0,-34
20647,0,0,71,0,-71
20648,0,0,23,0,-23
20649,1,0,44,0,-44
20650,1,0,27,0,-27
20651,0,0,9,0,-9
20652,1,1,143,1224,1081
20653,1,0,34,0,-34
20654,0,0,41,0,-41
20655,1,1,427,2115,1688
20656,0,0,114,0,-114
20657,1,0,7,0,-7
20658,0,0,5,0,-5
20659,1,0,142,0,-142
20660,0,0,15,0,-15
20661,1,0,95,0,-95
20662,0,0,10,0,-10
20663,0,0,34,0,-34
20664,0,0,189,0,-189
20665,1,1,432,1302,870
20666,0,0,10,0,-10
20667,1,1,1507,1444,-63
20668,1,0,55,0,-55
20669,1,0,29,0,-29
20670,1,1,751,1597,846
20671,0,0,117,0,-117
20672,0,0,4,0,-4
20673,1,0,17,0,-17
20674,1,1,252,1291,1039
20675,1,1,994,1286,292
20676,1,0,23,0,-23
20677,0,0,11,0,-11
20678,1,1,46,1275,1229
20679,1,0,13,0,-13
20680,1,0,24,0,-24
20681,1,0,134,0,-134
20682,0,0,2,0,-2
20683,1,0,52,0,-52
20684,0,0,5,0,-5
20685,1,0,96,0,-96
20686,0,0,156,0,-156
20687,1,1,375,1233,858
20688,1,0,3,0,-3
20689,1,0,100,0,-100
20690,0,0,54,0,-54
20691,1,1,1315,1228,-87
20692,1,0,7,0,-7
20693,1,1,251,1661,1410
20694,0,0,58,0,-58
20695,1,0,55,0,-55
20696,0,0,2,0,-2
20697,1,0,18,0,-18
20698,0,0,99,0,-99
20699,1,1,247,2155,1908
20700,1,1,256,1486,1230
20701,1,1,480,1254,774
20702,1,1,165,1651,1486
20703,1,1,159,1224,1065
20704,1,1,390,1267,877
20705,0,0,278,0,-278
20706,1,1,198,2172,1974
20707,1,0,17,0,-17
20708,1,0,16,0,-16
20709,1,1,435,1577,1142
20710,0,0,5,0,-5
20711,0,0,97,0,-97
20712,0,0,26,0,-26
20713,0,0,98,0,-98
20714,1,0,64,0,-64
20715,1,0,3,0,-3
20716,0,0,23,0,-23
20717,1,1,352,1886,1534
20718,1,1,246,1255,1009
20719,0,0,26,0,-26
20720,1,1,617,1221,604
20721,1,1,980,1420,440
20722,1,0,1,0,-1
20723,1,1,409,1225,816
20724,1,0,49,0,-49
20725,1,0,3,0,-3
20726,0,0,17,0,-17
20727,1,1,142,1352,1210
20728,1,0,22,0,-22
20729,1,0,19,0,-19
20730,1,1,297,1407,1110
20731,0,0,22,0,-22
20732,0,0,34,0,-34
20733,1,0,121,0,-121
20734,0,0,172,0,-172
20735,1,1,201,1237,1036
20736,1,0,35,0,-35
20737,1,1,847,1223,376
20738,1,0,2,0,-2
20739,1,1,831,1762,931
20740,1,0,27,0,-27
20741,1,1,3268,2059,-1209
20742,0,0,7,0,-7
20743,1,0,1,0,-1
20744,1,0,3,0,-3
20745,0,0,15,0,-15
20746,1,1,96,1541,1445
20747,0,0,5,0,-5
20748,1,0,61,0,-61
20749,1,1,54,1983,1929
20750,1,0,51,0,-51
20751,1,1,1282,1223,-59
20752,0,0,43,0,-43
20753,0,0,47,0,-47
20754,0,0,10,0,-10
20755,1,0,69,0,-69
20756,0,0,6,0,-6
20757,1,1,686,1481,795
20758,1,1,599,1257,658
20759,1,1,519,2001,1482
20760,0,0,9,0,-9
20761,1,1,550,1298,748
20762,1,1,904,3372,2468
20763,0,0,0,0,0
20764,1,0,43,0,-43
20765,1,0,24,0,-24
20766,1,0,18,0,-18
20767,0,0,8,0,-8
20768,1,1,248,1396,1148
20769,1,0,1,0,-1
20770,1,1,839,1491,652
20771,1,1,101,1429,1328
20772,1,1,652,1373,721
20773,1,1,985,1226,241
20774,1,0,36,0,-36
20775,0,0,12,0,-12
20776,1,1,985,1792,807
20777,1,0,165,0,-165
20778,1,1,3143,1845,-1298
20779,1,1,269,1319,1050
20780,1,0,0,0,0
20781,1,0,11,0,-11
20782,1,1,224,1432,1208
20783,1,1,243,1824,1581
20784,1,1,313,1988,1675
20785,1,0,18,0,-18
20786,1,1,288,1376,1088
20787,0,0,21,0,-21
20788,1,0,207,0,-207
20789,0,0,66,0,-66
20790,0,0,59,0,-59
20791,0,0,16,0,-16
20792,1,0,9,0,-9
20793,1,1,239,1333,1094
20794,1,1,110,2513,2403
20795,1,1,237,1453,1216
20796,0,0,29,0,-29
20797,1,1,53,1514,1461
20798,1,1,144,1292,1148
20799,1,1,683,1463,780
20800,1,1,599,1811,1212
20801,0,0,7,0,-7
20802,0,0,15,0,-15
20803,1,0,14,0,-14
20804,0,0,139,0,-139
20805,1,0,36,0,-36
20806,1,0,164,0,-164
20807,0,0,69,0,-69
20808,1,0,5,0,-5
20809,1,1,1500,1352,-148
20810,1,1,56,1363,1307
20811,0,0,16,0,-16
20812,0,0,0,0,0
20813,1,1,173,1420,1247
20814,1,1,97,1239,1142
20815,1,0,8,0,-8
20816,1,1,802,1206,404
20817,1,0,6,0,-6
20818,1,0,36,0,-36
20819,1,0,90,0,-90
20820,1,1,1137,1221,84
20821,1,1,116,1430,1314
20822,0,0,34,0,-34
20823,0,0,59,0,-59
20824,1,0,124,0,-124
20825,1,0,74,0,-74
20826,1,1,115,1227,1112
20827,1,1,471,1622,1151
20828,0,0,21,0,-21
20829,0,0,17,0,-17
20830,0,0,73,0,-73
20831,1,0,38,0,-38
20832,1,0,5,0,-5
20833,1,1,176,1247,1071
20834,1,0,38,0,-38
20835,1,0,13,0,-13
20836,1,0,0,0,0
20837,1,1,904,2555,1651
20838,1,1,512,1314,802
20839,0,0,135,0,-135
20840,1,1,1605,1266,-339
20841,1,0,84,0,-84
20842,1,0,51,0,-51
20843,1,1,535,2289,1754
20844,1,0,58,0,-58
20845,0,0,53,0,-53
20846,1,1,566,1435,869
20847,1,1,1116,1203,87
20848,1,1,856,1952,1096
20849,1,0,22,0,-22
20850,1,1,905,1253,348
20851,1,0,183,0,-183
20852,0,0,43,0,-43
20853,1,1,4667,1489,-3178
20854,0,0,2,0,-2
20855,1,0,47,0,-47
20856,0,0,37,0,-37
20857,0,0,17,0,-17
20858,0,0,47,0,-47
20859,0,0,18,0,-18
20860,0,0,17,0,-17
20861,1,0,65,0,-65
20862,1,0,2,0,-2
20863,1,1,668,1307,639
20864,1,1,821,3274,2453
20865,1,0,17,0,-17
20866,0,0,57,0,-57
20867,1,0,147,0,-147
20868,1,1,605,1297,692
20869,0,0,21,0,-21
20870,1,0,2,0,-2
20871,1,0,166,0,-166
20872,1,1,622,1785,1163
20873,1,0,15,0,-15
20874,0,0,10,0,-10
20875,0,0,90,0,-90
20876,1,1,528,1223,695
20877,0,0,7,0,-7
20878,1,1,937,1826,889
20879,1,0,145,0,-145
20880,0,0,54,0,-54
20881,1,0,88,0,-88
20882,1,1,650,1318,668
20883,0,0,1,0,-1
20884,1,0,10,0,-10
20885,0,0,9,0,-9
20886,1,0,30,0,-30
20887,1,0,129,0,-129
20888,1,1,69,1341,1272
20889,0,0,42,0,-42
20890,1,0,145,0,-145
20891,1,0,190,0,-190
20892,1,1,1225,1299,74
20893,1,1,634,1277,643
20894,1,0,106,0,-106
20895,0,0,190,0,-190
20896,0,0,25,0,-25
20897,0,0,56,0,-56
20898,0,0,38,0,-38
20899,1,1,80,1359,1279
20900,1,0,10,0,-10
20901,1,1,1053,1490,437
20902,1,0,9,0,-9
20903,1,1,269,1309,1040
20904,0,0,2,0,-2
20905,1,0,7,0,-7
20906,1,1,1135,1360,225
20907,0,0,25,0,-25
20908,1,1,298,1250,952
20909,0,0,49,0,-49
20910,1,0,2,0,-2
20911,1,1,155,1265,1110
20912,0,0,39,0,-39
20913,0,0,97,0,-97
20914,1,0,24,0,-24
20915,0,0,10,0,-10
20916,1,0,20,0,-20
20917,0,0,63,0,-63
20918,0,0,93,0,-93
20919,1,1,230,1426,1196
20920,0,0,41,0,-41
20921,1,0,72,0,-72
20922,1,0,10,0,-10
20923,1,0,60,0,-60
20924,1,0,24,0,-24
20925,0,0,112,0,-112
20926,1,1,391,1425,1034
20927,1,0,110,0,-110
20928,1,0,4,0,-4
20929,1,0,57,0,-57
20930,1,0,23,0,-23
20931,0,0,7,0,-7
20932,0,0,28,0,-28
20933,1,0,22,0,-22
20934,0,0,1,0,-1
20935,1,1,324,1966,1642
20936,0,0,29,0,-29
20937,1,1,347,1958,1611
20938,1,0,26,0,-26
20939,1,0,22,0,-22
20940,0,0,13,0,-13
20941,1,0,61,0,-61
20942,0,0,35,0,-35
20943,1,0,59,0,-59
20944,1,1,1616,1830,214
20945,0,0,24,0,-24
20946,1,1,389,1554,1165
20947,0,0,50,0,-50
20948,1,1,684,1370,686
20949,1,0,35,0,-35
20950,1,0,58,0,-58
20951,1,1,331,1253,922
20952,0,0,73,0,-73
20953,1,1,736,1459,723
20954,1,0,26,0,-26
20955,0,0,67,0,-67
20956,1,1,724,1390,666
20957,1,1,108,1680,1572
20958,0,0,23,0,-23
20959,0,0,50,0,-50
20960,1,1,416,1408,992
20961,0,0,31,0,-31
20962,0,0,54,0,-54
20963,1,1,1646,1361,-285
20964,1,0,22,0,-22
20965,1,0,8,0,-8
20966,1,1,208,1202,994
20967,0,0,32,0,-32
20968,0,0,8,0,-8
20969,1,0,6,0,-6
20970,1,1,353,1211,858
20971,0,0,139,0,-139
20972,1,0,40,0,-40
20973,1,0,27,0,-27
20974,1,0,17,0,-17
20975,1,0,1,0,-1
20976,0,0,33,0,-33
20977,1,1,309,2608,2299
20978,1,1,427,1529,1102
20979,0,0,74,0,-74
20980,1,1,304,1396,1092
20981,0,0,44,0,-44
20982,1,1,75,2171,2096
20983,1,0,238,0,-238
20984,0,0,41,0,-41
20985,1,1,328,1934,1606
20986,0,0,46,0,-46
20987,1,0,67,0,-67
20988,1,1,247,1202,955
20989,1,0,17,0,-17
20990,1,1,474,1730,1256
20991,1,0,34,0,-34
20992,1,0,14,0,-14
20993,1,1,364,1423,1059
20994,1,1,3447,1459,-1988
20995,1,1,403,1292,889
20996,0,0,52,0,-52
20997,0,0,75,0,-75
20998,1,0,39,0,-39
20999,1,1,1006,1407,401
21000,0,0,144,0,-144
21001,1,1,908,1498,590
21002,1,1,32,1228,1196
21003,1,1,617,1509,892
21004,0,0,50,0,-50
21005,0,0,175,0,-175
21006,1,0,54,0,-54
21007,1,0,33,0,-33
21008,1,0,35,0,-35
21009,0,0,122,0,-122
21010,0,0,46,0,-46
21011,1,0,50,0,-50
21012,1,1,448,1304,856
21013,1,0,3,0,-3
21014,1,0,3,0,-3
21015,0,0,9,0,-9
21016,0,0,19,0,-19
21017,1,1,468,1308,840
21018,1,1,579,1300,721
21019,1,1,91,2567,2476
21020,1,0,86,0,-86
21021,1,0,42,0,-42
21022,0,0,334,0,-334
21023,1,1,695,2317,1622
21024,1,0,6,0,-6
21025,0,0,11,0,-11
21026,0,0,25,0,-25
21027,1,0,39,0,-39
21028,1,0,53,0,-53
21029,1,0,70,0,-70
21030,0,0,107,0,-107
21031,0,0,15,0,-15
21032,1,0,15,0,-15
21033,0,0,163,0,-163
21034,1,1,1871,1257,-614
21035,0,0,121,0,-121
21036,1,1,46,1450,1404
21037,1,1,164,1932,1768
21038,1,1,29,1302,1273
21039,0,0,69,0,-69
21040,0,0,102,0,-102
21041,0,0,24,0,-24
21042,1,0,56,0,-56
21043,1,1,587,2971,2384
21044,0,0,38,0,-38
21045,0,0,10,0,-10
21046,1,0,46,0,-46
21047,0,0,25,0,-25
21048,1,0,14,0,-14
21049,1,0,90,0,-90
21050,1,0,34,0,-34
21051,0,0,13,0,-13
21052,0,0,16,0,-16
21053,1,1,246,4413,4167
21054,0,0,0,0,0
21055,0,0,25,0,-25
21056,1,0,18,0,-18
21057,1,1,437,1716,1279
21058,1,1,1281,1205,-76
21059,1,1,249,1524,1275
21060,0,0,16,0,-16
21061,0,0,21,0,-21
21062,0,0,25,0,-25
21063,1,1,332,1223,891
21064,0,0,6,0,-6
21065,1,1,189,1309,1120
21066,0,0,86,0,-86
21067,1,1,315,1875,1560
21068,1,1,893,3296,2403
21069,0,0,122,0,-122
21070,1,0,33,0,-33
21071,0,0,224,0,-224
21072,1,0,47,0,-47
21073,0,0,6,0,-6
21074,0,0,13,0,-13
21075,1,1,582,1375,793
21076,0,0,1,0,-1
21077,1,0,175,0,-175
21078,0,0,12,0,-12
21079,1,1,1724,1213,-511
21080,0,0,6,0,-6
21081,0,0,70,0,-70
21082,1,0,13,0,-13
21083,1,1,314,2279,1965
21084,0,0,63,0,-63
21085,0,0,13,0,-13
21086,1,0,37,0,-37
21087,0,0,53,0,-53
21088,0,0,47,0,-47
21089,0,0,12,0,-12
21090,1,0,54,0,-54
21091,1,1,466,1304,838
21092,0,0,93,0,-93
21093,1,1,46,1202,1156
21094,1,1,429,1367,938
21095,1,0,215,0,-215
21096,1,1,297,1640,1343
21097,1,1,124,1264,1140
21098,1,1,665,1213,548
21099,1,0,17,0,-17
21100,0,0,7,0,-7
21101,1,0,39,0,-39
21102,0,0,25,0,-25
21103,0,0,10,0,-10
21104,0,0,197,0,-197
21105,1,0,3,0,-3
21106,1,1,590,2028,1438
21107,0,0,36,0,-36
21108,1,0,4,0,-4
21109,0,0,12,0,-12
21110,0,0,32,0,-32
21111,1,1,769,2436,1667
21112,0,0,115,0,-115
21113,1,1,239,1310,1071
21114,0,0,25,0,-25
21115,1,0,20,0,-20
21116,0,0,103,0,-103
21117,1,0,0,0,0
21118,0,0,32,0,-32
21119,0,0,53,0,-53
21120,1,1,200,1236,1036
21121,0,0,43,0,-43
21122,0,0,29,0,-29
21123,0,0,23,0,-23
21124,1,0,43,0,-43
21125,1,1,1536,1289,-247
21126,1,1,128,1212,1084
21127,1,1,669,1382,713
21128,1,1,724,1559,835
21129,1,1,147,1396,1249
21130,1,1,447,1309,862
21131,0,0,21,0,-21
21132,0,0,8,0,-8
21133,0,0,17,0,-17
21134,1,1,418,1675,1257
21135,1,0,8,0,-8
21136,1,0,15,0,-15
21137,0,0,95,0,-95
21138,1,0,46,0,-46
21139,1,1,492,1634,1142
21140,1,0,28,0,-28
21141,1,1,204,2835,2631
21142,1,1,560,1255,695
21143,1,0,17,0,-17
21144,1,0,256,0,-256
21145,1,1,544,1234,690
21146,0,0,39,0,-39
21147,0,0,22,0,-22
21148,1,0,20,0,-20
21149,1,0,22,0,-22
21150,1,1,131,1236,1105
21151,1,1,71,1290,1219
21152,0,0,38,0,-38
21153,1,0,23,0,-23
21154,1,0,23,0,-23
21155,1,1,541,1460,919
21156,0,0,36,0,-36
21157,0,0,7,0,-7
21158,0,0,14,0,-14
21159,1,0,11,0,-11
21160,1,1,1915,1455,-460
21161,1,1,66,1825,1759
21162,0,0,1,0,-1
21163,1,1,878,1221,343
21164,1,1,471,1797,1326
21165,1,1,534,1707,1173
21166,0,0,25,0,-25
21167,0,0,4,0,-4
21168,1,0,11,0,-11
21169,1,0,9,0,-9
21170,0,0,5,0,-5
21171,1,0,106,0,-106
21172,0,0,35,0,-35
21173,1,1,439,1273,834
21174,1,0,62,0,-62
21175,0,0,18,0,-18
21176,1,0,133,0,-133
21177,1,0,8,0,-8
21178,0,0,30,0,-30
21179,1,1,1621,1267,-354
21180,0,0,80,0,-80
21181,1,0,13,0,-13
21182,0,0,7,0,-7
21183,0,0,182,0,-182
21184,1,0,0,0,0
21185,1,1,1331,1378,47
21186,1,0,57,0,-57
21187,1,0,53,0,-53
21188,0,0,91,0,-91
21189,1,0,35,0,-35
21190,0,0,66,0,-66
21191,0,0,118,0,-118
21192,1,1,604,1793,1189
21193,1,0,20,0,-20
21194,0,0,31,0,-31
21195,1,1,72,1263,1191
21196,0,0,42,0,-42
21197,1,1,357,1315,958
21198,0,0,12,0,-12
21199,0,0,5,0,-5
21200,1,0,15,0,-15
21201,0,0,19,0,-19
21202,0,0,26,0,-26
21203,1,1,540,1250,710
21204,0,0,78,0,-78
21205,1,1,595,1701,1106
21206,1,0,181,0,-181
21207,1,1,639,2233,1594
21208,0,0,15,0,-15
21209,1,1,807,2253,1446
21210,1,0,1,0,-1
21211,0,0,154,0,-154
21212,1,0,18,0,-18
21213,1,0,49,0,-49
21214,1,1,953,1537,584
21215,1,0,43,0,-43
21216,1,1,179,1293,1114
21217,1,0,38,0,-38
21218,1,0,4,0,-4
21219,1,0,144,0,-144
21220,1,0,197,0,-197
21221,0,0,43,0,-43
21222,0,0,64,0,-64
21223,1,0,4,0,-4
21224,0,0,3,0,-3
21225,0,0,51,0,-51
21226,0,0,29,0,-29
21227,0,0,16,0,-16
21228,0,0,7,0,-7
21229,1,0,29,0,-29
21230,0,0,0,0,0
21231,1,1,35,1229,1194
21232,0,0,42,0,-42
21233,1,0,47,0,-47
21234,1,0,56,0,-56
21235,1,0,21,0,-21
21236,1,0,54,0,-54
21237,0,0,10,0,-10
21238,0,0,22,0,-22
21239,1,1,178,1599,1421
21240,1,1,132,1939,1807
21241,0,0,29,0,-29
21242,0,0,41,0,-41
21243,1,1,1378,1701,323
21244,1,1,1005,5941,4936
21245,1,1,836,1486,650
21246,0,0,33,0,-33
21247,0,0,97,0,-97
21248,1,0,45,0,-45
21249,0,0,115,0,-115
21250,1,0,26,0,-26
21251,0,0,13,0,-13
21252,0,0,14,0,-14
21253,0,0,10,0,-10
21254,0,0,72,0,-72
21255,1,0,17,0,-17
21256,1,0,90,0,-90
21257,1,0,63,0,-63
21258,1,0,20,0,-20
21259,0,0,13,0,-13
21260,0,0,30,0,-30
21261,1,1,500,1493,993
21262,0,0,143,0,-143
21263,1,0,18,0,-18
21264,1,0,57,0,-57
21265,0,0,273,0,-273
21266,1,1,414,1289,875
21267,0,0,16,0,-16
21268,1,0,36,0,-36
21269,1,1,567,1256,689
21270,1,0,69,0,-69
21271,0,0,44,0,-44
21272,0,0,14,0,-14
21273,0,0,41,0,-41
21274,1,1,260,1264,1004
21275,1,1,1132,1866,734
21276,1,1,77,1242,1165
21277,1,1,921,1958,1037
21278,0,0,182,0,-182
21279,1,1,508,2648,2140
21280,0,0,10,0,-10
21281,1,1,183,2127,1944
21282,0,0,79,0,-79
21283,1,0,75,0,-75
21284,0,0,51,0,-51
21285,0,0,11,0,-11
21286,1,1,107,1361,1254
21287,1,0,127,0,-127
21288,1,1,197,2286,2089
21289,1,0,89,0,-89
21290,1,0,50,0,-50
21291,0,0,21,0,-21
21292,1,0,14,0,-14
21293,1,0,76,0,-76
21294,0,0,12,0,-12
21295,0,0,129,0,-129
21296,1,1,731,1402,671
21297,0,0,20,0,-20
21298,0,0,35,0,-35
21299,1,0,49,0,-49
21300,0,0,4,0,-4
21301,0,0,80,0,-80
21302,0,0,17,0,-17
21303,0,0,176,0,-176
21304,1,1,850,1562,712
21305,0,0,44,0,-44
21306,1,0,155,0,-155
21307,1,1,131,1222,1091
21308,0,0,102,0,-102
21309,0,0,19,0,-19
21310,1,1,252,1866,1614
21311,1,1,23,3945,3922
21312,0,0,71,0,-71
21313,0,0,123,0,-123
21314,1,1,132,1629,1497
21315,0,0,33,0,-33
21316,0,0,80,0,-80
21317,1,1,85,1252,1167
21318,0,0,42,0,-42
21319,0,0,31,0,-31
21320,1,0,101,0,-101
21321,0,0,27,0,-27
21322,0,0,71,0,-71
21323,1,0,3,0,-3
21324,1,0,14,0,-14
21325,1,1,377,1273,896
21326,0,0,26,0,-26
21327,1,1,1007,1873,866
21328,1,1,984,1455,471
21329,1,0,6,0,-6
21330,1,0,5,0,-5
21331,1,1,155,1211,1056
21332,1,1,300,1762,1462
21333,1,0,8,0,-8
21334,0,0,100,0,-100
21335,1,1,810,1379,569
21336,0,0,55,0,-55
21337,1,1,69,2329,2260
21338,1,1,665,1329,664
21339,0,0,9,0,-9
21340,0,0,15,0,-15
21341,0,0,38,0,-38
21342,0,0,68,0,-68
21343,1,1,322,2317,1995
21344,0,0,2,0,-2
21345,1,0,8,0,-8
21346,0,0,25,0,-25
21347,1,0,29,0,-29
21348,1,0,99,0,-99
21349,1,1,343,1374,1031
21350,1,0,36,0,-36
21351,1,0,33,0,-33
21352,0,0,5,0,-5
21353,0,0,263,0,-263
21354,1,0,22,0,-22
21355,0,0,61,0,-61
21356,1,1,187,3254,3067
21357,1,1,179,1436,1257
21358,1,1,628,1213,585
21359,1,1,1162,1309,147
21360,0,0,59,0,-59
21361,1,0,10,0,-10
21362,0,0,73,0,-73
21363,1,1,474,1249,775
21364,0,0,201,0,-201
21365,1,1,146,1600,1454
21366,0,0,13,0,-13
21367,0,0,155,0,-155
21368,1,0,6,0,-6
21369,0,0,23,0,-23
21370,0,0,20,0,-20
21371,1,1,87,1809,1722
21372,0,0,41,0,-41
21373,1,0,67,0,-67
21374,1,1,75,1635,1560
21375,1,0,86,0,-86
21376,1,1,483,1306,823
21377,1,0,48,0,-48
21378,1,0,67,0,-67
21379,1,1,143,1628,1485
21380,0,0,90,0,-90
21381,0,0,48,0,-48
21382,0,0,4,0,-4
21383,0,0,21,0,-21
21384,0,0,11,0,-11
21385,1,1,998,1569,571
21386,1,1,158,1539,1381
21387,1,1,134,2713,2579
21388,1,0,25,0,-25
21389,1,0,6,0,-6
21390,0,0,12,0,-12
21391,1,1,265,1737,1472
21392,1,1,288,1650,1362
21393,1,0,64,0,-64
21394,0,0,6,0,-6
21395,1,0,182,0,-182
21396,1,0,131,0,-131
21397,0,0,7,0,-7
21398,0,0,54,0,-54
21399,1,1,619,1226,607
21400,0,0,125,0,-125
21401,1,1,254,1214,960
21402,1,1,480,2012,1532
21403,1,0,45,0,-45
21404,0,0,78,0,-78
21405,1,1,35,1246,1211
21406,0,0,92,0,-92
21407,1,0,43,0,-43
21408,1,1,1458,1409,-49
21409,0,0,116,0,-116
21410,1,0,4,0,-4
21411,1,0,27,0,-27
21412,0,0,50,0,-50
21413,1,1,456,1626,1170
21414,0,0,84,0,-84
21415,1,1,802,1257,455
21416,1,0,110,0,-110
21417,0,0,6,0,-6
21418,1,1,1127,1255,128
21419,1,0,19,0,-19
21420,0,0,6,0,-6
21421,0,0,32,0,-32
21422,0,0,50,0,-50
21423,1,0,36,0,-36
21424,0,0,4,0,-4
21425,1,1,291,1714,1423
21426,1,0,73,0,-73
21427,1,0,45,0,-45
21428,0,0,26,0,-26
21429,1,0,191,0,-191
21430,0,0,1,0,-1
21431,0,0,2,0,-2
21432,1,0,10,0,-10
21433,1,1,519,1550,1031
21434,0,0,38,0,-38
21435,0,0,3,0,-3
21436,1,0,25,0,-25
21437,1,0,78,0,-78
21438,1,1,127,1526,1399
21439,0,0,105,0,-105
21440,1,0,41,0,-41
21441,1,0,122,0,-122
21442,1,0,0,0,0
21443,1,1,338,1347,1009
21444,0,0,9,0,-9
21445,0,0,115,0,-115
21446,1,1,302,1508,1206
21447,1,0,160,0,-160
21448,1,0,27,0,-27
21449,0,0,18,0,-18
21450,1,0,3,0,-3
21451,0,0,58,0,-58
21452,1,0,14,0,-14
21453,1,1,239,1291,1052
21454,1,0,138,0,-138
21455,0,0,6,0,-6
21456,1,0,139,0,-139
21457,0,0,8,0,-8
21458,1,1,1836,2164,328
21459,1,1,458,1399,941
21460,0,0,87,0,-87
21461,0,0,5,0,-5
21462,0,0,53,0,-53
21463,0,0,32,0,-32
21464,0,0,17,0,-17
21465,0,0,94,0,-94
21466,0,0,54,0,-54
21467,0,0,36,0,-36
21468,1,0,117,0,-117
21469,1,1,524,1466,942
21470,1,1,36,1909,1873
21471,0,0,0,0,0
21472,0,0,14,0,-14
21473,1,0,63,0,-63
21474,1,0,54,0,-54
21475,0,0,54,0,-54
21476,1,1,845,1274,429
21477,1,0,42,0,-42
21478,1,0,10,0,-10
21479,1,1,1709,1489,-220
21480,0,0,116,0,-116
21481,1,1,209,1778,1569
21482,1,1,236,1239,1003
21483,0,0,97,0,-97
21484,1,0,10,0,-10
21485,1,1,484,1951,1467
21486,1,0,115,0,-115
21487,0,0,22,0,-22
21488,0,0,184,0,-184
21489,0,0,43,0,-43
21490,1,1,885,1268,383
21491,0,0,59,0,-59
21492,1,0,99,0,-99
21493,1,0,2,0,-2
21494,1,1,2745,1347,-1398
21495,1,1,118,1469,1351
21496,1,0,16,0,-16
21497,0,0,41,0,-41
21498,1,1,617,1420,803
21499,1,1,313,1441,1128
21500,0,0,15,0,-15
21501,1,0,39,0,-39
21502,1,1,153,1210,1057
21503,1,0,30,0,-30
21504,1,0,37,0,-37
21505,0,0,5,0,-5
21506,1,1,1011,2077,1066
21507,0,0,11,0,-11
21508,0,0,40,0,-40
21509,0,0,23,0,-23
21510,0,0,39,0,-39
21511,1,1,830,1230,400
21512,0,0,218,0,-218
21513,1,0,39,0,-39
21514,1,1,542,1245,703
21515,0,0,46,0,-46
21516,0,0,12,0,-12
21517,1,1,268,1235,967
21518,0,0,50,0,-50
21519,1,0,33,0,-33
21520,1,1,3172,1746,-1426
21521,0,0,1,0,-1
21522,0,0,46,0,-46
21523,0,0,57,0,-57
21524,0,0,35,0,-35
21525,1,0,99,0,-99
21526,0,0,84,0,-84
21527,1,1,916,1351,435
21528,1,0,10,0,-10
21529,0,0,128,0,-128
21530,1,0,10,0,-10
21531,1,0,64,0,-64
21532,0,0,44,0,-44
21533,0,0,71,0,-71
21534,0,0,24,0,-24
21535,1,1,403,1279,876
21536,1,0,167,0,-167
21537,0,0,89,0,-89
21538,0,0,164,0,-164
21539,1,1,448,1635,1187
21540,1,1,707,2231,1524
21541,0,0,192,0,-192
21542,0,0,34,0,-34
21543,1,1,678,1279,601
21544,0,0,12,0,-12
21545,1,1,117,1370,1253
21546,1,1,239,2313,2074
21547,1,1,788,1408,620
21548,0,0,8,0,-8
21549,1,1,103,1254,1151
21550,1,1,259,1242,983
21551,1,1,1023,1346,323
21552,1,1,1531,1521,-10
21553,1,1,63,1251,1188
21554,1,0,12,0,-12
21555,1,1,1174,1450,276
21556,0,0,224,0,-224
21557,1,1,824,1365,541
21558,1,1,868,1230,362
21559,1,0,114,0,-114
21560,0,0,68,0,-68
21561,0,0,38,0,-38
21562,0,0,18,0,-18
21563,0,0,10,0,-10
21564,1,1,284,1245,961
21565,1,0,63,0,-63
21566,0,0,30,0,-30
21567,1,0,10,0,-10
21568,0,0,33,0,-33
21569,1,0,87,0,-87
21570,0,0,15,0,-15
21571,1,0,69,0,-69
21572,0,0,20,0,-20
21573,1,1,949,4199,3250
21574,1,0,53,0,-53
21575,0,0,6,0,-6
21576,0,0,25,0,-25
21577,0,0,136,0,-136
21578,0,0,21,0,-21
21579,0,0,81,0,-81
21580,0,0,35,0,-35
21581,0,0,124,0,-124
21582,1,0,13,0,-13
21583,1,0,51,0,-51
21584,1,1,1849,2838,989
21585,0,0,2,0,-2
21586,1,0,6,0,-6
21587,1,1,833,4396,3563
21588,1,1,1003,1440,437
21589,0,0,27,0,-27
21590,0,0,51,0,-51
21591,1,1,2954,1349,-1605
21592,1,0,36,0,-36
21593,0,0,51,0,-51
21594,1,1,164,2128,1964
21595,1,0,38,0,-38
21596,0,0,5,0,-5
21597,0,0,24,0,-24
21598,1,0,32,0,-32
21599,1,0,129,0,-129
21600,1,1,453,1416,963
21601,0,0,13,0,-13
21602,0,0,50,0,-50
21603,0,0,47,0,-47
21604,1,0,18,0,-18
21605,0,0,23,0,-23
21606,0,0,31,0,-31
21607,0,0,8,0,-8
21608,1,1,1817,1243,-574
21609,1,0,37,0,-37
21610,1,0,10,0,-10
21611,0,0,29,0,-29
21612,0,0,23,0,-23
21613,0,0,5,0,-5
21614,1,1,1465,1421,-44
21615,0,0,19,0,-19
21616,1,0,24,0,-24
21617,0,0,55,0,-55
21618,1,0,80,0,-80
21619,1,1,767,1372,605
21620,0,0,285,0,-285
21621,1,1,1362,1679,317
21622,1,1,332,1204,872
21623,1,1,299,1232,933
21624,1,1,224,1312,1088
21625,1,1,60,1271,1211
21626,0,0,38,0,-38
21627,1,1,781,1641,860
21628,1,0,37,0,-37
21629,0,0,7,0,-7
21630,1,1,607,1521,914
21631,1,1,185,2882,2697
21632,1,1,609,1228,619
21633,0,0,66,0,-66
21634,1,0,56,0,-56
21635,0,0,0,0,0
21636,1,0,30,0,-30
21637,1,1,615,2733,2118
21638,1,0,4,0,-4
21639,1,0,9,0,-9
21640,0,0,33,0,-33
21641,1,0,7,0,-7
21642,1,1,471,2485,2014
21643,1,0,172,0,-172
21644,1,0,4,0,-4
21645,1,1,355,1243,888
21646,1,1,816,1639,823
21647,0,0,4,0,-4
21648,1,1,248,1269,1021
21649,1,0,74,0,-74
21650,0,0,70,0,-70
21651,1,0,154,0,-154
21652,0,0,44,0,-44
21653,1,1,314,1256,942
21654,1,0,181,0,-181
21655,1,0,14,0,-14
21656,1,1,843,1631,788
21657,1,1,591,1316,725
21658,1,0,4,0,-4
21659,1,1,174,2377,2203
21660,1,0,6,0,-6
21661,1,1,205,1565,1360
21662,0,0,45,0,-45
21663,1,1,396,1327,931
21664,1,1,294,1251,957
21665,0,0,122,0,-122
21666,1,1,825,1645,820
21667,0,0,23,0,-23
21668,1,0,15,0,-15
21669,1,1,1524,1389,-135
21670,1,1,520,1232,712
21671,1,0,73,0,-73
21672,1,0,16,0,-16
21673,0,0,45,0,-45
21674,1,1,48,1494,1446
21675,1,0,54,0,-54
21676,0,0,51,0,-51
21677,1,1,524,1255,731
21678,0,0,8,0,-8
21679,1,1,510,1206,696
21680,1,1,1637,1512,-125
21681,1,0,36,0,-36
21682,1,0,34,0,-34
21683,1,0,21,0,-21
21684,1,0,0,0,0
21685,1,1,386,1255,869
21686,1,1,1267,2022,755
21687,0,0,18,0,-18
21688,1,1,292,1669,1377
21689,1,1,302,1959,1657
21690,1,0,5,0,-5
21691,0,0,104,0,-104
21692,1,0,96,0,-96
21693,1,1,520,1526,1006
21694,0,0,6,0,-6
21695,1,1,684,2082,1398
21696,1,1,223,1939,1716
21697,1,1,278,1209,931
21698,1,0,26,0,-26
21699,1,1,394,1267,873
21700,1,1,85,2813,2728
21701,0,0,46,0,-46
21702,0,0,44,0,-44
21703,0,0,16,0,-16
21704,1,0,5,0,-5
21705,1,1,672,2026,1354
21706,1,1,3283,1487,-1796
21707,1,0,153,0,-153
21708,0,0,6,0,-6
21709,1,0,43,0,-43
21710,1,0,14,0,-14
21711,0,0,30,0,-30
21712,0,0,101,0,-101
21713,1,0,53,0,-53
21714,1,1,85,1468,1383
21715,0,0,28,0,-28
21716,1,0,31,0,-31
21717,0,0,38,0,-38
21718,1,1,273,1493,1220
21719,0,0,89,0,-89
21720,1,1,364,1466,1102
21721,0,0,130,0,-130
21722,1,1,758,1426,668
21723,1,0,42,0,-42
21724,0,0,46,0,-46
21725,0,0,23,0,-23
21726,0,0,7,0,-7
21727,1,0,16,0,-16
21728,1,0,21,0,-21
21729,1,0,9,0,-9
21730,1,0,31,0,-31
21731,0,0,13,0,-13
21732,1,0,61,0,-61
21733,1,1,2073,1349,-724
21734,1,1,145,1284,1139
21735,1,0,32,0,-32
21736,1,1,51,1251,1200
21737,1,1,720,1575,855
21738,1,0,27,0,-27
21739,1,0,48,0,-48
21740,1,0,87,0,-87
21741,0,0,90,0,-90
21742,1,1,403,1261,858
21743,1,1,369,1341,972
21744,1,0,21,0,-21
21745,0,0,20,0,-20
21746,1,1,297,2424,2127
21747,1,0,14,0,-14
21748,0,0,5,0,-5
21749,0,0,12,0,-12
21750,1,0,57,0,-57
21751,0,0,14,0,-14
21752,1,1,801,1412,611
21753,1,1,1127,1473,346
21754,1,0,14,0,-14
21755,0,0,2,0,-2
21756,1,1,1739,1389,-350
21757,1,1,1436,1525,89
21758,0,0,173,0,-173
21759,1,0,9,0,-9
21760,0,0,145,0,-145
21761,1,1,630,1852,1222
21762,1,1,1249,1256,7
21763,1,1,692,1206,514
21764,1,0,12,0,-12
21765,1,1,319,1477,1158
21766,0,0,10,0,-10
21767,0,0,89,0,-89
21768,0,0,61,0,-61
21769,0,0,79,0,-79
21770,0,0,69,0,-69
21771,1,1,80,1628,1548
21772,1,1,613,1256,643
21773,1,1,657,1236,579
21774,0,0,12,0,-12
21775,0,0,0,0,0
21776,0,0,44,0,-44
21777,1,0,12,0,-12
21778,1,0,2,0,-2
21779,1,1,394,2498,2104
21780,1,1,1598,1359,-239
21781,0,0,5,0,-5
21782,0,0,1,0,-1
21783,1,0,0,0,0
21784,1,1,522,1598,1076
21785,1,0,231,0,-231
21786,1,0,39,0,-39
21787,0,0,39,0,-39
21788,0,0,21,0,-21
21789,1,0,45,0,-45
21790,1,0,52,0,-52
21791,0,0,31,0,-31
21792,1,0,35,0,-35
21793,1,0,72,0,-72
21794,1,0,49,0,-49
21795,0,0,23,0,-23
21796,0,0,48,0,-48
21797,1,0,8,0,-8
21798,1,1,569,1869,1300
21799,1,0,13,0,-13
21800,0,0,51,0,-51
21801,1,1,858,1582,724
21802,1,0,38,0,-38
21803,0,0,25,0,-25
21804,0,0,73,0,-73
21805,1,0,41,0,-41
21806,1,1,575,1225,650
21807,0,0,57,0,-57
21808,0,0,21,0,-21
21809,0,0,84,0,-84
21810,1,1,89,1351,1262
21811,1,0,52,0,-52
21812,1,1,437,1773,1336
21813,1,0,31,0,-31
21814,1,1,60,1465,1405
21815,1,0,13,0,-13
21816,0,0,9,0,-9
21817,1,0,134,0,-134
21818,1,0,45,0,-45
21819,1,1,1340,1361,21
21820,1,0,8,0,-8
21821,1,0,74,0,-74
21822,1,1,348,1243,895
21823,0,0,38,0,-38
21824,1,0,41,0,-41
21825,1,1,228,4023,3795
21826,1,0,47,0,-47
21827,0,0,27,0,-27
21828,0,0,203,0,-203
21829,0,0,119,0,-119
21830,1,0,6,0,-6
21831,1,1,431,1399,968
21832,1,1,1372,1987,615
21833,0,0,3,0,-3
21834,1,0,11,0,-11
21835,1,0,17,0,-17
21836,0,0,55,0,-55
21837,0,0,0,0,0
21838,1,1,425,1329,904
21839,1,0,8,0,-8
21840,1,0,69,0,-69
21841,0,0,5,0,-5
21842,1,1,407,1455,1048
21843,0,0,4,0,-4
21844,1,1,1379,1300,-79
21845,0,0,31,0,-31
21846,0,0,74,0,-74
21847,1,1,631,2139,1508
21848,0,0,242,0,-242
21849,1,0,69,0,-69
21850,1,0,26,0,-26
21851,1,0,4,0,-4
21852,1,1,155,1203,1048
21853,1,1,257,1697,1440
21854,0,0,218,0,-218
21855,0,0,3,0,-3
21856,0,0,10,0,-10
21857,0,0,27,0,-27
21858,1,0,48,0,-48
21859,1,0,7,0,-7
21860,0,0,42,0,-42
21861,1,0,107,0,-107
21862,1,1,452,1940,1488
21863,1,0,5,0,-5
21864,1,1,262,1337,1075
21865,1,0,68,0,-68
21866,0,0,6,0,-6
21867,0,0,53,0,-53
21868,0,0,54,0,-54
21869,1,1,986,1274,288
21870,1,0,42,0,-42
21871,0,0,40,0,-40
21872,0,0,66,0,-66
21873,1,1,529,1420,891
21874,0,0,2,0,-2
21875,1,1,949,1249,300
21876,0,0,4,0,-4
21877,1,1,493,1306,813
21878,0,0,9,0,-9
21879,1,1,556,1371,815
21880,1,1,324,1433,1109
21881,0,0,19,0,-19
21882,0,0,44,0,-44
21883,1,0,143,0,-143
21884,0,0,16,0,-16
21885,0,0,13,0,-13
21886,0,0,28,0,-28
21887,1,0,30,0,-30
21888,0,0,4,0,-4
21889,1,1,649,1240,591
21890,0,0,62,0,-62
21891,1,0,42,0,-42
21892,0,0,16,0,-16
21893,1,1,323,1695,1372
21894,1,1,336,1253,917
21895,1,0,146,0,-146
21896,1,0,22,0,-22
21897,0,0,38,0,-38
21898,1,1,157,1580,1423
21899,0,0,10,0,-10
21900,0,0,34,0,-34
21901,1,0,21,0,-21
21902,1,0,21,0,-21
21903,0,0,7,0,-7
21904,0,0,6,0,-6
21905,0,0,7,0,-7
21906,0,0,102,0,-102
21907,1,1,828,1526,698
21908,1,0,60,0,-60
21909,1,1,228,1886,1658
21910,1,0,76,0,-76
21911,1,1,333,1645,1312
21912,0,0,60,0,-60
21913,0,0,6,0,-6
21914,0,0,15,0,-15
21915,0,0,209,0,-209
21916,1,1,207,1900,1693
21917,0,0,8,0,-8
21918,0,0,64,0,-64
21919,0,0,11,0,-11
21920,1,1,178,1651,1473
21921,0,0,57,0,-57
21922,1,1,2019,1838,-181
21923,0,0,45,0,-45
21924,1,1,88,1262,1174
21925,0,0,0,0,0
21926,1,1,642,1205,563
21927,0,0,51,0,-51
21928,0,0,46,0,-46
21929,1,0,125,0,-125
21930,1,1,70,1416,1346
21931,0,0,31,0,-31
21932,1,0,26,0,-26
21933,1,0,9,0,-9
21934,1,1,391,1457,1066
21935,1,0,94,0,-94
21936,0,0,62,0,-62
21937,0,0,6,0,-6
21938,0,0,147,0,-147
21939,1,1,262,1555,1293
21940,1,0,20,0,-20
21941,1,0,22,0,-22
21942,0,0,2,0,-2
21943,1,0,36,0,-36
21944,1,1,153,1208,1055
21945,1,0,47,0,-47
21946,1,1,616,1958,1342
21947,0,0,31,0,-31
21948,0,0,239,0,-239
21949,0,0,38,0,-38
21950,1,0,18,0,-18
21951,0,0,41,0,-41
21952,1,0,0,0,0
21953,1,1,228,1393,1165
21954,1,0,43,0,-43
21955,1,0,22,0,-22
21956,0,0,5,0,-5
21957,1,0,15,0,-15
21958,1,0,116,0,-116
21959,0,0,9,0,-9
21960,1,1,1017,1286,269
21961,1,0,27,0,-27
21962,0,0,7,0,-7
21963,1,0,64,0,-64
21964,0,0,2,0,-2
21965,0,0,5,0,-5
21966,1,1,1597,1536,-61
21967,1,1,1722,1355,-367
21968,1,0,26,0,-26
21969,0,0,26,0,-26
21970,0,0,55,0,-55
21971,0,0,23,0,-23
21972,1,1,263,1393,1130
21973,1,0,14,0,-14
21974,1,1,206,1253,1047
21975,0,0,20,0,-20
21976,1,1,194,1353,1159
21977,0,0,6,0,-6
21978,1,1,1056,1252,196
21979,0,0,6,0,-6
21980,0,0,70,0,-70
21981,0,0,14,0,-14
21982,1,0,19,0,-19
21983,1,1,1226,1360,134
21984,1,0,40,0,-40
21985,1,0,5,0,-5
21986,1,1,443,1256,813
21987,1,1,1991,1417,-574
21988,1,1,1045,1236,191
21989,1,1,558,1481,923
21990,1,1,381,1710,1329
21991,0,0,31,0,-31
21992,0,0,16,0,-16
21993,1,0,112,0,-112
21994,0,0,10,0,-10
21995,1,0,312,0,-312
21996,1,0,48,0,-48
21997,0,0,13,0,-13
21998,1,0,107,0,-107
21999,1,1,200,1257,1057
22000,1,0,40,0,-40
22001,1,0,6,0,-6
22002,1,0,144,0,-144
22003,1,0,62,0,-62
22004,0,0,4,0,-4
22005,0,0,58,0,-58
22006,1,1,381,1347,966
22007,1,0,10,0,-10
22008,1,0,4,0,-4
22009,1,0,79,0,-79
22010,1,0,120,0,-120
22011,1,0,4,0,-4
22012,0,0,192,0,-192
22013,1,0,20,0,-20
22014,0,0,23,0,-23
22015,0,0,35,0,-35
22016,0,0,88,0,-88
22017,0,0,39,0,-39
22018,1,1,140,2156,2016
22019,1,1,950,1219,269
22020,1,1,227,1996,1769
22021,0,0,44,0,-44
22022,1,1,312,1474,1162
22023,1,0,3,0,-3
22024,0,0,47,0,-47
22025,1,0,196,0,-196
22026,1,1,345,1440,1095
22027,1,0,18,0,-18
22028,1,1,786,2383,1597
22029,1,0,4,0,-4
22030,1,1,130,1221,1091
22031,1,0,50,0,-50
22032,0,0,37,0,-37
22033,0,0,9,0,-9
22034,1,0,195,0,-195
22035,1,0,43,0,-43
22036,1,1,1750,1287,-463
22037,1,0,12,0,-12
22038,0,0,2,0,-2
22039,1,1,545,1330,785
22040,1,1,224,1214,990
22041,1,0,36,0,-36
22042,1,0,12,0,-12
22043,0,0,32,0,-32
22044,1,1,475,1322,847
22045,1,1,1231,1520,289
22046,0,0,16,0,-16
22047,1,0,42,0,-42
22048,0,0,24,0,-24
22049,0,0,98,0,-98
22050,0,0,18,0,-18
22051,1,0,38,0,-38
22052,0,0,15,0,-15
22053,0,0,30,0,-30
22054,0,0,53,0,-53
22055,1,0,36,0,-36
22056,1,0,33,0,-33
22057,1,1,648,1274,626
22058,1,1,102,2157,2055
22059,1,0,49,0,-49
22060,0,0,46,0,-46
22061,0,0,121,0,-121
22062,0,0,38,0,-38
22063,1,0,13,0,-13
22064,1,1,382,5070,4688
22065,0,0,26,0,-26
22066,0,0,61,0,-61
22067,0,0,36,0,-36
22068,0,0,147,0,-147
22069,1,1,315,1210,895
22070,0,0,42,0,-42
22071,1,1,1263,1332,69
22072,0,0,3,0,-3
22073,0,0,79,0,-79
22074,1,0,27,0,-27
22075,1,1,479,1568,1089
22076,1,1,341,1979,1638
22077,0,0,23,0,-23
22078,1,1,1077,2174,1097
22079,1,1,1594,1246,-348
22080,0,0,26,0,-26
22081,1,0,12,0,-12
22082,0,0,26,0,-26
22083,0,0,31,0,-31
22084,1,1,932,1379,447
22085,1,0,1,0,-1
22086,1,1,345,1803,1458
22087,1,0,91,0,-91
22088,0,0,47,0,-47
22089,1,1,159,1211,1052
22090,1,1,200,1780,1580
22091,0,0,10,0,-10
22092,1,0,24,0,-24
22093,1,1,704,1358,654
22094,1,1,680,1414,734
22095,0,0,113,0,-113
22096,1,0,82,0,-82
22097,1,0,166,0,-166
22098,0,0,42,0,-42
22099,1,0,29,0,-29
22100,1,0,100,0,-100
22101,1,0,196,0,-196
22102,0,0,8,0,-8
22103,1,1,1167,1379,212
22104,1,1,1227,1407,180
22105,0,0,45,0,-45
22106,0,0,29,0,-29
22107,1,0,103,0,-103
22108,1,1,223,1531,1308
22109,0,0,15,0,-15
22110,0,0,50,0,-50
22111,1,0,27,0,-27
22112,0,0,22,0,-22
22113,1,0,122,0,-122
22114,0,0,27,0,-27
22115,1,0,30,0,-30
22116,0,0,30,0,-30
22117,0,0,26,0,-26
22118,0,0,83,0,-83
22119,1,0,52,0,-52
22120,0,0,94,0,-94
22121,1,0,29,0,-29
22122,1,0,3,0,-3
22123,0,0,8,0,-8
22124,1,1,398,1317,919
22125,0,0,39,0,-39
22126,1,0,2,0,-2
22127,1,1,599,1374,775
22128,1,0,17,0,-17
22129,1,0,15,0,-15
22130,1,0,51,0,-51
22131,1,1,60,1207,1147
22132,0,0,10,0,-10
22133,0,0,22,0,-22
22134,1,0,46,0,-46
22135,0,0,10,0,-10
22136,1,1,362,1319,957
22137,1,0,23,0,-23
22138,1,0,11,0,-11
22139,0,0,1,0,-1
22140,1,0,12,0,-12
22141,1,1,1140,1604,464
22142,1,1,547,1858,1311
22143,0,0,81,0,-81
22144,1,0,74,0,-74
22145,0,0,77,0,-77
22146,1,0,68,0,-68
22147,1,0,1,0,-1
22148,1,1,255,1356,1101
22149,1,1,123,1556,1433
22150,1,0,53,0,-53
22151,0,0,44,0,-44
22152,1,0,56,0,-56
22153,1,0,6,0,-6
22154,0,0,14,0,-14
22155,1,1,574,1371,797
22156,1,0,3,0,-3
22157,1,1,29,5248,5219
22158,1,0,73,0,-73
22159,1,1,264,1317,1053
22160,1,0,41,0,-41
22161,1,1,23,1489,1466
22162,1,0,27,0,-27
22163,0,0,47,0,-47
22164,0,0,16,0,-16
22165,0,0,17,0,-17
22166,0,0,32,0,-32
22167,0,0,114,0,-114
22168,0,0,138,0,-138
22169,1,0,27,0,-27
22170,1,1,221,1374,1153
22171,1,0,5,0,-5
22172,1,0,39,0,-39
22173,0,0,1,0,-1
22174,1,0,149,0,-149
22175,0,0,3,0,-3
22176,0,0,45,0,-45
22177,1,1,84,1435,1351
22178,1,1,81,1419,1338
22179,0,0,4,0,-4
22180,0,0,15,0,-15
22181,0,0,44,0,-44
22182,1,0,50,0,-50
22183,0,0,73,0,-73
22184,0,0,91,0,-91
22185,0,0,19,0,-19
22186,1,1,643,1301,658
22187,1,1,245,1205,960
22188,0,0,30,0,-30
22189,1,1,518,1239,721
22190,1,0,43,0,-43
22191,1,0,18,0,-18
22192,1,1,361,1399,1038
22193,1,0,20,0,-20
22194,1,0,7,0,-7
22195,1,1,193,1575,1382
22196,1,1,244,1247,1003
22197,1,1,286,1590,1304
22198,0,0,4,0,-4
22199,0,0,119,0,-119
22200,1,1,543,1280,737
22201,1,1,1736,2408,672
22202,0,0,28,0,-28
22203,1,1,1756,1236,-520
22204,1,0,7,0,-7
22205,0,0,51,0,-51
22206,0,0,42,0,-42
22207,1,0,55,0,-55
22208,0,0,23,0,-23
22209,1,1,18,1344,1326
22210,1,0,35,0,-35
22211,0,0,52,0,-52
22212,0,0,1,0,-1
22213,1,0,30,0,-30
22214,1,0,2,0,-2
22215,1,0,0,0,0
22216,1,0,0,0,0
22217,1,0,6,0,-6
22218,1,0,34,0,-34
22219,1,0,12,0,-12
22220,1,1,470,1225,755
22221,1,1,1486,2044,558
22222,0,0,44,0,-44
22223,1,0,66,0,-66
22224,1,0,22,0,-22
22225,0,0,47,0,-47
22226,1,1,150,1500,1350
22227,1,1,113,1701,1588
22228,0,0,12,0,-12
22229,1,1,194,1219,1025
22230,1,1,115,1558,1443
22231,1,1,288,1344,1056
22232,0,0,35,0,-35
22233,0,0,10,0,-10
22234,1,1,376,1218,842
22235,1,1,1239,1699,460
22236,1,1,385,1567,1182
22237,0,0,0,0,0
22238,1,0,243,0,-243
22239,0,0,52,0,-52
22240,0,0,1,0,-1
22241,1,0,3,0,-3
22242,0,0,25,0,-25
22243,1,0,46,0,-46
22244,0,0,21,0,-21
22245,0,0,32,0,-32
22246,0,0,4,0,-4
22247,1,0,55,0,-55
22248,1,1,863,1370,507
22249,1,0,26,0,-26
22250,0,0,22,0,-22
22251,1,0,121,0,-121
22252,0,0,38,0,-38
22253,0,0,10,0,-10
22254,1,1,1363,1303,-60
22255,0,0,11,0,-11
22256,0,0,218,0,-218
22257,1,0,33,0,-33
22258,0,0,27,0,-27
22259,0,0,1,0,-1
22260,0,0,1,0,-1
22261,0,0,12,0,-12
22262,1,0,55,0,-55
22263,1,0,216,0,-216
22264,1,1,220,1328,1108
22265,1,1,1495,1394,-101
22266,1,1,631,1257,626
22267,1,0,47,0,-47
22268,1,1,236,1320,1084
22269,1,1,730,1358,628
22270,1,0,19,0,-19
22271,1,0,11,0,-11
22272,0,0,58,0,-58
22273,0,0,130,0,-130
22274,1,1,403,2417,2014
22275,1,1,170,1363,1193
22276,1,1,561,2357,1796
22277,0,0,6,0,-6
22278,0,0,57,0,-57
22279,1,1,416,1423,1007
22280,1,0,69,0,-69
22281,0,0,34,0,-34
22282,0,0,0,0,0
22283,0,0,11,0,-11
22284,0,0,29,0,-29
22285,1,0,17,0,-17
22286,1,1,858,1805,947
22287,1,0,62,0,-62
22288,0,0,6,0,-6
22289,1,0,171,0,-171
22290,0,0,39,0,-39
22291,1,1,1162,1214,52
22292,0,0,38,0,-38
22293,0,0,55,0,-55
22294,0,0,9,0,-9
22295,1,0,70,0,-70
22296,1,1,67,1686,1619
22297,1,1,581,1383,802
22298,0,0,24,0,-24
22299,1,0,25,0,-25
22300,1,1,278,1380,1102
22301,1,1,198,1389,1191
22302,0,0,22,0,-22
22303,1,0,138,0,-138
22304,1,1,499,1229,730
22305,1,1,569,1450,881
22306,0,0,230,0,-230
22307,0,0,8,0,-8
22308,1,1,402,1874,1472
22309,1,1,1176,1588,412
22310,0,0,249,0,-249
22311,1,0,14,0,-14
22312,0,0,58,0,-58
22313,1,1,1168,1487,319
22314,1,1,2644,1455,-1189
22315,1,0,139,0,-139
22316,1,1,302,1253,951
22317,1,0,95,0,-95
22318,0,0,15,0,-15
22319,1,0,11,0,-11
22320,0,0,4,0,-4
22321,1,1,91,1263,1172
22322,0,0,6,0,-6
22323,0,0,9,0,-9
22324,0,0,40,0,-40
22325,1,0,29,0,-29
22326,1,0,47,0,-47
22327,1,1,388,3026,2638
22328,0,0,33,0,-33
22329,1,1,80,1439,1359
22330,0,0,38,0,-38
22331,0,0,65,0,-65
22332,0,0,73,0,-73
22333,1,0,0,0,0
22334,1,1,926,1277,351
22335,0,0,1,0,-1
22336,0,0,20,0,-20
22337,1,0,23,0,-23
22338,1,1,206,1747,1541
22339,1,0,1,0,-1
22340,1,1,1272,1586,314
22341,0,0,22,0,-22
22342,1,1,172,1458,1286
22343,0,0,1,0,-1
22344,0,0,238,0,-238
22345,1,0,16,0,-16
22346,1,0,17,0,-17
22347,1,0,16,0,-16
22348,0,0,17,0,-17
22349,1,1,238,1642,1404
22350,0,0,180,0,-180
22351,1,0,26,0,-26
22352,1,0,11,0,-11
22353,1,0,42,0,-42
22354,1,0,16,0,-16
22355,1,0,89,0,-89
22356,1,1,301,1228,927
22357,0,0,13,0,-13
22358,0,0,23,0,-23
22359,0,0,62,0,-62
22360,1,0,10,0,-10
22361,0,0,82,0,-82
22362,0,0,56,0,-56
22363,0,0,37,0,-37
22364,0,0,13,0,-13
22365,1,1,1786,1388,-398
22366,1,1,1184,1243,59
22367,0,0,37,0,-37
22368,1,0,21,0,-21
22369,1,1,141,1221,1080
22370,1,0,14,0,-14
22371,0,0,52,0,-52
22372,1,1,596,1365,769
22373,1,0,2,0,-2
22374,0,0,14,0,-14
22375,0,0,0,0,0
22376,1,1,527,1219,692
22377,0,0,54,0,-54
22378,1,1,1311,1342,31
22379,0,0,13,0,-13
22380,1,1,1240,1331,91
22381,1,1,229,1582,1353
22382,0,0,76,0,-76
22383,0,0,63,0,-63
22384,1,0,13,0,-13
22385,1,1,363,1266,903
22386,1,0,120,0,-120
22387,0,0,10,0,-10
22388,0,0,102,0,-102
22389,1,1,305,1284,979
22390,1,0,12,0,-12
22391,1,1,365,1801,1436
22392,0,0,48,0,-48
22393,0,0,84,0,-84
22394,1,1,969,1335,366
22395,0,0,4,0,-4
22396,0,0,23,0,-23
22397,0,0,30,0,-30
22398,0,0,16,0,-16
22399,0,0,61,0,-61
22400,0,0,3,0,-3
22401,1,0,130,0,-130
22402,1,1,476,1533,1057
22403,1,1,148,1245,1097
22404,0,0,20,0,-20
22405,0,0,4,0,-4
22406,0,0,42,0,-42
22407,0,0,55,0,-55
22408,1,1,791,1546,755
22409,0,0,25,0,-25
22410,1,1,979,1315,336
22411,1,0,43,0,-43
22412,1,1,772,1576,804
22413,1,1,1118,1271,153
22414,1,0,14,0,-14
22415,1,0,45,0,-45
22416,1,1,45,1333,1288
22417,1,0,20,0,-20
22418,1,0,40,0,-40
22419,0,0,89,0,-89
22420,1,1,514,1416,902
22421,0,0,11,0,-11
22422,0,0,47,0,-47
22423,0,0,5,0,-5
22424,1,1,90,1789,1699
22425,1,1,720,1802,1082
22426,1,1,552,1545,993
22427,0,0,44,0,-44
22428,1,0,21,0,-21
22429,1,0,68,0,-68
22430,0,0,60,0,-60
22431,1,0,100,0,-100
22432,1,1,1010,1218,208
22433,0,0,83,0,-83
22434,1,0,49,0,-49
22435,0,0,21,0,-21
22436,1,1,160,1542,1382
22437,0,0,26,0,-26
22438,1,1,170,1330,1160
22439,0,0,1,0,-1
22440,0,0,2,0,-2
22441,0,0,351,0,-351
22442,0,0,162,0,-162
22443,0,0,103,0,-103
22444,1,0,62,0,-62
22445,1,1,455,1811,1356
22446,0,0,60,0,-60
22447,1,1,232,1585,1353
22448,1,1,903,1250,347
22449,1,0,9,0,-9
22450,1,0,200,0,-200
22451,0,0,14,0,-14
22452,0,0,7,0,-7
22453,1,0,28,0,-28
22454,1,1,844,2308,1464
22455,1,0,31,0,-31
22456,0,0,81,0,-81
22457,0,0,74,0,-74
22458,1,1,269,1392,1123
22459,1,0,56,0,-56
22460,1,1,1468,1483,15
22461,0,0,50,0,-50
22462,0,0,14,0,-14
22463,0,0,45,0,-45
22464,0,0,32,0,-32
22465,1,0,138,0,-138
22466,1,0,33,0,-33
22467,1,0,5,0,-5
22468,1,1,591,1531,940
22469,0,0,1,0,-1
22470,0,0,10,0,-10
22471,1,1,306,1281,975
22472,1,1,389,1733,1344
22473,1,0,49,0,-49
22474,0,0,74,0,-74
22475,1,0,145,0,-145
22476,1,0,78,0,-78
22477,0,0,14,0,-14
22478,0,0,13,0,-13
22479,1,1,175,1274,1099
22480,0,0,246,0,-246
22481,0,0,4,0,-4
22482,1,1,1186,1279,93
22483,1,0,13,0,-13
22484,1,0,47,0,-47
22485,1,0,24,0,-24
22486,0,0,143,0,-143
22487,0,0,11,0,-11
22488,0,0,49,0,-49
22489,1,1,873,1457,584
22490,1,0,40,0,-40
22491,1,0,38,0,-38
22492,0,0,22,0,-22
22493,1,0,7,0,-7
22494,1,1,904,1212,308
22495,0,0,87,0,-87
22496,0,0,38,0,-38
22497,0,0,19,0,-19
22498,1,0,75,0,-75
22499,0,0,18,0,-18
22500,0,0,63,0,-63
22501,1,0,115,0,-115
22502,1,0,15,0,-15
22503,0,0,1,0,-1
22504,1,1,1950,1870,-80
22505,1,1,247,2470,2223
22506,1,0,19,0,-19
22507,1,0,1,0,-1
22508,1,0,44,0,-44
22509,1,0,11,0,-11
22510,1,1,52,1811,1759
22511,1,1,147,2442,2295
22512,1,1,559,2120,1561
22513,0,0,8,0,-8
22514,1,1,713,1777,1064
22515,1,1,2369,3973,1604
22516,0,0,0,0,0
22517,1,0,5,0,-5
22518,1,0,49,0,-49
22519,0,0,17,0,-17
22520,1,0,147,0,-147
22521,1,0,7,0,-7
22522,1,0,19,0,-19
22523,1,0,186,0,-186
22524,1,1,205,1408,1203
22525,1,1,1010,1270,260
22526,1,1,124,1314,1190
22527,1,1,887,1476,589
22528,0,0,47,0,-47
22529,0,0,10,0,-10
22530,1,1,1015,1277,262
22531,0,0,21,0,-21
22532,0,0,74,0,-74
22533,1,1,853,1224,371
22534,1,1,128,1404,1276
22535,0,0,26,0,-26
22536,0,0,77,0,-77
22537,1,0,53,0,-53
22538,1,0,0,0,0
22539,1,1,74,1209,1135
22540,1,0,86,0,-86
22541,0,0,114,0,-114
22542,1,0,56,0,-56
22543,1,0,60,0,-60
22544,1,0,64,0,-64
22545,1,1,123,1707,1584
22546,1,1,181,1985,1804
22547,0,0,16,0,-16
22548,1,1,247,1249,1002
22549,1,0,248,0,-248
22550,0,0,6,0,-6
22551,0,0,41,0,-41
22552,0,0,70,0,-70
22553,0,0,76,0,-76
22554,1,1,25,1374,1349
22555,1,0,29,0,-29
22556,1,0,8,0,-8
22557,0,0,19,0,-19
22558,1,0,1,0,-1
22559,1,0,22,0,-22
22560,1,1,98,1415,1317
22561,1,1,32,1441,1409
22562,1,0,185,0,-185
22563,1,1,701,3143,2442
22564,0,0,136,0,-136
22565,1,0,125,0,-125
22566,0,0,1,0,-1
22567,1,0,19,0,-19
22568,0,0,156,0,-156
22569,0,0,52,0,-52
22570,1,0,165,0,-165
22571,1,1,334,1616,1282
22572,0,0,81,0,-81
22573,1,0,94,0,-94
22574,1,1,1030,1410,380
22575,0,0,76,0,-76
22576,1,1,1444,1485,41
22577,1,0,8,0,-8
22578,1,0,21,0,-21
22579,1,0,43,0,-43
22580,1,0,39,0,-39
22581,0,0,10,0,-10
22582,0,0,26,0,-26
22583,1,1,179,1211,1032
22584,0,0,72,0,-72
22585,0,0,83,0,-83
22586,1,0,53,0,-53
22587,1,1,103,1396,1293
22588,1,0,24,0,-24
22589,1,1,752,1281,529
22590,1,1,327,1253,926
22591,1,1,175,1952,1777
22592,0,0,74,0,-74
22593,1,0,84,0,-84
22594,1,0,7,0,-7
22595,1,1,243,1255,1012
22596,1,1,175,1206,1031
22597,1,0,52,0,-52
22598,0,0,32,0,-32
22599,1,1,2792,1283,-1509
22600,1,1,85,1493,1408
22601,0,0,5,0,-5
22602,0,0,2,0,-2
22603,0,0,0,0,0
22604,1,1,130,1223,1093
22605,0,0,2,0,-2
22606,1,1,217,2437,2220
22607,1,0,44,0,-44
22608,1,1,335,1224,889
22609,0,0,76,0,-76
22610,1,1,102,1217,1115
22611,1,1,93,1269,1176
22612,0,0,61,0,-61
22613,1,0,34,0,-34
22614,1,1,1217,1400,183
22615,0,0,63,0,-63
22616,1,0,4,0,-4
22617,1,0,60,0,-60
22618,1,0,18,0,-18
22619,1,0,146,0,-146
22620,1,1,341,1368,1027
22621,0,0,30,0,-30
22622,1,1,211,1535,1324
22623,1,1,111,1276,1165
22624,0,0,8,0,-8
22625,1,0,104,0,-104
22626,1,0,32,0,-32
22627,1,0,3,0,-3
22628,0,0,34,0,-34
22629,1,1,516,1770,1254
22630,1,0,2,0,-2
22631,1,0,149,0,-149
22632,1,1,312,2359,2047
22633,1,0,4,0,-4
22634,0,0,58,0,-58
22635,1,0,214,0,-214
22636,1,0,87,0,-87
22637,1,0,7,0,-7
22638,1,1,78,1701,1623
22639,0,0,13,0,-13
22640,0,0,41,0,-41
22641,1,0,10,0,-10
22642,1,0,39,0,-39
22643,0,0,35,0,-35
22644,1,1,1084,1280,196
22645,0,0,36,0,-36
22646,0,0,1,0,-1
22647,1,0,24,0,-24
22648,0,0,1,0,-1
22649,0,0,14,0,-14
22650,0,0,27,0,-27
22651,0,0,0,0,0
22652,1,0,180,0,-180
22653,1,0,27,0,-27
22654,1,1,1191,1236,45
22655,1,0,120,0,-120
22656,0,0,50,0,-50
22657,1,0,40,0,-40
22658,1,1,71,1477,1406
22659,1,0,25,0,-25
22660,1,0,15,0,-15
22661,0,0,101,0,-101
22662,0,0,120,0,-120
22663,1,1,329,1437,1108
22664,1,0,8,0,-8
22665,1,1,177,1492,1315
22666,0,0,14,0,-14
22667,0,0,43,0,-43
22668,0,0,34,0,-34
22669,0,0,40,0,-40
22670,0,0,42,0,-42
22671,1,1,639,2140,1501
22672,1,1,1977,1200,-777
22673,0,0,70,0,-70
22674,1,0,356,0,-356
22675,0,0,9,0,-9
22676,1,0,99,0,-99
22677,1,0,68,0,-68
22678,0,0,8,0,-8
22679,1,1,277,1500,1223
22680,1,0,158,0,-158
22681,0,0,73,0,-73
22682,1,1,505,1846,1341
22683,0,0,29,0,-29
22684,0,0,55,0,-55
22685,1,1,369,1563,1194
22686,1,1,843,1591,748
22687,1,1,441,1779,1338
22688,1,1,280,2386,2106
22689,1,1,19,1253,1234
22690,1,0,87,0,-87
22691,0,0,25,0,-25
22692,0,0,11,0,-11
22693,1,0,37,0,-37
22694,0,0,52,0,-52
22695,0,0,20,0,-20
22696,1,1,217,1310,1093
22697,0,0,98,0,-98
22698,0,0,12,0,-12
22699,0,0,12,0,-12
22700,0,0,19,0,-19
22701,0,0,8,0,-8
22702,1,1,390,1299,909
22703,1,0,108,0,-108
22704,1,0,147,0,-147
22705,1,0,99,0,-99
22706,1,0,66,0,-66
22707,0,0,2,0,-2
22708,1,0,52,0,-52
22709,1,0,155,0,-155
22710,1,1,497,1223,726
22711,0,0,34,0,-34
22712,1,0,34,0,-34
22713,1,0,35,0,-35
22714,1,0,57,0,-57
22715,1,1,1102,1508,406
22716,0,0,103,0,-103
22717,1,1,500,1350,850
22718,0,0,12,0,-12
22719,0,0,40,0,-40
22720,1,1,280,1993,1713
22721,1,1,242,1381,1139
22722,1,0,0,0,0
22723,1,0,153,0,-153
22724,1,1,22,1459,1437
22725,0,0,93,0,-93
22726,0,0,4,0,-4
22727,1,0,123,0,-123
22728,1,1,208,1479,1271
22729,1,1,96,1251,1155
22730,1,0,68,0,-68
22731,1,1,586,1679,1093
22732,0,0,16,0,-16
22733,1,0,54,0,-54
22734,1,1,170,1216,1046
22735,0,0,67,0,-67
22736,1,1,663,2066,1403
22737,0,0,107,0,-107
22738,1,0,90,0,-90
22739,0,0,22,0,-22
22740,1,0,85,0,-85
22741,0,0,41,0,-41
22742,0,0,5,0,-5
22743,1,0,3,0,-3
22744,1,0,4,0,-4
22745,0,0,86,0,-86
22746,1,0,20,0,-20
22747,0,0,11,0,-11
22748,1,0,55,0,-55
22749,1,0,44,0,-44
22750,0,0,41,0,-41
22751,1,0,57,0,-57
22752,1,0,72,0,-72
22753,1,1,1535,1318,-217
22754,1,0,16,0,-16
22755,1,1,127,1322,1195
22756,1,1,271,1855,1584
22757,1,1,1278,1460,182
22758,0,0,3,0,-3
22759,1,1,488,1570,1082
22760,0,0,33,0,-33
22761,0,0,29,0,-29
22762,1,1,197,1830,1633
22763,0,0,251,0,-251
22764,1,1,327,1282,955
22765,1,1,1085,1318,233
22766,0,0,42,0,-42
22767,1,0,158,0,-158
22768,1,1,721,1839,1118
22769,1,1,75,1238,1163
22770,1,0,44,0,-44
22771,0,0,61,0,-61
22772,0,0,162,0,-162
22773,0,0,52,0,-52
22774,1,0,76,0,-76
22775,1,0,7,0,-7
22776,1,0,43,0,-43
22777,0,0,41,0,-41
22778,1,0,8,0,-8
22779,1,1,287,1607,1320
22780,1,1,169,1297,1128
22781,1,0,27,0,-27
22782,1,1,269,2348,2079
22783,0,0,53,0,-53
22784,1,0,4,0,-4
22785,1,0,42,0,-42
22786,0,0,32,0,-32
22787,1,1,137,1957,1820
22788,1,0,53,0,-53
22789,1,1,430,1495,1065
22790,1,1,2890,1537,-1353
22791,0,0,26,0,-26
22792,0,0,20,0,-20
22793,1,0,22,0,-22
22794,0,0,92,0,-92
22795,1,1,240,1356,1116
22796,1,1,323,3073,2750
22797,0,0,73,0,-73
22798,1,1,390,2413,2023
22799,1,1,315,1210,895
22800,0,0,27,0,-27
22801,0,0,0,0,0
22802,1,1,367,1470,1103
22803,1,1,454,1271,817
22804,0,0,17,0,-17
22805,0,0,133,0,-133
22806,0,0,41,0,-41
22807,1,1,214,1555,1341
22808,1,0,105,0,-105
22809,0,0,18,0,-18
22810,0,0,31,0,-31
22811,0,0,111,0,-111
22812,1,1,413,1276,863
22813,0,0,2,0,-2
22814,0,0,116,0,-116
22815,1,1,578,1620,1042
22816,1,1,629,1342,713
22817,1,0,81,0,-81
22818,0,0,46,0,-46
22819,0,0,2,0,-2
22820,1,1,346,1908,1562
22821,1,1,55,1984,1929
22822,1,0,25,0,-25
22823,1,0,19,0,-19
22824,1,1,245,1212,967
22825,1,0,110,0,-110
22826,0,0,71,0,-71
22827,1,0,35,0,-35
22828,1,0,306,0,-306
22829,1,0,7,0,-7
22830,1,1,150,2084,1934
22831,1,0,0,0,0
22832,1,1,163,1302,1139
22833,0,0,50,0,-50
22834,1,0,22,0,-22
22835,0,0,53,0,-53
22836,0,0,2,0,-2
22837,1,1,631,1339,708
22838,1,0,97,0,-97
22839,0,0,41,0,-41
22840,1,1,580,1654,1074
22841,0,0,4,0,-4
22842,1,0,57,0,-57
22843,1,1,226,1209,983
22844,0,0,57,0,-57
22845,1,1,135,1610,1475
22846,1,0,107,0,-107
22847,0,0,55,0,-55
22848,1,1,1306,1445,139
22849,1,0,18,0,-18
22850,1,1,2024,1233,-791
22851,1,1,342,1596,1254
22852,1,1,14,1562,1548
22853,0,0,18,0,-18
22854,1,0,0,0,0
22855,0,0,85,0,-85
22856,1,1,1409,1648,239
22857,0,0,3,0,-3
22858,1,0,41,0,-41
22859,1,1,160,1465,1305
22860,1,0,105,0,-105
22861,1,0,57,0,-57
22862,1,0,119,0,-119
22863,0,0,22,0,-22
22864,1,1,2167,1357,-810
22865,1,0,57,0,-57
22866,1,1,299,1432,1133
22867,0,0,181,0,-181
22868,1,1,280,1529,1249
22869,0,0,7,0,-7
22870,1,0,181,0,-181
22871,1,0,0,0,0
22872,1,0,85,0,-85
22873,1,0,5,0,-5
22874,1,1,72,1483,1411
22875,1,1,485,1355,870
22876,0,0,6,0,-6
22877,1,0,48,0,-48
22878,1,1,133,1358,1225
22879,1,1,1469,1658,189
22880,1,0,8,0,-8
22881,0,0,91,0,-91
22882,1,0,32,0,-32
22883,0,0,66,0,-66
22884,0,0,17,0,-17
22885,1,0,23,0,-23
22886,0,0,19,0,-19
22887,1,1,287,2295,2008
22888,1,0,15,0,-15
22889,0,0,73,0,-73
22890,0,0,77,0,-77
22891,0,0,63,0,-63
22892,0,0,17,0,-17
22893,0,0,20,0,-20
22894,1,1,130,1765,1635
22895,0,0,2,0,-2
22896,0,0,4,0,-4
22897,1,0,16,0,-16
22898,1,1,926,1419,493
22899,0,0,131,0,-131
22900,0,0,60,0,-60
22901,1,0,10,0,-10
22902,1,1,385,1884,1499
22903,0,0,17,0,-17
22904,1,1,1099,1528,429
22905,0,0,42,0,-42
22906,1,0,219,0,-219
22907,1,0,74,0,-74
22908,1,0,67,0,-67
22909,1,0,26,0,-26
22910,1,0,34,0,-34
22911,0,0,82,0,-82
22912,1,1,307,1499,1192
22913,1,1,374,1250,876
22914,1,0,95,0,-95
22915,1,0,1,0,-1
22916,1,0,109,0,-109
22917,1,1,24,2450,2426
22918,1,0,15,0,-15
22919,1,0,66,0,-66
22920,1,1,591,1256,665
22921,1,0,99,0,-99
22922,1,1,135,1747,1612
22923,1,1,111,1445,1334
22924,1,0,0,0,0
22925,1,1,395,1441,1046
22926,1,1,406,1622,1216
22927,1,1,562,1785,1223
22928,1,1,282,1261,979
22929,1,0,36,0,-36
22930,1,0,32,0,-32
22931,1,1,1377,1242,-135
22932,0,0,12,0,-12
22933,1,0,43,0,-43
22934,0,0,128,0,-128
22935,0,0,68,0,-68
22936,1,1,301,1266,965
22937,1,0,9,0,-9
22938,0,0,66,0,-66
22939,1,1,723,1209,486
22940,1,1,115,1521,1406
22941,1,1,113,1282,1169
22942,1,0,22,0,-22
22943,0,0,46,0,-46
22944,0,0,26,0,-26
22945,0,0,0,0,0
22946,1,0,16,0,-16
22947,1,1,341,2238,1897
22948,1,1,39,1408,1369
22949,1,1,291,1221,930
22950,1,0,49,0,-49
22951,0,0,6,0,-6
22952,0,0,2,0,-2
22953,1,0,26,0,-26
22954,1,0,84,0,-84
22955,1,0,25,0,-25
22956,0,0,9,0,-9
22957,1,1,594,1336,742
22958,0,0,107,0,-107
22959,0,0,67,0,-67
22960,0,0,24,0,-24
22961,1,1,175,1411,1236
22962,0,0,22,0,-22
22963,0,0,31,0,-31
22964,1,0,31,0,-31
22965,1,0,17,0,-17
22966,0,0,16,0,-16
22967,1,0,0,0,0
22968,0,0,16,0,-16
22969,0,0,80,0,-80
22970,1,1,981,1462,481
22971,0,0,33,0,-33
22972,0,0,1,0,-1
22973,1,1,479,1285,806
22974,0,0,6,0,-6
22975,1,1,1067,1337,270
22976,1,0,30,0,-30
22977,1,0,60,0,-60
22978,0,0,98,0,-98
22979,1,0,35,0,-35
22980,1,1,765,1334,569
22981,1,1,148,1681,1533
22982,0,0,60,0,-60
22983,1,1,266,1214,948
22984,0,0,119,0,-119
22985,0,0,11,0,-11
22986,0,0,93,0,-93
22987,0,0,150,0,-150
22988,0,0,7,0,-7
22989,1,0,138,0,-138
22990,0,0,13,0,-13
22991,0,0,11,0,-11
22992,0,0,33,0,-33
22993,0,0,27,0,-27
22994,1,1,1411,2250,839
22995,0,0,16,0,-16
22996,1,1,382,1685,1303
22997,0,0,26,0,-26
22998,1,1,627,1300,673
22999,1,1,183,2279,2096
23000,0,0,15,0,-15
23001,1,1,358,1316,958
23002,1,1,1149,1886,737
23003,1,0,210,0,-210
23004,1,0,21,0,-21
23005,1,1,397,1206,809
23006,1,1,211,1355,1144
23007,1,0,26,0,-26
23008,1,0,90,0,-90
23009,1,1,851,2093,1242
23010,0,0,14,0,-14
23011,1,1,172,1481,1309
23012,0,0,31,0,-31
23013,1,0,3,0,-3
23014,1,0,125,0,-125
23015,1,0,104,0,-104
23016,1,0,0,0,0
23017,0,0,5,0,-5
23018,0,0,80,0,-80
23019,0,0,22,0,-22
23020,1,0,4,0,-4
23021,1,1,268,1380,1112
23022,1,0,25,0,-25
23023,0,0,75,0,-75
23024,0,0,6,0,-6
23025,1,1,643,1642,999
23026,0,0,10,0,-10
23027,1,0,31,0,-31
23028,0,0,229,0,-229
23029,1,0,37,0,-37
23030,1,1,417,1297,880
23031,0,0,2,0,-2
23032,0,0,38,0,-38
23033,0,0,84,0,-84
23034,1,1,246,1204,958
23035,1,1,1085,1483,398
23036,1,0,87,0,-87
23037,1,0,135,0,-135
23038,1,0,16,0,-16
23039,1,1,464,1352,888
23040,0,0,16,0,-16
23041,0,0,21,0,-21
23042,0,0,39,0,-39
23043,1,0,131,0,-131
23044,1,1,736,1229,493
23045,1,0,49,0,-49
23046,1,0,76,0,-76
23047,0,0,46,0,-46
23048,0,0,3,0,-3
23049,1,1,228,1277,1049
23050,1,1,135,2527,2392
23051,1,1,219,1245,1026
23052,0,0,12,0,-12
23053,1,1,132,1343,1211
23054,0,0,17,0,-17
23055,0,0,132,0,-132
23056,1,1,1089,1403,314
23057,0,0,227,0,-227
23058,1,1,179,2546,2367
23059,0,0,103,0,-103
23060,0,0,64,0,-64
23061,0,0,257,0,-257
23062,1,1,1405,2108,703
23063,0,0,17,0,-17
23064,1,1,23,1928,1905
23065,1,1,453,1366,913
23066,1,1,1502,1482,-20
23067,1,1,658,1213,555
23068,0,0,63,0,-63
23069,1,1,513,1338,825
23070,0,0,28,0,-28
23071,1,1,761,1456,695
23072,1,1,314,1254,940
23073,1,1,573,1231,658
23074,1,1,658,1628,970
23075,1,1,111,1221,1110
23076,1,1,239,1270,1031
23077,1,1,806,1454,648
23078,1,0,55,0,-55
23079,1,1,147,1664,1517
23080,0,0,70,0,-70
23081,0,0,19,0,-19
23082,0,0,69,0,-69
23083,0,0,42,0,-42
23084,1,0,45,0,-45
23085,1,0,9,0,-9
23086,1,0,42,0,-42
23087,1,1,658,1353,695
23088,1,0,111,0,-111
23089,0,0,55,0,-55
23090,0,0,6,0,-6
23091,1,0,8,0,-8
23092,0,0,46,0,-46
23093,1,0,9,0,-9
23094,0,0,2,0,-2
23095,0,0,77,0,-77
23096,1,1,522,1207,685
23097,1,0,9,0,-9
23098,0,0,5,0,-5
23099,0,0,31,0,-31
23100,1,1,938,1940,1002
23101,1,0,24,0,-24
23102,1,1,674,1398,724
23103,0,0,12,0,-12
23104,0,0,32,0,-32
23105,1,0,24,0,-24
23106,1,0,81,0,-81
23107,0,0,100,0,-100
23108,1,0,50,0,-50
23109,1,0,81,0,-81
23110,1,0,62,0,-62
23111,1,1,2437,1471,-966
23112,0,0,46,0,-46
23113,0,0,10,0,-10
23114,0,0,61,0,-61
23115,0,0,3,0,-3
23116,0,0,48,0,-48
23117,1,0,8,0,-8
23118,0,0,51,0,-51
23119,1,1,448,1338,890
23120,1,1,695,1306,611
23121,1,1,457,1341,884
23122,1,1,668,1690,1022
23123,1,0,47,0,-47
23124,1,0,36,0,-36
23125,0,0,41,0,-41
23126,0,0,87,0,-87
23127,1,0,142,0,-142
23128,0,0,39,0,-39
23129,0,0,45,0,-45
23130,1,0,101,0,-101
23131,1,0,18,0,-18
23132,0,0,35,0,-35
23133,1,1,448,1249,801
23134,0,0,23,0,-23
23135,1,1,665,1414,749
23136,1,1,963,1842,879
23137,0,0,33,0,-33
23138,1,0,84,0,-84
23139,0,0,35,0,-35
23140,0,0,4,0,-4
23141,0,0,49,0,-49
23142,0,0,6,0,-6
23143,0,0,19,0,-19
23144,1,1,171,1532,1361
23145,1,0,9,0,-9
23146,0,0,8,0,-8
23147,1,0,7,0,-7
23148,1,0,28,0,-28
23149,1,1,363,1240,877
23150,1,0,46,0,-46
23151,1,1,260,1476,1216
23152,1,1,496,1326,830
23153,1,1,1768,3137,1369
23154,1,0,45,0,-45
23155,0,0,37,0,-37
23156,1,1,771,1628,857
23157,1,0,49,0,-49
23158,0,0,52,0,-52
23159,0,0,83,0,-83
23160,1,0,36,0,-36
23161,0,0,40,0,-40
23162,1,1,355,1666,1311
23163,0,0,128,0,-128
23164,0,0,198,0,-198
23165,0,0,57,0,-57
23166,1,0,0,0,0
23167,0,0,30,0,-30
23168,0,0,3,0,-3
23169,1,0,79,0,-79
23170,1,1,281,1859,1578
23171,1,1,50,1549,1499
23172,0,0,159,0,-159
23173,1,1,39,2223,2184
23174,1,1,458,1208,750
23175,1,1,210,1580,1370
23176,0,0,24,0,-24
23177,1,1,685,1429,744
23178,0,0,7,0,-7
23179,1,1,220,1693,1473
23180,1,0,44,0,-44
23181,0,0,240,0,-240
23182,1,0,41,0,-41
23183,0,0,8,0,-8
23184,1,0,48,0,-48
23185,1,1,88,1474,1386
23186,1,0,27,0,-27
23187,1,1,983,1612,629
23188,0,0,62,0,-62
23189,0,0,83,0,-83
23190,1,1,301,1498,1197
23191,1,1,444,1320,876
23192,1,0,58,0,-58
23193,0,0,3,0,-3
23194,0,0,183,0,-183
23195,1,0,66,0,-66
23196,0,0,25,0,-25
23197,1,0,13,0,-13
23198,0,0,56,0,-56
23199,1,0,29,0,-29
23200,1,0,55,0,-55
23201,1,1,396,1492,1096
23202,1,0,16,0,-16
23203,1,0,9,0,-9
23204,1,1,880,1575,695
23205,1,1,477,1298,821
23206,0,0,63,0,-63
23207,0,0,71,0,-71
23208,0,0,122,0,-122
23209,0,0,36,0,-36
23210,1,0,8,0,-8
23211,1,0,22,0,-22
23212,0,0,1,0,-1
23213,1,0,19,0,-19
23214,1,1,368,1561,1193
23215,1,1,239,1262,1023
23216,0,0,30,0,-30
23217,0,0,33,0,-33
23218,1,0,82,0,-82
23219,1,0,108,0,-108
23220,0,0,29,0,-29
23221,1,0,91,0,-91
23222,0,0,13,0,-13
23223,0,0,57,0,-57
23224,1,1,64,1329,1265
23225,1,1,328,1411,1083
23226,1,0,31,0,-31
23227,0,0,15,0,-15
23228,1,0,55,0,-55
23229,1,0,55,0,-55
23230,1,1,1250,2305,1055
23231,0,0,0,0,0
23232,1,0,17,0,-17
23233,1,1,160,2086,1926
23234,0,0,48,0,-48
23235,0,0,74,0,-74
23236,1,0,55,0,-55
23237,1,1,128,1264,1136
23238,1,1,27,1456,1429
23239,1,0,14,0,-14
23240,1,0,49,0,-49
23241,1,0,55,0,-55
23242,1,0,4,0,-4
23243,1,0,30,0,-30
23244,1,0,54,0,-54
23245,1,0,24,0,-24
23246,1,1,877,1207,330
23247,1,0,124,0,-124
23248,1,1,526,1237,711
23249,0,0,17,0,-17
23250,0,0,5,0,-5
23251,1,1,301,2358,2057
23252,0,0,87,0,-87
23253,1,0,44,0,-44
23254,0,0,18,0,-18
23255,0,0,29,0,-29
23256,0,0,184,0,-184
23257,0,0,80,0,-80
23258,0,0,5,0,-5
23259,1,1,222,2241,2019
23260,0,0,87,0,-87
23261,1,0,91,0,-91
23262,1,1,181,2025,1844
23263,0,0,93,0,-93
23264,0,0,17,0,-17
23265,1,1,408,1641,1233
23266,0,0,24,0,-24
23267,0,0,40,0,-40
23268,1,0,0,0,0
23269,0,0,19,0,-19
23270,0,0,74,0,-74
23271,1,0,83,0,-83
23272,1,1,1366,1243,-123
23273,1,0,23,0,-23
23274,0,0,9,0,-9
23275,0,0,20,0,-20
23276,0,0,13,0,-13
23277,1,1,23,1406,1383
23278,0,0,56,0,-56
23279,0,0,105,0,-105
23280,1,1,646,1510,864
23281,1,0,40,0,-40
23282,0,0,33,0,-33
23283,1,0,16,0,-16
23284,1,1,1293,1577,284
23285,1,1,848,1634,786
23286,0,0,154,0,-154
23287,1,1,100,1576,1476
23288,1,0,58,0,-58
23289,1,0,56,0,-56
23290,0,0,54,0,-54
23291,1,1,49,1417,1368
23292,1,1,399,1407,1008
23293,1,0,70,0,-70
23294,1,0,16,0,-16
23295,0,0,1,0,-1
23296,1,1,374,1442,1068
23297,1,0,18,0,-18
23298,1,0,38,0,-38
23299,0,0,42,0,-42
23300,0,0,54,0,-54
23301,1,1,1399,1240,-159
23302,0,0,32,0,-32
23303,0,0,156,0,-156
23304,0,0,24,0,-24
23305,1,0,54,0,-54
23306,1,1,647,1247,600
23307,1,1,155,1897,1742
23308,1,1,455,1708,1253
23309,0,0,57,0,-57
23310,0,0,58,0,-58
23311,1,1,160,1587,1427
23312,1,1,2709,1312,-1397
23313,0,0,16,0,-16
23314,1,1,53,2415,2362
23315,1,1,52,1452,1400
23316,1,0,46,0,-46
23317,0,0,101,0,-101
23318,1,0,42,0,-42
23319,1,0,37,0,-37
23320,1,1,101,1215,1114
23321,1,1,336,1832,1496
23322,1,1,1399,1209,-190
23323,1,1,471,1203,732
23324,1,1,444,1215,771
23325,1,1,381,1402,1021
23326,0,0,58,0,-58
23327,1,0,18,0,-18
23328,1,1,1131,1378,247
23329,1,1,789,1406,617
23330,0,0,3,0,-3
23331,0,0,43,0,-43
23332,1,1,346,1362,1016
23333,1,1,298,1248,950
23334,1,0,31,0,-31
23335,0,0,81,0,-81
23336,0,0,54,0,-54
23337,1,1,420,1335,915
23338,0,0,97,0,-97
23339,0,0,51,0,-51
23340,0,0,4,0,-4
23341,1,0,2,0,-2
23342,0,0,58,0,-58
23343,1,1,3741,1256,-2485
23344,1,0,164,0,-164
23345,1,0,80,0,-80
23346,1,1,152,1387,1235
23347,1,0,37,0,-37
23348,0,0,60,0,-60
23349,1,1,194,2163,1969
23350,1,0,27,0,-27
23351,1,0,82,0,-82
23352,0,0,81,0,-81
23353,1,0,64,0,-64
23354,1,1,161,1440,1279
23355,1,0,35,0,-35
23356,1,0,15,0,-15
23357,1,0,0,0,0
23358,1,1,81,1237,1156
23359,1,1,257,1312,1055
23360,1,1,280,1229,949
23361,1,0,11,0,-11
23362,0,0,12,0,-12
23363,0,0,25,0,-25
23364,1,1,120,1289,1169
23365,1,0,70,0,-70
23366,0,0,20,0,-20
23367,1,0,191,0,-191
23368,0,0,29,0,-29
23369,0,0,48,0,-48
23370,0,0,36,0,-36
23371,1,1,131,1406,1275
23372,0,0,161,0,-161
23373,1,0,4,0,-4
23374,0,0,9,0,-9
23375,1,1,3969,1647,-2322
23376,1,1,256,1314,1058
23377,0,0,41,0,-41
23378,1,0,17,0,-17
23379,0,0,51,0,-51
23380,1,0,84,0,-84
23381,1,1,550,1743,1193
23382,0,0,86,0,-86
23383,1,1,230,1337,1107
23384,1,0,51,0,-51
23385,1,0,101,0,-101
23386,1,1,813,1769,956
23387,1,0,20,0,-20
23388,1,0,3,0,-3
23389,0,0,5,0,-5
23390,1,0,51,0,-51
23391,1,0,13,0,-13
23392,1,0,79,0,-79
23393,1,0,39,0,-39
23394,1,0,108,0,-108
23395,1,0,26,0,-26
23396,1,0,44,0,-44
23397,0,0,5,0,-5
23398,0,0,60,0,-60
23399,1,0,5,0,-5
23400,0,0,39,0,-39
23401,1,0,7,0,-7
23402,0,0,127,0,-127
23403,1,1,685,1448,763
23404,0,0,31,0,-31
23405,0,0,65,0,-65
23406,1,0,28,0,-28
23407,0,0,53,0,-53
23408,1,1,499,1433,934
23409,1,0,93,0,-93
23410,1,1,329,1358,1029
23411,1,0,62,0,-62
23412,1,1,1042,1200,158
23413,1,1,272,1238,966
23414,0,0,1,0,-1
23415,1,0,27,0,-27
23416,0,0,317,0,-317
23417,0,0,51,0,-51
23418,0,0,12,0,-12
23419,1,1,226,1841,1615
23420,0,0,41,0,-41
23421,1,0,48,0,-48
23422,1,1,758,1460,702
23423,1,1,376,2663,2287
23424,1,1,1315,1695,380
23425,1,1,585,1421,836
23426,0,0,19,0,-19
23427,0,0,35,0,-35
23428,1,1,265,1308,1043
23429,1,1,92,1807,1715
23430,1,0,30,0,-30
23431,1,0,101,0,-101
23432,0,0,70,0,-70
23433,1,0,3,0,-3
23434,1,1,1200,1268,68
23435,1,1,1963,1373,-590
23436,1,1,611,1270,659
23437,0,0,65,0,-65
23438,1,1,440,1482,1042
23439,0,0,99,0,-99
23440,1,1,119,1223,1104
23441,1,1,457,1622,1165
23442,1,1,5,1323,1318
23443,0,0,41,0,-41
23444,1,0,14,0,-14
23445,1,0,81,0,-81
23446,1,0,56,0,-56
23447,1,1,580,1581,1001
23448,1,1,156,1203,1047
23449,1,0,13,0,-13
23450,0,0,2,0,-2
23451,0,0,15,0,-15
23452,1,1,189,1300,1111
23453,1,1,369,1387,1018
23454,0,0,9,0,-9
23455,1,0,7,0,-7
23456,1,1,445,1744,1299
23457,0,0,9,0,-9
23458,1,1,626,1656,1030
23459,0,0,6,0,-6
23460,1,0,87,0,-87
23461,0,0,24,0,-24
23462,0,0,22,0,-22
23463,1,0,39,0,-39
23464,1,1,717,1202,485
23465,1,0,122,0,-122
23466,1,0,3,0,-3
23467,1,1,532,1383,851
23468,1,1,312,1421,1109
23469,0,0,6,0,-6
23470,1,0,9,0,-9
23471,1,1,503,2005,1502
23472,0,0,41,0,-41
23473,0,0,125,0,-125
23474,1,0,72,0,-72
23475,0,0,49,0,-49
23476,1,0,89,0,-89
23477,1,1,1676,1407,-269
23478,0,0,23,0,-23
23479,1,0,12,0,-12
23480,0,0,111,0,-111
23481,0,0,33,0,-33
23482,1,1,342,1743,1401
23483,1,1,1970,2009,39
23484,0,0,13,0,-13
23485,1,0,29,0,-29
23486,1,0,11,0,-11
23487,1,0,89,0,-89
23488,1,0,15,0,-15
23489,1,1,29,1370,1341
23490,0,0,29,0,-29
23491,1,1,104,1924,1820
23492,1,1,926,2694,1768
23493,1,0,141,0,-141
23494,1,0,20,0,-20
23495,1,1,1073,1497,424
23496,1,0,192,0,-192
23497,1,0,33,0,-33
23498,1,1,503,1220,717
23499,1,0,14,0,-14
23500,0,0,5,0,-5
23501,1,0,33,0,-33
23502,0,0,62,0,-62
23503,0,0,43,0,-43
23504,1,1,1674,2413,739
23505,0,0,122,0,-122
23506,1,1,878,1433,555
23507,1,1,308,1372,1064
23508,1,0,13,0,-13
23509,0,0,36,0,-36
23510,1,1,91,1666,1575
23511,0,0,51,0,-51
23512,0,0,26,0,-26
23513,1,0,1,0,-1
23514,1,0,54,0,-54
23515,1,0,13,0,-13
23516,1,0,40,0,-40
23517,1,0,19,0,-19
23518,1,1,221,1387,1166
23519,0,0,7,0,-7
23520,0,0,15,0,-15
23521,0,0,1,0,-1
23522,0,0,15,0,-15
23523,0,0,117,0,-117
23524,1,0,78,0,-78
23525,0,0,42,0,-42
23526,1,1,517,1330,813
23527,1,0,69,0,-69
23528,1,0,38,0,-38
23529,0,0,38,0,-38
23530,1,0,56,0,-56
23531,0,0,142,0,-142
23532,0,0,25,0,-25
23533,1,0,64,0,-64
23534,0,0,2,0,-2
23535,1,0,11,0,-11
23536,0,0,0,0,0
23537,0,0,0,0,0
23538,1,0,10,0,-10
23539,0,0,49,0,-49
23540,0,0,79,0,-79
23541,1,1,56,1266,1210
23542,0,0,104,0,-104
23543,1,1,798,1320,522
23544,1,1,1181,1518,337
23545,1,1,290,1239,949
23546,1,0,23,0,-23
23547,1,0,41,0,-41
23548,1,0,37,0,-37
23549,1,1,249,1348,1099
23550,1,0,24,0,-24
23551,0,0,104,0,-104
23552,1,1,175,1438,1263
23553,0,0,134,0,-134
23554,0,0,7,0,-7
23555,0,0,20,0,-20
23556,1,0,13,0,-13
23557,0,0,8,0,-8
23558,0,0,46,0,-46
23559,1,0,12,0,-12
23560,0,0,200,0,-200
23561,0,0,95,0,-95
23562,1,1,846,1201,355
23563,0,0,30,0,-30
23564,1,0,11,0,-11
23565,0,0,111,0,-111
23566,1,1,863,1200,337
23567,0,0,3,0,-3
23568,0,0,61,0,-61
23569,1,0,65,0,-65
23570,1,0,22,0,-22
23571,1,0,30,0,-30
23572,0,0,21,0,-21
23573,1,0,61,0,-61
23574,1,1,1570,1307,-263
23575,0,0,19,0,-19
23576,0,0,84,0,-84
23577,0,0,35,0,-35
23578,1,0,61,0,-61
23579,0,0,24,0,-24
23580,1,0,109,0,-109
23581,1,1,219,1251,1032
23582,1,1,196,1301,1105
23583,0,0,18,0,-18
23584,1,0,40,0,-40
23585,1,1,233,1548,1315
23586,1,1,673,1866,1193
23587,0,0,107,0,-107
23588,1,0,34,0,-34
23589,1,0,158,0,-158
23590,1,0,4,0,-4
23591,0,0,9,0,-9
23592,1,0,141,0,-141
23593,0,0,76,0,-76
23594,1,1,922,1770,848
23595,1,0,9,0,-9
23596,0,0,161,0,-161
23597,1,1,744,1261,517
23598,1,0,25,0,-25
23599,0,0,35,0,-35
23600,0,0,10,0,-10
23601,0,0,18,0,-18
23602,1,1,671,2061,1390
23603,1,0,39,0,-39
23604,1,0,270,0,-270
23605,1,0,84,0,-84
23606,0,0,4,0,-4
23607,0,0,39,0,-39
23608,1,0,27,0,-27
23609,1,0,86,0,-86
23610,1,1,229,1415,1186
23611,1,1,438,1278,840
23612,1,0,19,0,-19
23613,1,0,25,0,-25
23614,1,0,77,0,-77
23615,1,0,49,0,-49
23616,0,0,108,0,-108
23617,0,0,0,0,0
23618,1,1,827,2288,1461
23619,0,0,56,0,-56
23620,1,1,810,1226,416
23621,1,1,591,1366,775
23622,0,0,8,0,-8
23623,0,0,159,0,-159
23624,0,0,16,0,-16
23625,0,0,23,0,-23
23626,1,0,7,0,-7
23627,1,0,159,0,-159
23628,0,0,25,0,-25
23629,1,0,103,0,-103
23630,0,0,1,0,-1
23631,1,1,1534,1556,22
23632,0,0,166,0,-166
23633,1,1,116,1337,1221
23634,1,1,218,1264,1046
23635,0,0,58,0,-58
23636,1,0,37,0,-37
23637,0,0,21,0,-21
23638,1,1,1618,1385,-233
23639,1,0,46,0,-46
23640,1,1,84,1325,1241
23641,0,0,35,0,-35
23642,0,0,22,0,-22
23643,0,0,59,0,-59
23644,1,0,113,0,-113
23645,1,0,168,0,-168
23646,0,0,141,0,-141
23647,1,0,1,0,-1
23648,1,1,232,1250,1018
23649,0,0,83,0,-83
23650,1,0,152,0,-152
23651,0,0,18,0,-18
23652,0,0,5,0,-5
23653,0,0,69,0,-69
23654,1,1,817,1429,612
23655,0,0,9,0,-9
23656,0,0,6,0,-6
23657,0,0,62,0,-62
23658,0,0,0,0,0
23659,1,1,657,1370,713
23660,0,0,11,0,-11
23661,0,0,74,0,-74
23662,1,0,0,0,0
23663,1,0,29,0,-29
23664,0,0,51,0,-51
23665,1,0,19,0,-19
23666,0,0,18,0,-18
23667,1,0,23,0,-23
23668,1,0,62,0,-62
23669,0,0,178,0,-178
23670,0,0,5,0,-5
23671,1,1,840,1208,368
23672,0,0,11,0,-11
23673,0,0,8,0,-8
23674,1,1,547,1665,1118
23675,1,0,4,0,-4
23676,0,0,14,0,-14
23677,1,1,81,2348,2267
23678,0,0,77,0,-77
23679,1,0,7,0,-7
23680,1,0,21,0,-21
23681,1,0,6,0,-6
23682,1,0,0,0,0
23683,1,1,40,1205,1165
23684,0,0,13,0,-13
23685,1,1,602,1628,1026
23686,1,1,859,1293,434
23687,1,0,4,0,-4
23688,0,0,56,0,-56
23689,1,1,158,1664,1506
23690,1,1,649,1372,723
23691,0,0,41,0,-41
23692,0,0,21,0,-21
23693,1,0,62,0,-62
23694,0,0,36,0,-36
23695,1,0,70,0,-70
23696,0,0,73,0,-73
23697,1,1,340,2596,2256
23698,0,0,2,0,-2
23699,0,0,2,0,-2
23700,0,0,55,0,-55
23701,0,0,7,0,-7
23702,1,0,22,0,-22
23703,1,1,356,1209,853
23704,1,1,405,1403,998
23705,1,1,84,1458,1374
23706,1,0,84,0,-84
23707,0,0,48,0,-48
23708,0,0,10,0,-10
23709,0,0,5,0,-5
23710,0,0,5,0,-5
23711,1,0,77,0,-77
23712,0,0,21,0,-21
23713,1,0,41,0,-41
23714,1,0,22,0,-22
23715,1,0,40,0,-40
23716,1,0,47,0,-47
23717,0,0,96,0,-96
23718,0,0,55,0,-55
23719,0,0,36,0,-36
23720,0,0,7,0,-7
23721,0,0,86,0,-86
23722,1,1,333,1223,890
23723,1,1,1346,3452,2106
23724,0,0,47,0,-47
23725,1,0,100,0,-100
23726,1,0,19,0,-19
23727,0,0,63,0,-63
23728,0,0,8,0,-8
23729,1,0,11,0,-11
23730,0,0,16,0,-16
23731,0,0,4,0,-4
23732,1,1,777,3120,2343
23733,1,0,45,0,-45
23734,0,0,59,0,-59
23735,0,0,18,0,-18
23736,1,0,25,0,-25
23737,1,1,2636,1301,-1335
23738,0,0,18,0,-18
23739,1,1,399,1225,826
23740,1,1,309,2266,1957
23741,1,1,236,1545,1309
23742,1,0,35,0,-35
23743,1,1,860,1204,344
23744,1,1,105,1470,1365
23745,0,0,49,0,-49
23746,1,1,1417,1896,479
23747,0,0,33,0,-33
23748,1,1,149,1287,1138
23749,1,1,810,1285,475
23750,0,0,5,0,-5
23751,1,1,483,1660,1177
23752,0,0,45,0,-45
23753,0,0,1,0,-1
23754,1,0,9,0,-9
23755,1,0,22,0,-22
23756,1,1,767,1771,1004
23757,1,0,117,0,-117
23758,1,0,96,0,-96
23759,1,1,641,1437,796
23760,1,1,98,1241,1143
23761,0,0,37,0,-37
23762,1,1,306,1451,1145
23763,1,0,31,0,-31
23764,0,0,17,0,-17
23765,0,0,46,0,-46
23766,1,0,93,0,-93
23767,1,0,116,0,-116
23768,1,1,478,1385,907
23769,0,0,27,0,-27
23770,1,1,1331,1611,280
23771,1,1,418,1583,1165
23772,0,0,100,0,-100
23773,1,0,152,0,-152
23774,1,0,10,0,-10
23775,1,1,259,1376,1117
23776,0,0,52,0,-52
23777,1,0,2,0,-2
23778,1,0,27,0,-27
23779,0,0,166,0,-166
23780,1,1,825,2473,1648
23781,0,0,99,0,-99
23782,0,0,104,0,-104
23783,1,1,323,1294,971
23784,0,0,4,0,-4
23785,1,1,1865,1331,-534
23786,0,0,9,0,-9
23787,0,0,12,0,-12
23788,0,0,16,0,-16
23789,0,0,21,0,-21
23790,0,0,44,0,-44
23791,1,1,79,1900,1821
23792,1,1,350,1426,1076
23793,1,1,428,1301,873
23794,1,0,7,0,-7
23795,1,0,158,0,-158
23796,0,0,1,0,-1
23797,1,1,869,1307,438
23798,1,0,11,0,-11
23799,1,1,229,1387,1158
23800,0,0,7,0,-7
23801,0,0,28,0,-28
23802,0,0,26,0,-26
23803,0,0,35,0,-35
23804,1,0,10,0,-10
23805,0,0,7,0,-7
23806,1,0,24,0,-24
23807,1,1,1195,2361,1166
23808,0,0,9,0,-9
23809,1,0,63,0,-63
23810,0,0,14,0,-14
23811,0,0,105,0,-105
23812,1,1,1284,1224,-60
23813,0,0,29,0,-29
23814,1,0,16,0,-16
23815,0,0,78,0,-78
23816,0,0,14,0,-14
23817,0,0,36,0,-36
23818,0,0,20,0,-20
23819,1,0,11,0,-11
23820,0,0,160,0,-160
23821,0,0,21,0,-21
23822,1,1,78,1735,1657
23823,1,0,27,0,-27
23824,1,1,1056,1411,355
23825,0,0,21,0,-21
23826,1,1,16,1258,1242
23827,1,0,256,0,-256
23828,1,0,9,0,-9
23829,1,1,258,2201,1943
23830,1,0,128,0,-128
23831,0,0,68,0,-68
23832,1,1,227,1236,1009
23833,1,0,11,0,-11
23834,0,0,93,0,-93
23835,0,0,58,0,-58
23836,1,1,123,1389,1266
23837,1,1,459,1248,789
23838,1,1,1062,1430,368
23839,1,1,202,1783,1581
23840,1,0,51,0,-51
23841,1,1,10,1767,1757
23842,0,0,94,0,-94
23843,1,1,418,1399,981
23844,1,1,431,1475,1044
23845,0,0,11,0,-11
23846,1,0,10,0,-10
23847,0,0,8,0,-8
23848,0,0,24,0,-24
23849,0,0,19,0,-19
23850,0,0,3,0,-3
23851,1,0,0,0,0
23852,0,0,62,0,-62
23853,0,0,17,0,-17
23854,1,1,362,2431,2069
23855,0,0,85,0,-85
23856,0,0,5,0,-5
23857,0,0,12,0,-12
23858,1,0,74,0,-74
23859,1,1,596,1715,1119
23860,1,0,93,0,-93
23861,1,1,269,1417,1148
23862,1,1,1298,1552,254
23863,0,0,16,0,-16
23864,0,0,102,0,-102
23865,1,1,1655,1729,74
23866,1,1,1310,1231,-79
23867,1,0,58,0,-58
23868,1,0,7,0,-7
23869,1,1,131,1570,1439
23870,1,0,108,0,-108
23871,1,1,1266,1363,97
23872,1,0,83,0,-83
23873,1,0,17,0,-17
23874,1,0,34,0,-34
23875,1,1,645,1250,605
23876,0,0,109,0,-109
23877,1,0,11,0,-11
23878,0,0,9,0,-9
23879,0,0,47,0,-47
23880,1,1,483,1259,776
23881,1,0,31,0,-31
23882,0,0,173,0,-173
23883,0,0,124,0,-124
23884,1,1,168,1328,1160
23885,0,0,81,0,-81
23886,1,1,646,1557,911
23887,1,0,10,0,-10
23888,1,1,434,1334,900
23889,1,1,228,1773,1545
23890,1,0,120,0,-120
23891,1,1,690,2152,1462
23892,0,0,4,0,-4
23893,1,0,7,0,-7
23894,0,0,6,0,-6
23895,1,0,1,0,-1
23896,1,1,165,1493,1328
23897,0,0,101,0,-101
23898,0,0,227,0,-227
23899,1,0,25,0,-25
23900,0,0,187,0,-187
23901,1,1,2124,1394,-730
23902,0,0,0,0,0
23903,1,1,135,1282,1147
23904,0,0,69,0,-69
23905,1,0,44,0,-44
23906,0,0,31,0,-31
23907,0,0,47,0,-47
23908,1,0,78,0,-78
23909,1,1,374,1746,1372
23910,0,0,95,0,-95
23911,1,1,283,2376,2093
23912,1,1,365,1210,845
23913,1,0,5,0,-5
23914,0,0,44,0,-44
23915,0,0,88,0,-88
23916,0,0,36,0,-36
23917,0,0,52,0,-52
23918,1,0,42,0,-42
23919,0,0,4,0,-4
23920,0,0,40,0,-40
23921,1,1,76,1468,1392
23922,1,0,0,0,0
23923,1,0,36,0,-36
23924,1,0,30,0,-30
23925,0,0,7,0,-7
23926,1,1,197,1211,1014
23927,1,0,25,0,-25
23928,0,0,13,0,-13
23929,1,1,1182,1225,43
23930,1,0,70,0,-70
23931,1,1,51,1458,1407
23932,1,0,5,0,-5
23933,0,0,80,0,-80
23934,0,0,28,0,-28
23935,0,0,41,0,-41
23936,0,0,48,0,-48
23937,0,0,2,0,-2
23938,1,1,214,2153,1939
23939,1,0,26,0,-26
23940,1,0,52,0,-52
23941,1,0,158,0,-158
23942,1,1,224,2882,2658
23943,1,0,108,0,-108
23944,1,1,810,1693,883
23945,0,0,2,0,-2
23946,0,0,67,0,-67
23947,0,0,0,0,0
23948,0,0,62,0,-62
23949,1,1,898,1248,350
23950,1,0,74,0,-74
23951,1,1,338,1433,1095
23952,1,0,11,0,-11
23953,0,0,41,0,-41
23954,1,1,1674,1429,-245
23955,1,1,157,1228,1071
23956,1,1,994,1539,545
23957,0,0,153,0,-153
23958,1,0,28,0,-28
23959,1,0,11,0,-11
23960,1,0,21,0,-21
23961,0,0,6,0,-6
23962,1,1,483,1710,1227
23963,0,0,3,0,-3
23964,1,1,794,1283,489
23965,1,1,1812,1390,-422
23966,1,1,897,1587,690
23967,0,0,81,0,-81
23968,0,0,30,0,-30
23969,1,0,54,0,-54
23970,0,0,46,0,-46
23971,1,0,22,0,-22
23972,1,1,98,1228,1130
23973,1,1,174,1648,1474
23974,1,0,115,0,-115
23975,1,1,476,1412,936
23976,1,0,46,0,-46
23977,1,0,7,0,-7
23978,1,0,105,0,-105
23979,0,0,98,0,-98
23980,1,1,355,1225,870
23981,0,0,72,0,-72
23982,1,0,3,0,-3
23983,1,0,117,0,-117
23984,1,0,3,0,-3
23985,1,0,113,0,-113
23986,0,0,59,0,-59
23987,1,1,271,1289,1018
23988,1,0,78,0,-78
23989,1,1,325,1268,943
23990,1,1,908,1405,497
23991,0,0,172,0,-172
23992,0,0,8,0,-8
23993,1,0,27,0,-27
23994,1,1,888,1440,552
23995,0,0,17,0,-17
23996,0,0,73,0,-73
23997,1,0,125,0,-125
23998,0,0,11,0,-11
23999,1,0,44,0,-44
24000,1,1,152,1345,1193
24001,1,0,103,0,-103
24002,1,0,26,0,-26
24003,0,0,93,0,-93
24004,1,1,543,1291,748
24005,1,1,439,1735,1296
24006,0,0,51,0,-51
24007,0,0,77,0,-77
24008,1,0,3,0,-3
24009,1,1,537,1260,723
24010,1,0,30,0,-30
24011,1,1,712,1373,661
24012,1,0,15,0,-15
24013,1,1,319,1227,908
24014,0,0,15,0,-15
24015,1,0,17,0,-17
24016,0,0,9,0,-9
24017,0,0,10,0,-10
24018,0,0,64,0,-64
24019,1,0,53,0,-53
24020,1,1,460,3975,3515
24021,1,0,77,0,-77
24022,0,0,52,0,-52
24023,1,1,721,1792,1071
24024,0,0,4,0,-4
24025,1,1,451,1717,1266
24026,0,0,82,0,-82
24027,1,1,243,2470,2227
24028,1,0,8,0,-8
24029,0,0,75,0,-75
24030,1,0,10,0,-10
24031,0,0,72,0,-72
24032,1,1,547,1471,924
24033,0,0,7,0,-7
24034,1,0,41,0,-41
24035,1,1,279,1297,1018
24036,1,1,325,1360,1035
24037,0,0,36,0,-36
24038,0,0,8,0,-8
24039,1,1,419,1730,1311
24040,0,0,28,0,-28
24041,1,1,317,1398,1081
24042,0,0,168,0,-168
24043,1,1,932,1223,291
24044,1,1,1444,1205,-239
24045,1,0,9,0,-9
24046,1,1,759,1892,1133
24047,1,1,896,1308,412
24048,1,0,58,0,-58
24049,1,1,744,1215,471
24050,1,1,2092,1584,-508
24051,0,0,12,0,-12
24052,0,0,48,0,-48
24053,1,1,320,1556,1236
24054,0,0,11,0,-11
24055,0,0,15,0,-15
24056,1,1,52,1823,1771
24057,0,0,17,0,-17
24058,0,0,98,0,-98
24059,0,0,22,0,-22
24060,0,0,85,0,-85
24061,0,0,40,0,-40
24062,1,1,1125,1208,83
24063,0,0,34,0,-34
24064,1,0,46,0,-46
24065,1,0,90,0,-90
24066,0,0,35,0,-35
24067,1,0,152,0,-152
24068,1,1,775,1818,1043
24069,0,0,42,0,-42
24070,1,1,485,1331,846
24071,1,0,34,0,-34
24072,1,0,5,0,-5
24073,0,0,5,0,-5
24074,1,1,566,1511,945
24075,1,1,394,1267,873
24076,0,0,178,0,-178
24077,0,0,48,0,-48
24078,0,0,141,0,-141
24079,0,0,5,0,-5
24080,0,0,1,0,-1
24081,1,0,146,0,-146
24082,0,0,20,0,-20
24083,1,0,88,0,-88
24084,1,0,22,0,-22
24085,0,0,62,0,-62
24086,1,0,133,0,-133
24087,0,0,39,0,-39
24088,0,0,9,0,-9
24089,0,0,66,0,-66
24090,1,1,2571,2371,-200
24091,0,0,129,0,-129
24092,1,1,765,1346,581
24093,0,0,75,0,-75
24094,0,0,51,0,-51
24095,0,0,169,0,-169
24096,0,0,31,0,-31
24097,0,0,5,0,-5
24098,1,1,328,1699,1371
24099,1,1,841,1723,882
24100,1,0,13,0,-13
24101,0,0,70,0,-70
24102,0,0,11,0,-11
24103,0,0,0,0,0
24104,1,1,118,2248,2130
24105,0,0,99,0,-99
24106,0,0,31,0,-31
24107,1,1,1539,1847,308
24108,0,0,71,0,-71
24109,1,0,79,0,-79
24110,1,1,581,1392,811
24111,0,0,18,0,-18
24112,1,1,134,1817,1683
24113,1,1,975,1265,290
24114,1,0,11,0,-11
24115,1,1,106,2473,2367
24116,1,0,49,0,-49
24117,0,0,32,0,-32
24118,1,1,37,1815,1778
24119,0,0,75,0,-75
24120,1,0,10,0,-10
24121,1,1,882,1477,595
24122,0,0,7,0,-7
24123,1,0,6,0,-6
24124,0,0,77,0,-77
24125,0,0,16,0,-16
24126,0,0,23,0,-23
24127,1,0,43,0,-43
24128,1,0,10,0,-10
24129,0,0,15,0,-15
24130,0,0,96,0,-96
24131,1,0,54,0,-54
24132,1,0,18,0,-18
24133,1,0,1,0,-1
24134,1,0,16,0,-16
24135,1,0,27,0,-27
24136,0,0,112,0,-112
24137,0,0,1,0,-1
24138,0,0,3,0,-3
24139,0,0,129,0,-129
24140,0,0,5,0,-5
24141,1,1,92,1260,1168
24142,1,1,115,4639,4524
24143,1,1,55,1464,1409
24144,1,1,1069,1424,355
24145,0,0,42,0,-42
24146,0,0,150,0,-150
24147,1,0,34,0,-34
24148,1,0,197,0,-197
24149,1,1,449,2229,1780
24150,1,0,84,0,-84
24151,0,0,182,0,-182
24152,1,0,37,0,-37
24153,1,0,13,0,-13
24154,0,0,138,0,-138
24155,1,0,18,0,-18
24156,1,0,31,0,-31
24157,1,1,205,1743,1538
24158,1,1,127,2578,2451
24159,1,0,72,0,-72
24160,1,0,129,0,-129
24161,1,1,386,1295,909
24162,0,0,114,0,-114
24163,1,0,37,0,-37
24164,0,0,99,0,-99
24165,0,0,29,0,-29
24166,1,1,591,1335,744
24167,0,0,51,0,-51
24168,1,0,4,0,-4
24169,1,1,386,1585,1199
24170,1,0,25,0,-25
24171,1,0,14,0,-14
24172,0,0,109,0,-109
24173,0,0,65,0,-65
24174,0,0,2,0,-2
24175,1,0,132,0,-132
24176,0,0,64,0,-64
24177,1,1,909,2899,1990
24178,0,0,13,0,-13
24179,0,0,145,0,-145
24180,0,0,26,0,-26
24181,0,0,28,0,-28
24182,1,1,906,2228,1322
24183,1,1,137,2433,2296
24184,1,1,848,1210,362
24185,1,1,801,1334,533
24186,1,0,20,0,-20
24187,1,0,11,0,-11
24188,1,1,520,1326,806
24189,1,1,644,1398,754
24190,1,1,213,1378,1165
24191,1,1,280,1422,1142
24192,1,1,3024,2108,-916
24193,0,0,123,0,-123
24194,1,0,40,0,-40
24195,1,1,439,1364,925
24196,1,0,16,0,-16
24197,1,0,35,0,-35
24198,0,0,91,0,-91
24199,0,0,44,0,-44
24200,1,1,528,2332,1804
24201,1,1,58,1537,1479
24202,1,1,782,1292,510
24203,1,0,88,0,-88
24204,1,1,437,1790,1353
24205,1,0,61,0,-61
24206,1,0,92,0,-92
24207,0,0,34,0,-34
24208,1,1,135,1229,1094
24209,1,0,2,0,-2
24210,1,0,2,0,-2
24211,1,1,37,2603,2566
24212,1,0,13,0,-13
24213,1,0,43,0,-43
24214,1,1,117,1237,1120
24215,0,0,170,0,-170
24216,1,0,11,0,-11
24217,0,0,42,0,-42
24218,1,1,29,1208,1179
24219,0,0,39,0,-39
24220,0,0,244,0,-244
24221,1,1,296,1212,916
24222,1,0,81,0,-81
24223,1,1,231,1519,1288
24224,1,1,98,1672,1574
24225,0,0,96,0,-96
24226,1,1,115,1315,1200
24227,1,0,24,0,-24
24228,1,1,2043,1599,-444
24229,1,0,107,0,-107
24230,1,1,135,1444,1309
24231,1,0,180,0,-180
24232,1,0,52,0,-52
24233,0,0,76,0,-76
24234,0,0,43,0,-43
24235,0,0,62,0,-62
24236,1,1,189,1375,1186
24237,0,0,76,0,-76
24238,1,1,115,1532,1417
24239,1,1,102,1335,1233
24240,1,0,53,0,-53
24241,1,1,199,1930,1731
24242,1,0,16,0,-16
24243,0,0,102,0,-102
24244,0,0,18,0,-18
24245,1,0,13,0,-13
24246,0,0,63,0,-63
24247,0,0,12,0,-12
24248,0,0,16,0,-16
24249,0,0,10,0,-10
24250,1,1,568,1266,698
24251,1,1,170,1863,1693
24252,0,0,12,0,-12
24253,0,0,38,0,-38
24254,0,0,0,0,0
24255,0,0,13,0,-13
24256,1,1,545,7749,7204
24257,1,0,0,0,0
24258,0,0,22,0,-22
24259,1,1,198,2032,1834
24260,0,0,131,0,-131
24261,0,0,15,0,-15
24262,1,1,205,1213,1008
24263,0,0,31,0,-31
24264,0,0,189,0,-189
24265,0,0,36,0,-36
24266,0,0,19,0,-19
24267,0,0,26,0,-26
24268,1,1,872,1977,1105
24269,1,1,444,1298,854
24270,0,0,21,0,-21
24271,1,0,3,0,-3
24272,0,0,11,0,-11
24273,1,0,27,0,-27
24274,1,0,36,0,-36
24275,0,0,13,0,-13
24276,1,0,84,0,-84
24277,1,0,47,0,-47
24278,1,0,207,0,-207
24279,1,0,31,0,-31
24280,1,1,522,1824,1302
24281,0,0,7,0,-7
24282,1,1,598,1529,931
24283,1,0,26,0,-26
24284,0,0,95,0,-95
24285,1,0,39,0,-39
24286,0,0,102,0,-102
24287,0,0,26,0,-26
24288,0,0,89,0,-89
24289,0,0,35,0,-35
24290,1,0,50,0,-50
24291,1,1,1923,1370,-553
24292,1,0,6,0,-6
24293,0,0,69,0,-69
24294,1,1,1875,1334,-541
24295,1,0,85,0,-85
24296,0,0,73,0,-73
24297,0,0,62,0,-62
24298,0,0,5,0,-5
24299,1,0,11,0,-11
24300,1,1,278,1222,944
24301,1,0,3,0,-3
24302,1,0,24,0,-24
24303,1,0,61,0,-61
24304,1,1,669,1242,573
24305,1,0,15,0,-15
24306,0,0,15,0,-15
24307,0,0,4,0,-4
24308,1,0,2,0,-2
24309,0,0,62,0,-62
24310,1,1,914,1312,398
24311,1,0,82,0,-82
24312,1,1,165,1223,1058
24313,1,1,1033,1887,854
24314,0,0,32,0,-32
24315,1,1,1429,1768,339
24316,1,1,1585,2091,506
24317,1,1,229,1465,1236
24318,1,0,44,0,-44
24319,0,0,32,0,-32
24320,0,0,41,0,-41
24321,1,0,13,0,-13
24322,1,0,12,0,-12
24323,1,0,104,0,-104
24324,0,0,30,0,-30
24325,1,1,141,1289,1148
24326,1,1,233,1665,1432
24327,1,0,34,0,-34
24328,0,0,20,0,-20
24329,1,1,132,1201,1069
24330,1,0,94,0,-94
24331,0,0,27,0,-27
24332,1,0,31,0,-31
24333,1,1,13,1314,1301
24334,0,0,49,0,-49
24335,1,1,458,2300,1842
24336,1,1,379,1341,962
24337,1,1,857,5321,4464
24338,0,0,30,0,-30
24339,1,1,942,3735,2793
24340,1,1,103,1247,1144
24341,0,0,50,0,-50
24342,0,0,9,0,-9
24343,1,1,159,1767,1608
24344,1,0,104,0,-104
24345,1,1,150,1286,1136
24346,0,0,0,0,0
24347,1,0,27,0,-27
24348,1,0,64,0,-64
24349,0,0,7,0,-7
24350,1,0,40,0,-40
24351,0,0,31,0,-31
24352,0,0,0,0,0
24353,1,1,199,1756,1557
24354,1,0,53,0,-53
24355,1,1,374,1834,1460
24356,0,0,15,0,-15
24357,0,0,60,0,-60
24358,0,0,31,0,-31
24359,0,0,5,0,-5
24360,1,1,123,1247,1124
24361,1,0,9,0,-9
24362,1,1,112,1635,1523
24363,1,0,93,0,-93
24364,1,0,19,0,-19
24365,0,0,1,0,-1
24366,0,0,183,0,-183
24367,1,1,992,1283,291
24368,1,0,22,0,-22
24369,1,0,63,0,-63
24370,1,1,2853,2227,-626
24371,1,0,13,0,-13
24372,1,1,286,1323,1037
24373,0,0,1,0,-1
24374,0,0,44,0,-44
24375,1,1,637,1816,1179
24376,1,1,472,1278,806
24377,0,0,12,0,-12
24378,0,0,11,0,-11
24379,0,0,11,0,-11
24380,1,0,86,0,-86
24381,0,0,39,0,-39
24382,1,1,283,1270,987
24383,0,0,97,0,-97
24384,1,0,143,0,-143
24385,0,0,246,0,-246
24386,1,1,632,1388,756
24387,1,1,295,1229,934
24388,1,1,724,2181,1457
24389,1,0,123,0,-123
24390,1,1,623,1326,703
24391,1,1,520,1677,1157
24392,1,0,43,0,-43
24393,0,0,10,0,-10
24394,0,0,46,0,-46
24395,1,0,28,0,-28
24396,0,0,17,0,-17
24397,1,1,311,2322,2011
24398,1,0,50,0,-50
24399,0,0,73,0,-73
24400,1,0,8,0,-8
24401,1,0,59,0,-59
24402,0,0,9,0,-9
24403,1,1,653,1494,841
24404,1,1,309,1855,1546
24405,1,1,656,1698,1042
24406,1,1,2059,1279,-780
24407,1,1,576,1269,693
24408,1,1,253,1214,961
24409,0,0,9,0,-9
24410,0,0,28,0,-28
24411,0,0,21,0,-21
24412,1,0,126,0,-126
24413,0,0,523,0,-523
24414,0,0,107,0,-107
24415,0,0,34,0,-34
24416,1,0,115,0,-115
24417,0,0,87,0,-87
24418,1,1,380,1527,1147
24419,1,0,63,0,-63
24420,0,0,20,0,-20
24421,1,1,667,1416,749
24422,1,0,39,0,-39
24423,1,0,3,0,-3
24424,0,0,13,0,-13
24425,1,0,8,0,-8
24426,1,1,177,2108,1931
24427,0,0,125,0,-125
24428,1,1,911,1234,323
24429,0,0,28,0,-28
24430,1,0,19,0,-19
24431,1,1,582,1886,1304
24432,0,0,44,0,-44
24433,0,0,10,0,-10
24434,1,0,1,0,-1
24435,0,0,69,0,-69
24436,1,1,450,1499,1049
24437,1,1,878,1280,402
24438,0,0,83,0,-83
24439,0,0,26,0,-26
24440,1,1,103,1216,1113
24441,1,1,167,1200,1033
24442,1,1,388,1203,815
24443,1,1,1061,1295,234
24444,1,1,561,1332,771
24445,1,1,76,1375,1299
24446,1,0,38,0,-38
24447,0,0,51,0,-51
24448,0,0,39,0,-39
24449,1,1,1268,1217,-51
24450,1,0,70,0,-70
24451,0,0,96,0,-96
24452,0,0,25,0,-25
24453,1,1,1089,4010,2921
24454,1,1,332,3081,2749
24455,1,0,13,0,-13
24456,1,0,111,0,-111
24457,0,0,48,0,-48
24458,1,1,1197,1836,639
24459,1,0,191,0,-191
24460,0,0,75,0,-75
24461,0,0,41,0,-41
24462,0,0,62,0,-62
24463,1,0,37,0,-37
24464,1,1,187,1729,1542
24465,0,0,94,0,-94
24466,0,0,116,0,-116
24467,1,1,1689,1666,-23
24468,1,1,166,1545,1379
24469,0,0,41,0,-41
24470,1,1,145,1225,1080
24471,1,1,365,1298,933
24472,1,0,57,0,-57
24473,0,0,13,0,-13
24474,1,0,9,0,-9
24475,0,0,9,0,-9
24476,0,0,35,0,-35
24477,1,1,1319,1552,233
24478,1,0,129,0,-129
24479,0,0,17,0,-17
24480,0,0,46,0,-46
24481,1,1,410,1659,1249
24482,1,0,9,0,-9
24483,1,1,328,2148,1820
24484,1,1,573,1600,1027
24485,0,0,100,0,-100
24486,0,0,35,0,-35
24487,1,0,2,0,-2
24488,1,1,23,1231,1208
24489,0,0,8,0,-8
24490,0,0,7,0,-7
24491,1,1,363,1207,844
24492,0,0,47,0,-47
24493,1,1,685,1450,765
24494,0,0,28,0,-28
24495,0,0,104,0,-104
24496,1,0,24,0,-24
24497,1,1,216,1248,1032
24498,0,0,55,0,-55
24499,0,0,21,0,-21
24500,1,1,91,1301,1210
24501,1,1,435,1315,880
24502,1,1,716,1702,986
24503,1,0,52,0,-52
24504,1,1,207,1551,1344
24505,0,0,6,0,-6
24506,1,1,108,1474,1366
24507,1,0,43,0,-43
24508,0,0,182,0,-182
24509,1,1,406,1634,1228
24510,1,1,3618,1584,-2034
24511,0,0,44,0,-44
24512,0,0,14,0,-14
24513,0,0,71,0,-71
24514,1,1,431,1548,1117
24515,0,0,26,0,-26
24516,1,1,184,1811,1627
24517,1,0,20,0,-20
24518,1,1,112,1698,1586
24519,1,0,57,0,-57
24520,1,0,48,0,-48
24521,1,0,17,0,-17
24522,0,0,0,0,0
24523,0,0,39,0,-39
24524,1,0,71,0,-71
24525,1,0,28,0,-28
24526,0,0,105,0,-105
24527,1,0,154,0,-154
24528,1,0,6,0,-6
24529,1,0,17,0,-17
24530,1,1,106,1670,1564
24531,1,1,680,1448,768
24532,1,0,16,0,-16
24533,1,0,59,0,-59
24534,0,0,8,0,-8
24535,1,0,16,0,-16
24536,1,0,73,0,-73
24537,0,0,60,0,-60
24538,1,0,18,0,-18
24539,1,1,87,1230,1143
24540,1,0,36,0,-36
24541,0,0,237,0,-237
24542,1,0,76,0,-76
24543,1,1,486,1688,1202
24544,1,0,223,0,-223
24545,1,1,198,1313,1115
24546,1,1,692,1239,547
24547,0,0,231,0,-231
24548,0,0,92,0,-92
24549,1,0,3,0,-3
24550,1,1,285,1229,944
24551,0,0,45,0,-45
24552,0,0,4,0,-4
24553,1,0,109,0,-109
24554,1,1,703,2119,1416
24555,1,1,418,1244,826
24556,0,0,5,0,-5
24557,0,0,7,0,-7
24558,1,0,1,0,-1
24559,1,0,53,0,-53
24560,1,1,42,1270,1228
24561,1,1,568,1536,968
24562,0,0,18,0,-18
24563,0,0,50,0,-50
24564,1,0,59,0,-59
24565,1,1,888,1357,469
24566,0,0,19,0,-19
24567,0,0,34,0,-34
24568,0,0,9,0,-9
24569,0,0,17,0,-17
24570,0,0,3,0,-3
24571,1,1,1167,2295,1128
24572,0,0,97,0,-97
24573,1,1,1051,1375,324
24574,1,0,19,0,-19
24575,1,1,251,1516,1265
24576,1,0,70,0,-70
24577,1,0,28,0,-28
24578,0,0,84,0,-84
24579,1,0,30,0,-30
24580,1,0,132,0,-132
24581,1,1,1104,3665,2561
24582,0,0,31,0,-31
24583,1,0,35,0,-35
24584,0,0,51,0,-51
24585,1,1,376,1363,987
24586,1,1,1218,2160,942
24587,0,0,71,0,-71
24588,0,0,25,0,-25
24589,0,0,13,0,-13
24590,1,0,5,0,-5
24591,1,1,1020,1329,309
24592,0,0,25,0,-25
24593,1,1,279,1713,1434
24594,1,1,49,1877,1828
24595,0,0,127,0,-127
24596,0,0,72,0,-72
24597,0,0,20,0,-20
24598,1,1,273,1350,1077
24599,1,1,1018,1271,253
24600,1,1,400,1389,989
24601,1,1,74,2213,2139
24602,0,0,17,0,-17
24603,1,1,143,1748,1605
24604,1,1,145,1236,1091
24605,0,0,17,0,-17
24606,1,1,97,1438,1341
24607,1,0,39,0,-39
24608,1,0,11,0,-11
24609,1,0,18,0,-18
24610,0,0,59,0,-59
24611,1,1,542,1343,801
24612,0,0,24,0,-24
24613,1,1,724,1224,500
24614,1,0,11,0,-11
24615,0,0,119,0,-119
24616,1,1,1139,1545,406
24617,0,0,111,0,-111
24618,0,0,90,0,-90
24619,0,0,1,0,-1
24620,1,1,303,2085,1782
24621,1,0,12,0,-12
24622,1,0,13,0,-13
24623,1,0,68,0,-68
24624,0,0,34,0,-34
24625,1,0,46,0,-46
24626,1,1,260,1276,1016
24627,1,0,133,0,-133
24628,1,0,2,0,-2
24629,0,0,18,0,-18
24630,1,1,797,1609,812
24631,0,0,6,0,-6
24632,0,0,29,0,-29
24633,0,0,13,0,-13
24634,0,0,58,0,-58
24635,1,0,30,0,-30
24636,0,0,19,0,-19
24637,0,0,89,0,-89
24638,1,1,464,1790,1326
24639,1,0,25,0,-25
24640,1,0,32,0,-32
24641,0,0,6,0,-6
24642,0,0,50,0,-50
24643,0,0,51,0,-51
24644,1,0,25,0,-25
24645,1,1,688,1236,548
24646,1,1,473,1544,1071
24647,0,0,29,0,-29
24648,1,1,348,3286,2938
24649,1,0,33,0,-33
24650,0,0,31,0,-31
24651,0,0,105,0,-105
24652,0,0,34,0,-34
24653,0,0,46,0,-46
24654,0,0,4,0,-4
24655,1,0,2,0,-2
24656,0,0,57,0,-57
24657,1,0,62,0,-62
24658,0,0,25,0,-25
24659,1,1,180,1306,1126
24660,1,1,70,1256,1186
24661,0,0,11,0,-11
24662,1,1,757,1332,575
24663,1,1,136,1458,1322
24664,0,0,89,0,-89
24665,1,0,30,0,-30
24666,0,0,18,0,-18
24667,1,1,181,1236,1055
24668,1,0,14,0,-14
24669,1,0,24,0,-24
24670,1,0,12,0,-12
24671,0,0,11,0,-11
24672,1,0,39,0,-39
24673,0,0,3,0,-3
24674,1,0,36,0,-36
24675,0,0,35,0,-35
24676,1,0,10,0,-10
24677,1,0,145,0,-145
24678,0,0,58,0,-58
24679,1,1,94,1417,1323
24680,1,0,25,0,-25
24681,1,0,1,0,-1
24682,0,0,30,0,-30
24683,0,0,17,0,-17
24684,0,0,46,0,-46
24685,1,1,1219,1377,158
24686,0,0,23,0,-23
24687,1,1,124,1271,1147
24688,1,0,67,0,-67
24689,0,0,33,0,-33
24690,1,1,156,1687,1531
24691,0,0,33,0,-33
24692,0,0,34,0,-34
24693,0,0,12,0,-12
24694,1,0,5,0,-5
24695,0,0,2,0,-2
24696,0,0,63,0,-63
24697,0,0,155,0,-155
24698,1,0,1,0,-1
24699,1,0,28,0,-28
24700,1,0,29,0,-29
24701,1,0,24,0,-24
24702,1,0,14,0,-14
24703,1,1,78,1309,1231
24704,0,0,71,0,-71
24705,1,0,15,0,-15
24706,0,0,61,0,-61
24707,1,1,560,1253,693
24708,0,0,136,0,-136
24709,1,1,369,1587,1218
24710,1,0,9,0,-9
24711,0,0,31,0,-31
24712,1,1,1536,1366,-170
24713,0,0,0,0,0
24714,0,0,17,0,-17
24715,0,0,84,0,-84
24716,1,0,40,0,-40
24717,1,1,371,1426,1055
24718,1,1,151,1288,1137
24719,0,0,61,0,-61
24720,0,0,9,0,-9
24721,0,0,18,0,-18
24722,1,0,10,0,-10
24723,1,0,16,0,-16
24724,0,0,58,0,-58
24725,0,0,56,0,-56
24726,0,0,86,0,-86
24727,1,1,1390,3455,2065
24728,0,0,5,0,-5
24729,1,0,159,0,-159
24730,1,0,24,0,-24
24731,1,1,528,1310,782
24732,1,1,104,1214,1110
24733,1,0,69,0,-69
24734,1,1,233,1451,1218
24735,1,1,648,1603,955
24736,0,0,64,0,-64
24737,1,0,49,0,-49
24738,1,0,69,0,-69
24739,0,0,121,0,-121
24740,1,1,96,1391,1295
24741,1,0,45,0,-45
24742,1,0,171,0,-171
24743,1,1,336,1396,1060
24744,1,0,54,0,-54
24745,0,0,4,0,-4
24746,1,0,9,0,-9
24747,0,0,75,0,-75
24748,0,0,9,0,-9
24749,1,0,8,0,-8
24750,0,0,5,0,-5
24751,1,0,12,0,-12
24752,1,1,2936,1615,-1321
24753,0,0,38,0,-38
24754,1,0,6,0,-6
24755,0,0,46,0,-46
24756,0,0,9,0,-9
24757,0,0,12,0,-12
24758,1,0,37,0,-37
24759,1,1,1784,1599,-185
24760,1,1,1539,1368,-171
24761,1,0,40,0,-40
24762,1,0,101,0,-101
24763,1,0,37,0,-37
24764,0,0,60,0,-60
24765,0,0,103,0,-103
24766,0,0,15,0,-15
24767,0,0,11,0,-11
24768,0,0,2,0,-2
24769,1,0,50,0,-50
24770,0,0,25,0,-25
24771,0,0,35,0,-35
24772,0,0,71,0,-71
24773,1,1,5,2252,2247
24774,1,0,69,0,-69
24775,0,0,3,0,-3
24776,0,0,390,0,-390
24777,1,1,558,2107,1549
24778,0,0,5,0,-5
24779,0,0,98,0,-98
24780,1,1,681,1707,1026
24781,0,0,17,0,-17
24782,1,1,1530,1485,-45
24783,0,0,21,0,-21
24784,0,0,12,0,-12
24785,1,1,140,2589,2449
24786,1,0,15,0,-15
24787,1,1,42,1395,1353
24788,1,1,81,1530,1449
24789,0,0,101,0,-101
24790,1,1,296,1283,987
24791,0,0,25,0,-25
24792,1,1,360,1213,853
24793,1,0,14,0,-14
24794,1,1,2713,2194,-519
24795,1,0,27,0,-27
24796,1,1,310,1480,1170
24797,1,1,402,1379,977
24798,1,1,864,1498,634
24799,0,0,1,0,-1
24800,0,0,106,0,-106
24801,0,0,30,0,-30
24802,0,0,3,0,-3
24803,1,0,6,0,-6
24804,1,1,635,2976,2341
24805,1,0,15,0,-15
24806,0,0,85,0,-85
24807,1,1,115,1738,1623
24808,1,0,56,0,-56
24809,1,0,34,0,-34
24810,1,1,407,1563,1156
24811,1,1,224,1690,1466
24812,1,1,592,1310,718
24813,1,1,581,1222,641
24814,1,0,26,0,-26
24815,0,0,10,0,-10
24816,1,0,8,0,-8
24817,1,0,58,0,-58
24818,0,0,18,0,-18
24819,1,0,81,0,-81
24820,0,0,21,0,-21
24821,1,0,96,0,-96
24822,1,1,99,1310,1211
24823,0,0,142,0,-142
24824,0,0,40,0,-40
24825,1,0,77,0,-77
24826,1,1,189,1848,1659
24827,1,0,33,0,-33
24828,1,0,0,0,0
24829,0,0,27,0,-27
24830,0,0,3,0,-3
24831,0,0,40,0,-40
24832,0,0,4,0,-4
24833,1,0,24,0,-24
24834,0,0,37,0,-37
24835,1,1,140,1432,1292
24836,1,1,140,1759,1619
24837,0,0,54,0,-54
24838,0,0,41,0,-41
24839,1,0,42,0,-42
24840,0,0,87,0,-87
24841,1,1,1868,1766,-102
24842,1,0,78,0,-78
24843,0,0,96,0,-96
24844,0,0,3,0,-3
24845,1,0,2,0,-2
24846,0,0,4,0,-4
24847,1,0,38,0,-38
24848,1,0,20,0,-20
24849,1,1,684,3594,2910
24850,0,0,124,0,-124
24851,1,0,5,0,-5
24852,1,1,103,1895,1792
24853,1,1,327,1351,1024
24854,0,0,13,0,-13
24855,0,0,12,0,-12
24856,0,0,165,0,-165
24857,1,1,963,1233,270
24858,1,0,30,0,-30
24859,1,0,176,0,-176
24860,0,0,61,0,-61
24861,1,0,60,0,-60
24862,0,0,23,0,-23
24863,0,0,11,0,-11
24864,1,1,174,1417,1243
24865,0,0,36,0,-36
24866,0,0,21,0,-21
24867,1,1,472,1728,1256
24868,1,1,2656,1782,-874
24869,0,0,16,0,-16
24870,1,0,106,0,-106
24871,0,0,57,0,-57
24872,0,0,63,0,-63
24873,0,0,9,0,-9
24874,1,0,247,0,-247
24875,1,0,25,0,-25
24876,1,0,5,0,-5
24877,1,1,526,1700,1174
24878,1,0,12,0,-12
24879,1,1,118,2207,2089
24880,0,0,11,0,-11
24881,0,0,38,0,-38
24882,1,0,37,0,-37
24883,0,0,11,0,-11
24884,1,0,10,0,-10
24885,0,0,8,0,-8
24886,0,0,58,0,-58
24887,1,1,57,1482,1425
24888,1,1,231,1507,1276
24889,0,0,21,0,-21
24890,0,0,75,0,-75
24891,1,0,39,0,-39
24892,0,0,41,0,-41
24893,1,0,144,0,-144
24894,1,0,4,0,-4
24895,1,0,6,0,-6
24896,0,0,214,0,-214
24897,0,0,38,0,-38
24898,1,1,256,1431,1175
24899,1,0,25,0,-25
24900,0,0,63,0,-63
24901,0,0,14,0,-14
24902,1,0,32,0,-32
24903,0,0,0,0,0
24904,0,0,14,0,-14
24905,1,0,6,0,-6
24906,1,1,438,1507,1069
24907,1,0,13,0,-13
24908,1,1,37,3185,3148
24909,0,0,10,0,-10
24910,0,0,52,0,-52
24911,1,1,593,1238,645
24912,0,0,26,0,-26
24913,1,0,121,0,-121
24914,1,0,28,0,-28
24915,1,0,13,0,-13
24916,1,0,35,0,-35
24917,1,1,181,1371,1190
24918,0,0,15,0,-15
24919,1,1,593,2185,1592
24920,0,0,162,0,-162
24921,0,0,60,0,-60
24922,1,0,7,0,-7
24923,1,1,922,1204,282
24924,1,0,190,0,-190
24925,0,0,8,0,-8
24926,1,0,62,0,-62
24927,1,1,31,1357,1326
24928,0,0,33,0,-33
24929,0,0,34,0,-34
24930,1,0,43,0,-43
24931,1,0,7,0,-7
24932,0,0,87,0,-87
24933,0,0,99,0,-99
24934,1,0,8,0,-8
24935,0,0,3,0,-3
24936,1,1,92,1624,1532
24937,0,0,109,0,-109
24938,1,1,81,1409,1328
24939,1,1,664,1598,934
24940,1,0,136,0,-136
24941,1,1,384,1350,966
24942,0,0,63,0,-63
24943,0,0,34,0,-34
24944,0,0,12,0,-12
24945,0,0,10,0,-10
24946,1,1,155,2129,1974
24947,1,0,11,0,-11
24948,1,0,119,0,-119
24949,0,0,12,0,-12
24950,1,0,16,0,-16
24951,1,1,866,2265,1399
24952,1,1,406,1804,1398
24953,1,1,958,1296,338
24954,1,0,44,0,-44
24955,0,0,107,0,-107
24956,1,1,52,1447,1395
24957,0,0,24,0,-24
24958,1,0,17,0,-17
24959,1,1,704,1255,551
24960,0,0,29,0,-29
24961,1,1,254,2171,1917
24962,0,0,16,0,-16
24963,1,0,57,0,-57
24964,1,1,349,1746,1397
24965,0,0,27,0,-27
24966,0,0,165,0,-165
24967,1,1,440,2500,2060
24968,1,1,531,2050,1519
24969,0,0,114,0,-114
24970,0,0,137,0,-137
24971,1,0,46,0,-46
24972,0,0,12,0,-12
24973,1,1,399,1252,853
24974,0,0,24,0,-24
24975,1,1,791,1287,496
24976,0,0,18,0,-18
24977,1,0,21,0,-21
24978,0,0,108,0,-108
24979,0,0,84,0,-84
24980,1,0,23,0,-23
24981,1,0,3,0,-3
24982,1,1,1650,1251,-399
24983,1,0,121,0,-121
24984,0,0,18,0,-18
24985,1,1,51,2353,2302
24986,1,1,397,1462,1065
24987,0,0,28,0,-28
24988,1,0,18,0,-18
24989,0,0,1,0,-1
24990,0,0,80,0,-80
24991,0,0,43,0,-43
24992,1,0,4,0,-4
24993,0,0,12,0,-12
24994,1,1,373,1365,992
24995,0,0,21,0,-21
24996,1,0,30,0,-30
24997,1,0,24,0,-24
24998,1,0,35,0,-35
24999,1,1,857,1615,758
25000,0,0,38,0,-38
25001,0,0,145,0,-145
25002,1,0,60,0,-60
25003,0,0,45,0,-45
25004,1,0,48,0,-48
25005,0,0,38,0,-38
25006,0,0,151,0,-151
25007,1,0,18,0,-18
25008,1,0,88,0,-88
25009,0,0,13,0,-13
25010,1,0,22,0,-22
25011,0,0,37,0,-37
25012,1,0,7,0,-7
25013,0,0,86,0,-86
25014,0,0,3,0,-3
25015,1,0,38,0,-38
25016,1,1,11,1370,1359
25017,0,0,65,0,-65
25018,1,0,78,0,-78
25019,1,1,83,1234,1151
25020,1,1,879,1218,339
25021,0,0,75,0,-75
25022,1,1,1408,1264,-144
25023,0,0,225,0,-225
25024,0,0,6,0,-6
25025,1,1,656,1391,735
25026,0,0,0,0,0
25027,0,0,28,0,-28
25028,1,1,336,1289,953
25029,0,0,15,0,-15
25030,0,0,49,0,-49
25031,0,0,83,0,-83
25032,1,0,36,0,-36
25033,0,0,0,0,0
25034,1,0,81,0,-81
25035,1,1,397,1890,1493
25036,0,0,62,0,-62
25037,1,0,213,0,-213
25038,0,0,119,0,-119
25039,1,1,1068,2767,1699
25040,1,1,285,2183,1898
25041,1,1,1121,1205,84
25042,1,1,177,1725,1548
25043,1,1,21,3319,3298
25044,1,0,10,0,-10
25045,1,1,207,1743,1536
25046,1,0,23,0,-23
25047,1,0,101,0,-101
25048,1,0,19,0,-19
25049,0,0,0,0,0
25050,0,0,39,0,-39
25051,0,0,58,0,-58
25052,0,0,175,0,-175
25053,1,0,37,0,-37
25054,1,0,8,0,-8
25055,1,1,822,1894,1072
25056,0,0,27,0,-27
25057,1,0,16,0,-16
25058,0,0,14,0,-14
25059,0,0,206,0,-206
25060,0,0,138,0,-138
25061,0,0,84,0,-84
25062,0,0,28,0,-28
25063,1,1,748,1321,573
25064,1,1,542,1852,1310
25065,1,0,213,0,-213
25066,0,0,119,0,-119
25067,1,1,207,1532,1325
25068,0,0,93,0,-93
25069,1,0,13,0,-13
25070,1,1,149,2063,1914
25071,0,0,10,0,-10
25072,1,0,15,0,-15
25073,1,1,606,1344,738
25074,1,1,374,4180,3806
25075,1,1,54,1518,1464
25076,0,0,33,0,-33
25077,1,1,718,1846,1128
25078,1,0,96,0,-96
25079,1,0,21,0,-21
25080,1,1,2265,1248,-1017
25081,1,0,140,0,-140
25082,1,1,109,1583,1474
25083,1,1,1284,1872,588
25084,1,0,78,0,-78
25085,1,0,105,0,-105
25086,1,1,96,1229,1133
25087,1,1,383,1331,948
25088,0,0,24,0,-24
25089,1,0,2,0,-2
25090,0,0,91,0,-91
25091,0,0,19,0,-19
25092,0,0,1,0,-1
25093,1,0,181,0,-181
25094,1,0,7,0,-7
25095,1,1,63,1482,1419
25096,1,1,273,1462,1189
25097,1,0,3,0,-3
25098,1,1,326,1520,1194
25099,1,0,17,0,-17
25100,1,0,22,0,-22
25101,0,0,32,0,-32
25102,1,0,53,0,-53
25103,0,0,83,0,-83
25104,0,0,302,0,-302
25105,0,0,75,0,-75
25106,1,0,22,0,-22
25107,1,1,537,1311,774
25108,1,0,107,0,-107
25109,1,1,273,1218,945
25110,0,0,64,0,-64
25111,0,0,87,0,-87
25112,0,0,22,0,-22
25113,1,1,719,1243,524
25114,1,0,58,0,-58
25115,1,0,9,0,-9
25116,1,1,1008,1282,274
25117,1,1,77,1214,1137
25118,1,0,43,0,-43
25119,0,0,56,0,-56
25120,0,0,139,0,-139
25121,0,0,60,0,-60
25122,0,0,1,0,-1
25123,1,1,200,1990,1790
25124,1,0,20,0,-20
25125,0,0,90,0,-90
25126,1,1,297,1452,1155
25127,1,0,27,0,-27
25128,1,0,8,0,-8
25129,1,0,155,0,-155
25130,0,0,19,0,-19
25131,0,0,7,0,-7
25132,0,0,35,0,-35
25133,0,0,43,0,-43
25134,0,0,41,0,-41
25135,1,0,2,0,-2
25136,1,0,76,0,-76
25137,1,1,402,1380,978
25138,1,0,0,0,0
25139,0,0,106,0,-106
25140,1,0,24,0,-24
25141,1,0,46,0,-46
25142,1,0,24,0,-24
25143,0,0,16,0,-16
25144,1,1,132,1346,1214
25145,0,0,10,0,-10
25146,0,0,22,0,-22
25147,1,1,285,1369,1084
25148,0,0,16,0,-16
25149,0,0,74,0,-74
25150,1,1,227,1905,1678
25151,1,1,186,1621,1435
25152,1,0,5,0,-5
25153,1,0,35,0,-35
25154,0,0,56,0,-56
25155,1,1,213,1949,1736
25156,1,1,1851,1722,-129
25157,0,0,11,0,-11
25158,0,0,47,0,-47
25159,1,1,1194,1381,187
25160,0,0,40,0,-40
25161,1,0,39,0,-39
25162,0,0,132,0,-132
25163,0,0,2,0,-2
25164,1,0,199,0,-199
25165,1,1,69,1548,1479
25166,1,1,1194,2265,1071
25167,0,0,99,0,-99
25168,0,0,29,0,-29
25169,0,0,110,0,-110
25170,1,1,776,1443,667
25171,1,0,22,0,-22
25172,0,0,142,0,-142
25173,1,0,33,0,-33
25174,0,0,15,0,-15
25175,1,1,559,1789,1230
25176,0,0,3,0,-3
25177,1,0,48,0,-48
25178,1,1,446,1208,762
25179,0,0,40,0,-40
25180,1,1,548,1641,1093
25181,0,0,64,0,-64
25182,1,1,170,1240,1070
25183,1,0,298,0,-298
25184,0,0,27,0,-27
25185,1,1,1465,1578,113
25186,0,0,28,0,-28
25187,1,0,25,0,-25
25188,0,0,67,0,-67
25189,1,1,202,1398,1196
25190,0,0,122,0,-122
25191,0,0,159,0,-159
25192,1,0,29,0,-29
25193,1,0,123,0,-123
25194,1,1,39,1267,1228
25195,0,0,57,0,-57
25196,1,1,37,1781,1744
25197,0,0,0,0,0
25198,0,0,2,0,-2
25199,0,0,25,0,-25
25200,1,1,1145,1350,205
25201,1,1,1992,1886,-106
25202,0,0,107,0,-107
25203,1,1,104,1559,1455
25204,1,0,83,0,-83
25205,1,1,751,1758,1007
25206,0,0,55,0,-55
25207,0,0,49,0,-49
25208,1,0,3,0,-3
25209,1,1,193,1241,1048
25210,0,0,3,0,-3
25211,1,1,677,1632,955
25212,0,0,9,0,-9
25213,1,0,105,0,-105
25214,1,0,33,0,-33
25215,0,0,21,0,-21
25216,1,1,775,1372,597
25217,1,0,55,0,-55
25218,0,0,51,0,-51
25219,0,0,48,0,-48
25220,0,0,56,0,-56
25221,1,0,14,0,-14
25222,1,1,23,1527,1504
25223,1,0,46,0,-46
25224,0,0,52,0,-52
25225,1,0,18,0,-18
25226,1,0,31,0,-31
25227,1,1,69,1480,1411
25228,1,1,473,1454,981
25229,0,0,18,0,-18
25230,0,0,135,0,-135
25231,1,0,70,0,-70
25232,0,0,26,0,-26
25233,0,0,132,0,-132
25234,1,1,212,1294,1082
25235,0,0,57,0,-57
25236,1,0,75,0,-75
25237,1,0,31,0,-31
25238,1,0,81,0,-81
25239,0,0,335,0,-335
25240,1,0,14,0,-14
25241,0,0,34,0,-34
25242,0,0,5,0,-5
25243,1,0,72,0,-72
25244,1,1,393,1532,1139
25245,0,0,30,0,-30
25246,1,1,1384,1611,227
25247,1,1,797,1208,411
25248,1,1,597,1425,828
25249,1,0,121,0,-121
25250,1,0,17,0,-17
25251,0,0,92,0,-92
25252,0,0,99,0,-99
25253,1,1,570,2569,1999
25254,1,1,210,2048,1838
25255,0,0,36,0,-36
25256,1,1,374,1202,828
25257,1,0,42,0,-42
25258,0,0,38,0,-38
25259,1,1,577,2071,1494
25260,0,0,9,0,-9
25261,0,0,65,0,-65
25262,1,0,30,0,-30
25263,0,0,31,0,-31
25264,1,0,14,0,-14
25265,0,0,104,0,-104
25266,1,0,18,0,-18
25267,1,0,9,0,-9
25268,0,0,44,0,-44
25269,1,0,33,0,-33
25270,1,0,35,0,-35
25271,0,0,97,0,-97
25272,1,0,167,0,-167
25273,1,1,1733,1264,-469
25274,0,0,92,0,-92
25275,0,0,19,0,-19
25276,0,0,49,0,-49
25277,1,1,772,3104,2332
25278,1,0,69,0,-69
25279,1,0,33,0,-33
25280,1,1,279,1444,1165
25281,1,0,7,0,-7
25282,1,0,42,0,-42
25283,1,0,17,0,-17
25284,0,0,68,0,-68
25285,1,0,24,0,-24
25286,1,1,905,4559,3654
25287,0,0,60,0,-60
25288,0,0,35,0,-35
25289,0,0,23,0,-23
25290,1,0,159,0,-159
25291,0,0,90,0,-90
25292,0,0,70,0,-70
25293,1,1,536,1411,875
25294,0,0,13,0,-13
25295,0,0,51,0,-51
25296,0,0,11,0,-11
25297,1,0,41,0,-41
25298,0,0,4,0,-4
25299,0,0,67,0,-67
25300,1,1,859,1765,906
25301,0,0,24,0,-24
25302,0,0,65,0,-65
25303,0,0,31,0,-31
25304,0,0,19,0,-19
25305,1,1,251,1500,1249
25306,0,0,6,0,-6
25307,1,1,78,1989,1911
25308,1,0,0,0,0
25309,1,1,50,1275,1225
25310,1,0,37,0,-37
25311,1,0,64,0,-64
25312,1,0,36,0,-36
25313,1,0,38,0,-38
25314,0,0,27,0,-27
25315,0,0,29,0,-29
25316,1,1,150,1817,1667
25317,0,0,63,0,-63
25318,1,0,0,0,0
25319,1,1,118,1288,1170
25320,0,0,151,0,-151
25321,1,1,414,1200,786
25322,1,1,219,1276,1057
25323,0,0,157,0,-157
25324,1,0,53,0,-53
25325,1,0,266,0,-266
25326,1,0,15,0,-15
25327,1,0,250,0,-250
25328,1,0,93,0,-93
25329,1,1,1066,1212,146
25330,1,1,861,1218,357
25331,0,0,15,0,-15
25332,0,0,149,0,-149
25333,0,0,46,0,-46
25334,1,1,508,2458,1950
25335,1,1,765,1203,438
25336,1,1,210,1747,1537
25337,1,0,13,0,-13
25338,1,0,28,0,-28
25339,1,0,6,0,-6
25340,1,0,14,0,-14
25341,1,1,322,1344,1022
25342,1,1,287,2628,2341
25343,0,0,0,0,0
25344,1,1,725,1554,829
25345,1,1,713,1621,908
25346,0,0,43,0,-43
25347,0,0,19,0,-19
25348,1,1,2609,1311,-1298
25349,0,0,51,0,-51
25350,1,0,23,0,-23
25351,1,1,412,1214,802
25352,0,0,21,0,-21
25353,1,1,277,1736,1459
25354,0,0,27,0,-27
25355,1,0,79,0,-79
25356,1,1,1297,1370,73
25357,0,0,0,0,0
25358,1,0,51,0,-51
25359,0,0,54,0,-54
25360,1,1,999,1471,472
25361,0,0,22,0,-22
25362,0,0,74,0,-74
25363,1,1,842,1665,823
25364,1,1,673,1426,753
25365,1,1,524,1244,720
25366,0,0,209,0,-209
25367,0,0,40,0,-40
25368,0,0,34,0,-34
25369,1,0,164,0,-164
25370,0,0,12,0,-12
25371,1,0,54,0,-54
25372,0,0,31,0,-31
25373,0,0,20,0,-20
25374,1,0,39,0,-39
25375,1,1,737,1391,654
25376,1,1,1206,1285,79
25377,0,0,29,0,-29
25378,0,0,66,0,-66
25379,1,0,1,0,-1
25380,1,0,258,0,-258
25381,0,0,18,0,-18
25382,0,0,243,0,-243
25383,0,0,217,0,-217
25384,1,1,1074,1541,467
25385,0,0,7,0,-7
25386,1,1,1346,1284,-62
25387,1,0,91,0,-91
25388,0,0,81,0,-81
25389,0,0,95,0,-95
25390,0,0,11,0,-11
25391,1,1,96,1379,1283
25392,1,1,523,1344,821
25393,0,0,33,0,-33
25394,0,0,24,0,-24
25395,1,1,237,1270,1033
25396,1,0,7,0,-7
25397,1,0,103,0,-103
25398,1,1,639,1299,660
25399,1,0,2,0,-2
25400,1,1,436,1585,1149
25401,1,1,1356,1875,519
25402,0,0,120,0,-120
25403,1,1,533,1611,1078
25404,1,1,281,1568,1287
25405,0,0,21,0,-21
25406,1,1,1946,1579,-367
25407,1,0,28,0,-28
25408,1,0,63,0,-63
25409,0,0,2,0,-2
25410,1,1,369,1332,963
25411,1,0,30,0,-30
25412,1,1,632,1447,815
25413,1,0,72,0,-72
25414,1,0,45,0,-45
25415,1,0,133,0,-133
25416,1,0,5,0,-5
25417,0,0,6,0,-6
25418,0,0,48,0,-48
25419,1,0,109,0,-109
25420,1,1,1664,1573,-91
25421,1,1,403,1560,1157
25422,0,0,103,0,-103
25423,1,1,357,1518,1161
25424,0,0,51,0,-51
25425,1,0,65,0,-65
25426,0,0,124,0,-124
25427,1,0,23,0,-23
25428,1,1,74,1237,1163
25429,1,0,6,0,-6
25430,0,0,58,0,-58
25431,1,1,1170,1687,517
25432,0,0,9,0,-9
25433,1,1,736,1624,888
25434,0,0,66,0,-66
25435,1,0,32,0,-32
25436,1,1,559,1370,811
25437,1,1,176,1251,1075
25438,1,1,590,2382,1792
25439,1,1,404,1206,802
25440,0,0,21,0,-21
25441,1,1,2360,1367,-993
25442,1,0,28,0,-28
25443,0,0,11,0,-11
25444,1,0,24,0,-24
25445,1,1,994,1272,278
25446,0,0,22,0,-22
25447,0,0,94,0,-94
25448,1,0,50,0,-50
25449,0,0,136,0,-136
25450,1,0,44,0,-44
25451,1,0,34,0,-34
25452,0,0,155,0,-155
25453,0,0,114,0,-114
25454,1,0,0,0,0
25455,1,0,9,0,-9
25456,0,0,108,0,-108
25457,1,1,166,1895,1729
25458,1,0,83,0,-83
25459,1,1,248,1226,978
25460,1,1,1662,1792,130
25461,1,1,1079,1229,150
25462,1,0,59,0,-59
25463,0,0,40,0,-40
25464,0,0,88,0,-88
25465,1,1,500,1378,878
25466,1,0,98,0,-98
25467,1,1,391,1270,879
25468,1,1,368,1201,833
25469,1,0,5,0,-5
25470,0,0,31,0,-31
25471,1,0,141,0,-141
25472,1,1,418,1312,894
25473,1,0,49,0,-49
25474,1,1,525,1397,872
25475,0,0,54,0,-54
25476,1,1,889,2439,1550
25477,0,0,71,0,-71
25478,1,1,588,1437,849
25479,0,0,63,0,-63
25480,1,1,171,1230,1059
25481,1,1,835,1257,422
25482,0,0,7,0,-7
25483,1,0,156,0,-156
25484,1,1,130,1323,1193
25485,1,0,3,0,-3
25486,1,1,426,2393,1967
25487,1,0,4,0,-4
25488,1,1,984,1239,255
25489,0,0,19,0,-19
25490,0,0,53,0,-53
25491,1,0,72,0,-72
25492,1,1,95,1773,1678
25493,0,0,22,0,-22
25494,1,1,297,1390,1093
25495,1,1,996,1400,404
25496,1,1,189,1374,1185
25497,1,1,850,1365,515
25498,0,0,5,0,-5
25499,0,0,74,0,-74
25500,0,0,28,0,-28
25501,1,1,385,1510,1125
25502,0,0,39,0,-39
25503,1,0,86,0,-86
25504,1,1,772,1298,526
25505,0,0,19,0,-19
25506,0,0,3,0,-3
25507,0,0,10,0,-10
25508,1,0,0,0,0
25509,0,0,125,0,-125
25510,1,1,303,1335,1032
25511,1,0,81,0,-81
25512,0,0,56,0,-56
25513,0,0,3,0,-3
25514,1,1,276,2092,1816
25515,1,0,14,0,-14
25516,0,0,49,0,-49
25517,1,0,28,0,-28
25518,1,1,280,1509,1229
25519,1,1,146,1469,1323
25520,1,0,6,0,-6
25521,0,0,25,0,-25
25522,0,0,77,0,-77
25523,1,0,14,0,-14
25524,1,0,39,0,-39
25525,0,0,39,0,-39
25526,1,1,195,2398,2203
25527,1,0,89,0,-89
25528,1,0,8,0,-8
25529,1,1,110,1465,1355
25530,0,0,5,0,-5
25531,0,0,57,0,-57
25532,1,1,129,1638,1509
25533,1,1,1385,1358,-27
25534,0,0,88,0,-88
25535,1,1,844,2427,1583
25536,1,1,92,1234,1142
25537,1,0,69,0,-69
25538,0,0,2,0,-2
25539,0,0,25,0,-25
25540,0,0,106,0,-106
25541,0,0,3,0,-3
25542,1,1,884,1495,611
25543,0,0,73,0,-73
25544,0,0,10,0,-10
25545,0,0,115,0,-115
25546,1,0,12,0,-12
25547,1,0,75,0,-75
25548,1,1,628,1401,773
25549,0,0,2,0,-2
25550,1,1,71,1462,1391
25551,1,0,61,0,-61
25552,1,1,806,1587,781
25553,1,0,419,0,-419
25554,0,0,153,0,-153
25555,1,0,6,0,-6
25556,1,0,11,0,-11
25557,0,0,74,0,-74
25558,0,0,40,0,-40
25559,1,0,23,0,-23
25560,1,0,52,0,-52
25561,1,1,839,2488,1649
25562,0,0,41,0,-41
25563,1,1,497,1615,1118
25564,0,0,0,0,0
25565,1,0,64,0,-64
25566,0,0,20,0,-20
25567,1,0,5,0,-5
25568,0,0,35,0,-35
25569,1,1,797,1782,985
25570,1,0,82,0,-82
25571,0,0,14,0,-14
25572,1,0,9,0,-9
25573,1,1,451,1266,815
25574,0,0,313,0,-313
25575,0,0,9,0,-9
25576,0,0,83,0,-83
25577,0,0,1,0,-1
25578,0,0,71,0,-71
25579,1,1,1701,1304,-397
25580,0,0,0,0,0
25581,1,0,102,0,-102
25582,1,0,72,0,-72
25583,0,0,20,0,-20
25584,1,0,70,0,-70
25585,0,0,5,0,-5
25586,0,0,37,0,-37
25587,1,1,1142,1832,690
25588,1,1,822,1417,595
25589,1,0,31,0,-31
25590,0,0,103,0,-103
25591,0,0,15,0,-15
25592,0,0,196,0,-196
25593,1,1,192,1215,1023
25594,1,1,243,1233,990
25595,1,0,17,0,-17
25596,0,0,95,0,-95
25597,0,0,2,0,-2
25598,1,0,63,0,-63
25599,0,0,25,0,-25
25600,0,0,120,0,-120
25601,1,1,419,1351,932
25602,1,0,173,0,-173
25603,1,0,58,0,-58
25604,0,0,20,0,-20
25605,0,0,70,0,-70
25606,0,0,56,0,-56
25607,1,1,614,1292,678
25608,0,0,38,0,-38
25609,1,0,52,0,-52
25610,0,0,28,0,-28
25611,0,0,23,0,-23
25612,0,0,165,0,-165
25613,1,0,58,0,-58
25614,1,0,25,0,-25
25615,1,1,159,1255,1096
25616,0,0,7,0,-7
25617,0,0,32,0,-32
25618,1,0,4,0,-4
25619,0,0,94,0,-94
25620,1,0,3,0,-3
25621,0,0,36,0,-36
25622,1,0,3,0,-3
25623,1,0,34,0,-34
25624,1,1,72,3937,3865
25625,1,1,1350,1232,-118
25626,1,0,93,0,-93
25627,0,0,38,0,-38
25628,1,1,264,1929,1665
25629,1,0,46,0,-46
25630,0,0,74,0,-74
25631,1,1,605,1502,897
25632,0,0,52,0,-52
25633,1,1,717,1422,705
25634,0,0,3,0,-3
25635,1,0,14,0,-14
25636,1,0,66,0,-66
25637,1,1,195,1363,1168
25638,0,0,34,0,-34
25639,0,0,156,0,-156
25640,1,1,946,1706,760
25641,1,1,807,1359,552
25642,1,0,138,0,-138
25643,1,1,324,1209,885
25644,1,1,166,1270,1104
25645,1,0,34,0,-34
25646,1,0,175,0,-175
25647,1,0,45,0,-45
25648,0,0,15,0,-15
25649,0,0,3,0,-3
25650,0,0,53,0,-53
25651,1,0,143,0,-143
25652,1,1,857,1531,674
25653,0,0,19,0,-19
25654,1,1,605,1259,654
25655,0,0,8,0,-8
25656,1,0,50,0,-50
25657,1,1,378,1588,1210
25658,1,1,403,1281,878
25659,1,0,51,0,-51
25660,0,0,55,0,-55
25661,1,0,115,0,-115
25662,1,0,0,0,0
25663,0,0,45,0,-45
25664,1,0,29,0,-29
25665,1,1,908,1260,352
25666,0,0,41,0,-41
25667,1,1,110,1425,1315
25668,0,0,56,0,-56
25669,0,0,98,0,-98
25670,1,0,46,0,-46
25671,1,1,1569,1376,-193
25672,0,0,23,0,-23
25673,1,1,914,1791,877
25674,1,1,27,1574,1547
25675,1,1,299,1277,978
25676,1,0,1,0,-1
25677,0,0,13,0,-13
25678,1,1,167,1321,1154
25679,0,0,17,0,-17
25680,1,1,232,1312,1080
25681,1,1,307,1562,1255
25682,1,1,86,1530,1444
25683,1,0,14,0,-14
25684,0,0,11,0,-11
25685,1,0,10,0,-10
25686,1,0,40,0,-40
25687,1,0,25,0,-25
25688,1,1,87,1774,1687
25689,1,0,191,0,-191
25690,0,0,59,0,-59
25691,1,1,23,2167,2144
25692,0,0,107,0,-107
25693,1,0,70,0,-70
25694,1,0,30,0,-30
25695,0,0,16,0,-16
25696,1,0,14,0,-14
25697,0,0,54,0,-54
25698,1,1,1018,1354,336
25699,1,0,37,0,-37
25700,0,0,7,0,-7
25701,1,0,46,0,-46
25702,1,0,170,0,-170
25703,1,1,709,1431,722
25704,1,1,676,1337,661
25705,0,0,2,0,-2
25706,1,0,4,0,-4
25707,0,0,59,0,-59
25708,1,1,73,1371,1298
25709,1,0,15,0,-15
25710,1,0,160,0,-160
25711,1,0,50,0,-50
25712,1,1,128,1284,1156
25713,1,1,412,1923,1511
25714,1,1,418,1628,1210
25715,1,1,243,1201,958
25716,0,0,38,0,-38
25717,1,1,793,1460,667
25718,1,0,173,0,-173
25719,0,0,3,0,-3
25720,0,0,19,0,-19
25721,0,0,30,0,-30
25722,1,0,31,0,-31
25723,0,0,58,0,-58
25724,0,0,98,0,-98
25725,0,0,10,0,-10
25726,1,0,44,0,-44
25727,1,0,23,0,-23
25728,0,0,4,0,-4
25729,0,0,107,0,-107
25730,0,0,30,0,-30
25731,1,0,21,0,-21
25732,1,0,30,0,-30
25733,1,0,30,0,-30
25734,1,1,154,1392,1238
25735,1,1,54,1242,1188
25736,1,1,579,1480,901
25737,0,0,38,0,-38
25738,1,0,35,0,-35
25739,1,0,169,0,-169
25740,0,0,118,0,-118
25741,0,0,71,0,-71
25742,1,1,751,2776,2025
25743,1,1,198,1258,1060
25744,1,0,19,0,-19
25745,1,0,10,0,-10
25746,0,0,19,0,-19
25747,1,1,362,1578,1216
25748,0,0,8,0,-8
25749,1,0,4,0,-4
25750,1,1,1688,1779,91
25751,0,0,14,0,-14
25752,0,0,56,0,-56
25753,1,1,403,1537,1134
25754,1,1,1701,1390,-311
25755,0,0,191,0,-191
25756,1,0,53,0,-53
25757,0,0,14,0,-14
25758,1,1,543,1380,837
25759,1,0,193,0,-193
25760,1,1,76,1443,1367
25761,1,0,18,0,-18
25762,0,0,54,0,-54
25763,0,0,48,0,-48
25764,1,1,810,1286,476
25765,1,1,168,1262,1094
25766,0,0,14,0,-14
25767,0,0,28,0,-28
25768,1,0,13,0,-13
25769,0,0,132,0,-132
25770,1,1,870,1288,418
25771,0,0,24,0,-24
25772,0,0,4,0,-4
25773,1,1,241,1206,965
25774,1,0,0,0,0
25775,1,1,632,1333,701
25776,1,0,30,0,-30
25777,0,0,28,0,-28
25778,1,0,7,0,-7
25779,1,0,49,0,-49
25780,1,0,16,0,-16
25781,1,1,225,1488,1263
25782,1,1,763,1808,1045
25783,1,0,39,0,-39
25784,0,0,17,0,-17
25785,0,0,24,0,-24
25786,0,0,39,0,-39
25787,1,1,2370,1427,-943
25788,1,0,19,0,-19
25789,1,1,475,1321,846
25790,0,0,33,0,-33
25791,1,0,2,0,-2
25792,1,0,99,0,-99
25793,1,0,131,0,-131
25794,0,0,69,0,-69
25795,1,0,154,0,-154
25796,0,0,232,0,-232
25797,0,0,91,0,-91
25798,1,0,55,0,-55
25799,0,0,62,0,-62
25800,1,0,5,0,-5
25801,0,0,9,0,-9
25802,1,0,43,0,-43
25803,1,0,27,0,-27
25804,1,1,167,1585,1418
25805,1,1,851,1578,727
25806,1,1,341,1254,913
25807,0,0,120,0,-120
25808,1,1,94,1678,1584
25809,0,0,9,0,-9
25810,1,0,361,0,-361
25811,0,0,58,0,-58
25812,1,0,1,0,-1
25813,1,0,23,0,-23
25814,1,0,84,0,-84
25815,0,0,36,0,-36
25816,0,0,13,0,-13
25817,0,0,15,0,-15
25818,1,1,478,2921,2443
25819,1,1,1091,1606,515
25820,1,0,11,0,-11
25821,1,1,87,1330,1243
25822,0,0,51,0,-51
25823,1,0,27,0,-27
25824,1,0,105,0,-105
25825,1,0,157,0,-157
25826,0,0,49,0,-49
25827,0,0,5,0,-5
25828,0,0,10,0,-10
25829,1,0,80,0,-80
25830,0,0,145,0,-145
25831,0,0,8,0,-8
25832,0,0,35,0,-35
25833,1,0,57,0,-57
25834,0,0,12,0,-12
25835,1,1,289,1391,1102
25836,1,1,1374,1227,-147
25837,0,0,4,0,-4
25838,1,1,547,1206,659
25839,1,1,389,1399,1010
25840,0,0,25,0,-25
25841,0,0,5,0,-5
25842,0,0,17,0,-17
25843,1,0,0,0,0
25844,1,1,284,1664,1380
25845,1,1,210,1309,1099
25846,0,0,24,0,-24
25847,0,0,49,0,-49
25848,1,0,55,0,-55
25849,1,0,1,0,-1
25850,1,1,395,1295,900
25851,1,0,85,0,-85
25852,1,1,396,1313,917
25853,1,1,279,1864,1585
25854,1,1,419,1487,1068
25855,1,1,581,4980,4399
25856,1,0,186,0,-186
25857,0,0,0,0,0
25858,1,1,496,1258,762
25859,1,0,102,0,-102
25860,0,0,48,0,-48
25861,1,0,13,0,-13
25862,0,0,28,0,-28
25863,1,1,685,1294,609
25864,1,1,488,1449,961
25865,1,1,183,1520,1337
25866,1,0,49,0,-49
25867,1,0,91,0,-91
25868,0,0,26,0,-26
25869,0,0,31,0,-31
25870,0,0,52,0,-52
25871,1,1,234,1898,1664
25872,1,1,102,1293,1191
25873,1,0,15,0,-15
25874,1,0,79,0,-79
25875,0,0,1,0,-1
25876,0,0,71,0,-71
25877,1,0,105,0,-105
25878,1,0,28,0,-28
25879,1,0,58,0,-58
25880,1,1,125,1216,1091
25881,1,1,100,1814,1714
25882,1,0,24,0,-24
25883,1,0,35,0,-35
25884,0,0,12,0,-12
25885,1,0,20,0,-20
25886,1,0,103,0,-103
25887,1,1,1209,1411,202
25888,0,0,111,0,-111
25889,0,0,18,0,-18
25890,0,0,3,0,-3
25891,1,1,133,1273,1140
25892,1,0,94,0,-94
25893,0,0,184,0,-184
25894,1,1,1296,1280,-16
25895,1,0,24,0,-24
25896,1,0,27,0,-27
25897,1,1,948,2429,1481
25898,1,0,101,0,-101
25899,1,0,6,0,-6
25900,0,0,1,0,-1
25901,1,0,57,0,-57
25902,1,1,886,1933,1047
25903,1,1,556,1494,938
25904,1,0,33,0,-33
25905,1,0,92,0,-92
25906,1,1,269,1267,998
25907,1,0,77,0,-77
25908,1,0,25,0,-25
25909,1,0,40,0,-40
25910,0,0,85,0,-85
25911,0,0,8,0,-8
25912,1,1,357,1638,1281
25913,1,0,55,0,-55
25914,0,0,9,0,-9
25915,0,0,1,0,-1
25916,1,1,204,1273,1069
25917,1,0,90,0,-90
25918,0,0,2,0,-2
25919,1,1,528,1529,1001
25920,0,0,42,0,-42
25921,0,0,2,0,-2
25922,0,0,24,0,-24
25923,0,0,1,0,-1
25924,1,1,1068,1939,871
25925,1,1,100,1201,1101
25926,1,1,175,1433,1258
25927,0,0,8,0,-8
25928,0,0,105,0,-105
25929,1,1,579,1243,664
25930,0,0,122,0,-122
25931,1,0,2,0,-2
25932,1,1,59,1713,1654
25933,0,0,40,0,-40
25934,1,0,125,0,-125
25935,0,0,15,0,-15
25936,0,0,28,0,-28
25937,1,0,130,0,-130
25938,1,0,0,0,0
25939,1,0,40,0,-40
25940,0,0,26,0,-26
25941,1,1,1173,1295,122
25942,1,1,947,1427,480
25943,1,0,26,0,-26
25944,1,1,210,1329,1119
25945,0,0,84,0,-84
25946,0,0,71,0,-71
25947,0,0,53,0,-53
25948,0,0,2,0,-2
25949,1,0,5,0,-5
25950,0,0,173,0,-173
25951,1,1,558,1391,833
25952,1,1,103,1710,1607
25953,1,0,22,0,-22
25954,0,0,40,0,-40
25955,1,0,92,0,-92
25956,0,0,28,0,-28
25957,0,0,4,0,-4
25958,1,1,1273,3413,2140
25959,1,0,63,0,-63
25960,0,0,16,0,-16
25961,0,0,43,0,-43
25962,0,0,42,0,-42
25963,0,0,112,0,-112
25964,1,0,35,0,-35
25965,1,1,535,1215,680
25966,1,1,67,1333,1266
25967,1,1,714,1650,936
25968,1,1,150,1461,1311
25969,0,0,58,0,-58
25970,1,0,40,0,-40
25971,1,1,45,1213,1168
25972,1,0,56,0,-56
25973,1,0,38,0,-38
25974,1,0,102,0,-102
25975,1,0,15,0,-15
25976,1,1,19,1309,1290
25977,1,1,29,1699,1670
25978,1,0,46,0,-46
25979,1,1,517,1222,705
25980,0,0,62,0,-62
25981,0,0,29,0,-29
25982,1,1,184,1322,1138
25983,0,0,98,0,-98
25984,0,0,7,0,-7
25985,0,0,72,0,-72
25986,0,0,2,0,-2
25987,1,0,94,0,-94
25988,1,0,79,0,-79
25989,1,1,958,2501,1543
25990,0,0,22,0,-22
25991,0,0,15,0,-15
25992,1,1,271,2923,2652
25993,0,0,36,0,-36
25994,1,0,27,0,-27
25995,0,0,110,0,-110
25996,1,0,28,0,-28
25997,1,1,969,1636,667
25998,1,0,121,0,-121
25999,0,0,29,0,-29
26000,0,0,161,0,-161
26001,0,0,42,0,-42
26002,1,1,105,1557,1452
26003,0,0,56,0,-56
26004,1,0,7,0,-7
26005,0,0,44,0,-44
26006,0,0,25,0,-25
26007,1,1,497,1731,1234
26008,1,1,576,1416,840
26009,1,0,6,0,-6
26010,0,0,78,0,-78
26011,1,1,986,2492,1506
26012,0,0,92,0,-92
26013,1,0,3,0,-3
26014,0,0,17,0,-17
26015,0,0,65,0,-65
26016,1,1,313,1263,950
26017,1,1,1029,1551,522
26018,1,0,23,0,-23
26019,0,0,21,0,-21
26020,1,0,86,0,-86
26021,1,1,230,2182,1952
26022,1,1,1094,1602,508
26023,0,0,115,0,-115
26024,0,0,29,0,-29
26025,1,0,67,0,-67
26026,0,0,76,0,-76
26027,1,0,100,0,-100
26028,0,0,18,0,-18
26029,1,0,9,0,-9
26030,1,0,26,0,-26
26031,1,1,626,1243,617
26032,1,1,984,1864,880
26033,0,0,223,0,-223
26034,0,0,180,0,-180
26035,1,1,521,1234,713
26036,1,0,28,0,-28
26037,1,1,1036,1268,232
26038,1,0,25,0,-25
26039,0,0,10,0,-10
26040,0,0,1,0,-1
26041,0,0,27,0,-27
26042,0,0,22,0,-22
26043,1,0,17,0,-17
26044,1,1,383,1626,1243
26045,0,0,10,0,-10
26046,0,0,2,0,-2
26047,1,1,157,2125,1968
26048,1,1,211,1295,1084
26049,1,0,50,0,-50
26050,1,0,50,0,-50
26051,1,0,31,0,-31
26052,0,0,19,0,-19
26053,1,0,22,0,-22
26054,0,0,7,0,-7
26055,0,0,2,0,-2
26056,0,0,35,0,-35
26057,1,0,48,0,-48
26058,1,0,12,0,-12
26059,1,0,70,0,-70
26060,0,0,19,0,-19
26061,1,0,200,0,-200
26062,1,0,124,0,-124
26063,0,0,37,0,-37
26064,1,0,47,0,-47
26065,1,0,158,0,-158
26066,1,0,5,0,-5
26067,1,1,123,1498,1375
26068,1,0,36,0,-36
26069,1,1,862,2152,1290
26070,0,0,36,0,-36
26071,0,0,48,0,-48
26072,0,0,7,0,-7
26073,1,1,1408,1587,179
26074,1,0,89,0,-89
26075,1,0,6,0,-6
26076,0,0,45,0,-45
26077,0,0,3,0,-3
26078,0,0,10,0,-10
26079,0,0,30,0,-30
26080,0,0,53,0,-53
26081,1,0,26,0,-26
26082,1,1,972,1935,963
26083,1,0,7,0,-7
26084,1,1,1743,1952,209
26085,0,0,34,0,-34
26086,0,0,18,0,-18
26087,1,1,317,1256,939
26088,1,0,33,0,-33
26089,1,0,13,0,-13
26090,1,1,71,1855,1784
26091,0,0,49,0,-49
26092,1,1,274,1408,1134
26093,0,0,165,0,-165
26094,1,0,7,0,-7
26095,0,0,76,0,-76
26096,0,0,39,0,-39
26097,0,0,80,0,-80
26098,0,0,19,0,-19
26099,1,1,221,2064,1843
26100,0,0,8,0,-8
26101,1,0,15,0,-15
26102,0,0,14,0,-14
26103,1,0,2,0,-2
26104,0,0,10,0,-10
26105,0,0,17,0,-17
26106,1,1,535,1418,883
26107,1,1,1063,1222,159
26108,1,0,104,0,-104
26109,0,0,8,0,-8
26110,1,0,119,0,-119
26111,1,0,31,0,-31
26112,1,0,134,0,-134
26113,1,0,22,0,-22
26114,1,0,106,0,-106
26115,1,0,2,0,-2
26116,0,0,17,0,-17
26117,1,0,15,0,-15
26118,1,1,222,1362,1140
26119,1,0,7,0,-7
26120,1,1,571,1462,891
26121,1,0,190,0,-190
26122,1,1,242,1379,1137
26123,0,0,17,0,-17
26124,0,0,96,0,-96
26125,1,1,429,1406,977
26126,1,1,406,1801,1395
26127,1,0,27,0,-27
26128,1,1,727,2203,1476
26129,1,0,69,0,-69
26130,1,1,274,1286,1012
26131,0,0,39,0,-39
26132,1,1,308,1212,904
26133,1,1,566,1318,752
26134,1,1,963,1211,248
26135,1,0,35,0,-35
26136,0,0,47,0,-47
26137,0,0,75,0,-75
26138,0,0,57,0,-57
26139,1,0,86,0,-86
26140,1,0,136,0,-136
26141,1,1,403,1360,957
26142,1,0,118,0,-118
26143,0,0,199,0,-199
26144,1,1,963,1536,573
26145,0,0,6,0,-6
26146,1,1,584,1549,965
26147,0,0,276,0,-276
26148,0,0,264,0,-264
26149,1,0,173,0,-173
26150,1,0,23,0,-23
26151,0,0,4,0,-4
26152,1,0,112,0,-112
26153,0,0,42,0,-42
26154,1,0,66,0,-66
26155,1,1,592,1347,755
26156,1,1,498,4768,4270
26157,1,0,10,0,-10
26158,0,0,237,0,-237
26159,0,0,42,0,-42
26160,0,0,58,0,-58
26161,1,1,176,2913,2737
26162,1,0,45,0,-45
26163,1,0,55,0,-55
26164,1,1,170,1381,1211
26165,0,0,74,0,-74
26166,1,0,101,0,-101
26167,1,1,331,1229,898
26168,0,0,3,0,-3
26169,0,0,109,0,-109
26170,1,0,41,0,-41
26171,1,1,362,1296,934
26172,1,0,1,0,-1
26173,0,0,62,0,-62
26174,1,0,123,0,-123
26175,1,0,58,0,-58
26176,0,0,39,0,-39
26177,0,0,79,0,-79
26178,1,0,12,0,-12
26179,1,0,139,0,-139
26180,1,0,3,0,-3
26181,0,0,115,0,-115
26182,1,0,75,0,-75
26183,0,0,24,0,-24
26184,1,0,49,0,-49
26185,1,1,163,1460,1297
26186,0,0,83,0,-83
26187,1,0,13,0,-13
26188,1,0,3,0,-3
26189,1,1,81,1765,1684
26190,1,0,26,0,-26
26191,0,0,35,0,-35
26192,0,0,18,0,-18
26193,1,0,3,0,-3
26194,0,0,69,0,-69
26195,1,0,22,0,-22
26196,1,0,67,0,-67
26197,0,0,11,0,-11
26198,1,1,1285,1214,-71
26199,1,0,41,0,-41
26200,1,1,445,2492,2047
26201,0,0,49,0,-49
26202,1,1,408,1701,1293
26203,0,0,54,0,-54
26204,1,0,69,0,-69
26205,0,0,30,0,-30
26206,1,1,578,1208,630
26207,1,1,788,1341,553
26208,1,1,118,1514,1396
26209,0,0,51,0,-51
26210,1,1,102,1521,1419
26211,1,0,12,0,-12
26212,1,0,83,0,-83
26213,0,0,106,0,-106
26214,1,0,7,0,-7
26215,0,0,24,0,-24
26216,1,1,190,1206,1016
26217,0,0,69,0,-69
26218,0,0,36,0,-36
26219,0,0,3,0,-3
26220,0,0,85,0,-85
26221,1,1,577,1261,684
26222,0,0,0,0,0
26223,1,0,84,0,-84
26224,1,0,61,0,-61
26225,1,1,113,1352,1239
26226,0,0,8,0,-8
26227,0,0,17,0,-17
26228,1,0,9,0,-9
26229,1,1,435,1930,1495
26230,1,1,1290,1264,-26
26231,1,0,14,0,-14
26232,1,0,34,0,-34
26233,0,0,123,0,-123
26234,0,0,62,0,-62
26235,0,0,74,0,-74
26236,1,1,900,1415,515
26237,1,0,45,0,-45
26238,0,0,21,0,-21
26239,0,0,52,0,-52
26240,1,1,644,1404,760
26241,1,0,35,0,-35
26242,1,0,59,0,-59
26243,1,0,41,0,-41
26244,1,1,238,1366,1128
26245,1,0,2,0,-2
26246,1,1,1016,1201,185
26247,0,0,67,0,-67
26248,1,1,142,1284,1142
26249,1,1,517,1226,709
26250,1,1,820,1312,492
26251,1,1,407,2299,1892
26252,1,1,28,1333,1305
26253,1,0,26,0,-26
26254,0,0,180,0,-180
26255,1,1,1461,1822,361
26256,1,1,312,2086,1774
26257,1,0,79,0,-79
26258,0,0,29,0,-29
26259,1,0,16,0,-16
26260,1,1,346,1431,1085
26261,0,0,11,0,-11
26262,1,1,589,1364,775
26263,0,0,28,0,-28
26264,0,0,18,0,-18
26265,1,1,617,1421,804
26266,1,1,660,1330,670
26267,0,0,60,0,-60
26268,1,1,346,3204,2858
26269,0,0,51,0,-51
26270,1,1,394,1238,844
26271,0,0,32,0,-32
26272,0,0,4,0,-4
26273,1,1,1310,1364,54
26274,1,1,592,1223,631
26275,1,1,1380,2205,825
26276,0,0,0,0,0
26277,0,0,80,0,-80
26278,1,1,238,2370,2132
26279,1,1,522,1754,1232
26280,1,1,1617,1205,-412
26281,1,1,100,1366,1266
26282,0,0,115,0,-115
26283,1,0,104,0,-104
26284,1,0,57,0,-57
26285,0,0,54,0,-54
26286,0,0,68,0,-68
26287,0,0,22,0,-22
26288,1,0,38,0,-38
26289,1,0,88,0,-88
26290,1,1,601,2795,2194
26291,1,1,328,1295,967
26292,1,1,244,1495,1251
26293,0,0,8,0,-8
26294,0,0,32,0,-32
26295,1,0,10,0,-10
26296,1,0,55,0,-55
26297,0,0,0,0,0
26298,0,0,45,0,-45
26299,1,1,156,1440,1284
26300,0,0,60,0,-60
26301,1,0,27,0,-27
26302,0,0,59,0,-59
26303,1,1,2352,1367,-985
26304,0,0,18,0,-18
26305,1,1,223,1399,1176
26306,1,0,49,0,-49
26307,0,0,87,0,-87
26308,0,0,83,0,-83
26309,1,1,97,1451,1354
26310,1,1,484,1314,830
26311,0,0,6,0,-6
26312,1,1,165,1751,1586
26313,1,1,240,1923,1683
26314,0,0,57,0,-57
26315,1,1,765,2176,1411
26316,0,0,56,0,-56
26317,1,1,581,1338,757
26318,1,0,11,0,-11
26319,0,0,89,0,-89
26320,0,0,15,0,-15
26321,1,1,340,1249,909
26322,0,0,22,0,-22
26323,0,0,12,0,-12
26324,1,1,216,1598,1382
26325,1,0,20,0,-20
26326,0,0,12,0,-12
26327,1,1,34,1517,1483
26328,1,1,493,1362,869
26329,1,1,817,1287,470
26330,0,0,183,0,-183
26331,0,0,29,0,-29
26332,1,0,7,0,-7
26333,0,0,70,0,-70
26334,0,0,79,0,-79
26335,1,0,31,0,-31
26336,0,0,1,0,-1
26337,1,1,517,1327,810
26338,0,0,48,0,-48
26339,1,0,21,0,-21
26340,1,0,35,0,-35
26341,1,0,170,0,-170
26342,1,1,1684,1487,-197
26343,1,0,126,0,-126
26344,1,1,392,3241,2849
26345,0,0,147,0,-147
26346,0,0,64,0,-64
26347,0,0,27,0,-27
26348,1,1,392,1394,1002
26349,1,1,290,1875,1585
26350,1,0,15,0,-15
26351,0,0,67,0,-67
26352,0,0,18,0,-18
26353,1,0,33,0,-33
26354,1,1,78,1469,1391
26355,1,0,27,0,-27
26356,0,0,55,0,-55
26357,1,0,13,0,-13
26358,1,1,401,1435,1034
26359,1,0,5,0,-5
26360,1,0,32,0,-32
26361,0,0,35,0,-35
26362,0,0,11,0,-11
26363,1,0,57,0,-57
26364,0,0,45,0,-45
26365,0,0,54,0,-54
26366,0,0,52,0,-52
26367,1,1,135,1212,1077
26368,1,0,36,0,-36
26369,0,0,28,0,-28
26370,0,0,32,0,-32
26371,0,0,87,0,-87
26372,0,0,28,0,-28
26373,1,0,54,0,-54
26374,1,1,436,1806,1370
26375,1,0,6,0,-6
26376,0,0,49,0,-49
26377,1,0,18,0,-18
26378,0,0,7,0,-7
26379,1,1,526,2084,1558
26380,0,0,143,0,-143
26381,0,0,33,0,-33
26382,1,1,1110,1507,397
26383,1,0,16,0,-16
26384,0,0,29,0,-29
26385,0,0,11,0,-11
26386,0,0,58,0,-58
26387,1,0,112,0,-112
26388,0,0,97,0,-97
26389,1,0,66,0,-66
26390,0,0,116,0,-116
26391,1,1,113,1225,1112
26392,1,1,584,1248,664
26393,1,0,50,0,-50
26394,1,0,174,0,-174
26395,1,1,601,1237,636
26396,0,0,239,0,-239
26397,1,1,86,1953,1867
26398,0,0,9,0,-9
26399,1,1,181,1451,1270
26400,1,0,97,0,-97
26401,1,0,94,0,-94
26402,1,0,78,0,-78
26403,1,0,108,0,-108
26404,0,0,0,0,0
26405,0,0,23,0,-23
26406,0,0,31,0,-31
26407,0,0,47,0,-47
26408,1,1,195,1357,1162
26409,1,1,607,2449,1842
26410,1,0,68,0,-68
26411,1,0,19,0,-19
26412,1,1,1082,1456,374
26413,0,0,165,0,-165
26414,1,0,9,0,-9
26415,1,0,2,0,-2
26416,1,0,38,0,-38
26417,0,0,23,0,-23
26418,0,0,64,0,-64
26419,1,1,887,1244,357
26420,1,0,48,0,-48
26421,1,1,537,1340,803
26422,0,0,1,0,-1
26423,0,0,14,0,-14
26424,0,0,131,0,-131
26425,1,0,22,0,-22
26426,0,0,69,0,-69
26427,1,1,201,1209,1008
26428,0,0,12,0,-12
26429,1,1,200,1604,1404
26430,1,1,3942,1450,-2492
26431,1,1,415,1312,897
26432,0,0,210,0,-210
26433,1,1,115,1852,1737
26434,1,1,335,1265,930
26435,0,0,3,0,-3
26436,0,0,165,0,-165
26437,1,1,345,1425,1080
26438,0,0,15,0,-15
26439,0,0,3,0,-3
26440,1,0,55,0,-55
26441,1,1,975,1863,888
26442,0,0,26,0,-26
26443,0,0,71,0,-71
26444,1,1,161,1341,1180
26445,1,1,175,1441,1266
26446,1,1,138,1401,1263
26447,0,0,11,0,-11
26448,1,0,36,0,-36
26449,1,0,47,0,-47
26450,0,0,83,0,-83
26451,1,1,770,1379,609
26452,1,1,457,1261,804
26453,1,1,115,1710,1595
26454,1,0,52,0,-52
26455,1,1,410,1357,947
26456,0,0,132,0,-132
26457,1,1,410,1232,822
26458,1,1,783,1583,800
26459,0,0,6,0,-6
26460,0,0,49,0,-49
26461,0,0,66,0,-66
26462,1,1,125,1362,1237
26463,1,0,2,0,-2
26464,0,0,58,0,-58
26465,0,0,62,0,-62
26466,1,1,1355,1406,51
26467,1,1,2292,2061,-231
26468,1,1,943,1225,282
26469,1,1,764,1655,891
26470,1,0,132,0,-132
26471,1,0,58,0,-58
26472,1,0,8,0,-8
26473,0,0,14,0,-14
26474,0,0,20,0,-20
26475,1,1,152,1501,1349
26476,1,1,66,1602,1536
26477,0,0,28,0,-28
26478,1,1,253,1266,1013
26479,1,1,412,1477,1065
26480,0,0,79,0,-79
26481,1,0,100,0,-100
26482,0,0,21,0,-21
26483,1,0,55,0,-55
26484,0,0,40,0,-40
26485,0,0,45,0,-45
26486,1,1,756,1316,560
26487,1,1,1008,1311,303
26488,1,1,365,1476,1111
26489,1,0,43,0,-43
26490,0,0,38,0,-38
26491,1,0,50,0,-50
26492,1,0,33,0,-33
26493,1,1,735,1634,899
26494,1,1,461,1590,1129
26495,0,0,48,0,-48
26496,1,0,89,0,-89
26497,0,0,196,0,-196
26498,1,1,149,1238,1089
26499,0,0,31,0,-31
26500,0,0,96,0,-96
26501,0,0,13,0,-13
26502,1,0,97,0,-97
26503,0,0,86,0,-86
26504,1,1,2204,1238,-966
26505,0,0,20,0,-20
26506,1,0,1,0,-1
26507,0,0,10,0,-10
26508,1,1,692,1781,1089
26509,1,1,430,1408,978
26510,1,1,1342,1369,27
26511,1,1,499,1627,1128
26512,1,0,39,0,-39
26513,1,0,16,0,-16
26514,0,0,72,0,-72
26515,1,0,24,0,-24
26516,1,0,5,0,-5
26517,0,0,12,0,-12
26518,1,0,3,0,-3
26519,0,0,13,0,-13
26520,1,0,31,0,-31
26521,1,1,3014,1453,-1561
26522,1,0,13,0,-13
26523,1,1,97,1615,1518
26524,0,0,13,0,-13
26525,1,0,202,0,-202
26526,0,0,227,0,-227
26527,0,0,70,0,-70
26528,1,1,322,1590,1268
26529,1,0,48,0,-48
26530,0,0,19,0,-19
26531,1,1,569,1621,1052
26532,1,1,246,1250,1004
26533,0,0,33,0,-33
26534,0,0,13,0,-13
26535,0,0,10,0,-10
26536,1,0,67,0,-67
26537,1,0,26,0,-26
26538,1,0,214,0,-214
26539,1,1,1434,1532,98
26540,1,0,13,0,-13
26541,1,0,81,0,-81
26542,1,0,13,0,-13
26543,1,0,20,0,-20
26544,0,0,41,0,-41
26545,0,0,80,0,-80
26546,1,0,107,0,-107
26547,1,1,167,1376,1209
26548,0,0,16,0,-16
26549,0,0,18,0,-18
26550,1,0,19,0,-19
26551,0,0,81,0,-81
26552,0,0,3,0,-3
26553,1,1,109,2180,2071
26554,1,0,102,0,-102
26555,1,0,107,0,-107
26556,1,1,43,1233,1190
26557,0,0,40,0,-40
26558,1,1,877,1200,323
26559,0,0,7,0,-7
26560,1,0,38,0,-38
26561,0,0,121,0,-121
26562,0,0,143,0,-143
26563,0,0,115,0,-115
26564,1,1,145,1403,1258
26565,1,0,0,0,0
26566,0,0,84,0,-84
26567,0,0,18,0,-18
26568,0,0,56,0,-56
26569,0,0,42,0,-42
26570,1,1,399,1245,846
26571,1,0,207,0,-207
26572,0,0,18,0,-18
26573,1,0,57,0,-57
26574,1,1,2738,1497,-1241
26575,0,0,36,0,-36
26576,0,0,137,0,-137
26577,0,0,5,0,-5
26578,1,0,29,0,-29
26579,1,1,265,1235,970
26580,0,0,3,0,-3
26581,0,0,31,0,-31
26582,1,1,181,2223,2042
26583,0,0,88,0,-88
26584,1,1,1445,1320,-125
26585,0,0,102,0,-102
26586,1,0,14,0,-14
26587,1,0,127,0,-127
26588,0,0,58,0,-58
26589,1,0,241,0,-241
26590,1,1,398,1294,896
26591,0,0,126,0,-126
26592,0,0,1,0,-1
26593,0,0,20,0,-20
26594,1,1,201,1556,1355
26595,0,0,58,0,-58
26596,0,0,16,0,-16
26597,0,0,30,0,-30
26598,1,1,687,1481,794
26599,1,0,83,0,-83
26600,1,1,690,1450,760
26601,0,0,57,0,-57
26602,1,0,281,0,-281
26603,0,0,38,0,-38
26604,0,0,67,0,-67
26605,0,0,17,0,-17
26606,0,0,81,0,-81
26607,0,0,35,0,-35
26608,0,0,5,0,-5
26609,1,0,43,0,-43
26610,1,0,4,0,-4
26611,0,0,105,0,-105
26612,0,0,83,0,-83
26613,1,0,32,0,-32
26614,1,0,31,0,-31
26615,0,0,17,0,-17
26616,1,1,40,1465,1425
26617,1,0,113,0,-113
26618,0,0,13,0,-13
26619,1,1,221,1253,1032
26620,0,0,67,0,-67
26621,1,0,29,0,-29
26622,1,0,66,0,-66
26623,1,1,186,1489,1303
26624,1,0,3,0,-3
26625,0,0,8,0,-8
26626,0,0,46,0,-46
26627,1,0,34,0,-34
26628,1,1,963,1424,461
26629,1,1,618,1495,877
26630,1,1,45,1507,1462
26631,1,1,553,1260,707
26632,1,0,47,0,-47
26633,1,1,110,1225,1115
26634,1,0,41,0,-41
26635,0,0,3,0,-3
26636,1,1,612,1335,723
26637,0,0,23,0,-23
26638,0,0,45,0,-45
26639,0,0,23,0,-23
26640,0,0,214,0,-214
26641,1,0,12,0,-12
26642,1,1,454,1822,1368
26643,0,0,86,0,-86
26644,0,0,76,0,-76
26645,1,1,89,1239,1150
26646,1,1,404,1249,845
26647,1,0,6,0,-6
26648,1,1,403,2552,2149
26649,0,0,3,0,-3
26650,1,0,64,0,-64
26651,1,0,247,0,-247
26652,1,1,61,2380,2319
26653,0,0,14,0,-14
26654,0,0,17,0,-17
26655,1,0,20,0,-20
26656,1,1,471,1366,895
26657,1,0,21,0,-21
26658,0,0,61,0,-61
26659,0,0,24,0,-24
26660,0,0,46,0,-46
26661,1,1,256,1948,1692
26662,1,0,7,0,-7
26663,0,0,58,0,-58
26664,1,1,134,1706,1572
26665,0,0,14,0,-14
26666,1,0,9,0,-9
26667,1,0,18,0,-18
26668,0,0,36,0,-36
26669,0,0,1,0,-1
26670,1,1,512,1681,1169
26671,1,1,180,1540,1360
26672,1,1,35,1221,1186
26673,1,1,276,1476,1200
26674,0,0,54,0,-54
26675,1,1,894,1381,487
26676,1,1,919,1480,561
26677,1,1,187,1306,1119
26678,0,0,4,0,-4
26679,0,0,112,0,-112
26680,0,0,43,0,-43
26681,0,0,17,0,-17
26682,1,1,589,1536,947
26683,0,0,101,0,-101
26684,1,1,440,1876,1436
26685,0,0,109,0,-109
26686,1,1,412,1502,1090
26687,1,1,205,1323,1118
26688,1,0,60,0,-60
26689,0,0,65,0,-65
26690,0,0,33,0,-33
26691,1,1,123,1613,1490
26692,0,0,91,0,-91
26693,0,0,25,0,-25
26694,0,0,8,0,-8
26695,1,0,12,0,-12
26696,1,0,86,0,-86
26697,1,1,496,1310,814
26698,1,1,401,1240,839
26699,1,0,33,0,-33
26700,1,1,933,1305,372
26701,0,0,15,0,-15
26702,1,1,1251,1479,228
26703,1,0,40,0,-40
26704,1,0,12,0,-12
26705,1,0,7,0,-7
26706,1,0,24,0,-24
26707,1,0,42,0,-42
26708,1,1,2079,1257,-822
26709,0,0,19,0,-19
26710,0,0,125,0,-125
26711,1,0,31,0,-31
26712,0,0,100,0,-100
26713,1,0,33,0,-33
26714,1,1,866,1331,465
26715,1,0,138,0,-138
26716,0,0,166,0,-166
26717,0,0,97,0,-97
26718,1,1,191,1402,1211
26719,1,0,125,0,-125
26720,1,0,5,0,-5
26721,1,1,40,1207,1167
26722,1,0,120,0,-120
26723,0,0,20,0,-20
26724,1,0,41,0,-41
26725,1,0,40,0,-40
26726,1,0,10,0,-10
26727,1,1,681,1242,561
26728,1,1,983,1201,218
26729,0,0,46,0,-46
26730,0,0,61,0,-61
26731,1,0,95,0,-95
26732,0,0,5,0,-5
26733,0,0,42,0,-42
26734,1,1,42,1274,1232
26735,0,0,48,0,-48
26736,1,0,28,0,-28
26737,1,1,319,1226,907
26738,0,0,15,0,-15
26739,0,0,31,0,-31
26740,0,0,20,0,-20
26741,1,1,230,1699,1469
26742,1,0,14,0,-14
26743,1,0,53,0,-53
26744,0,0,17,0,-17
26745,1,1,1583,1268,-315
26746,1,1,24,5265,5241
26747,0,0,36,0,-36
26748,1,0,27,0,-27
26749,0,0,126,0,-126
26750,0,0,4,0,-4
26751,1,0,76,0,-76
26752,0,0,204,0,-204
26753,1,0,13,0,-13
26754,1,1,264,1309,1045
26755,0,0,33,0,-33
26756,1,0,133,0,-133
26757,1,0,151,0,-151
26758,1,1,207,1440,1233
26759,1,0,55,0,-55
26760,0,0,30,0,-30
26761,1,1,307,1247,940
26762,1,1,592,1517,925
26763,1,1,67,1238,1171
26764,1,0,31,0,-31
26765,0,0,19,0,-19
26766,1,0,7,0,-7
26767,1,1,713,2064,1351
26768,1,1,207,1288,1081
26769,0,0,60,0,-60
26770,1,1,314,1339,1025
26771,1,0,5,0,-5
26772,0,0,32,0,-32
26773,0,0,391,0,-391
26774,1,0,25,0,-25
26775,1,0,95,0,-95
26776,0,0,57,0,-57
26777,1,0,45,0,-45
26778,0,0,16,0,-16
26779,1,0,69,0,-69
26780,0,0,82,0,-82
26781,1,1,167,1455,1288
26782,1,1,353,1392,1039
26783,1,1,272,1730,1458
26784,0,0,21,0,-21
26785,0,0,69,0,-69
26786,1,1,125,1329,1204
26787,0,0,0,0,0
26788,0,0,10,0,-10
26789,1,1,122,1378,1256
26790,1,0,65,0,-65
26791,0,0,10,0,-10
26792,0,0,110,0,-110
26793,0,0,66,0,-66
26794,1,1,322,1301,979
26795,1,0,15,0,-15
26796,1,0,76,0,-76
26797,0,0,31,0,-31
26798,1,1,212,1246,1034
26799,1,0,0,0,0
26800,1,1,511,2204,1693
26801,0,0,4,0,-4
26802,1,1,553,1242,689
26803,1,1,150,1257,1107
26804,0,0,13,0,-13
26805,1,1,1002,1577,575
26806,1,1,141,1211,1070
26807,1,1,824,1283,459
26808,1,1,237,1493,1256
26809,0,0,45,0,-45
26810,0,0,28,0,-28
26811,0,0,11,0,-11
26812,0,0,23,0,-23
26813,1,0,16,0,-16
26814,1,0,35,0,-35
26815,1,1,319,1291,972
26816,1,1,310,1286,976
26817,1,1,73,1490,1417
26818,1,1,120,1469,1349
26819,0,0,65,0,-65
26820,0,0,12,0,-12
26821,1,1,327,1453,1126
26822,0,0,10,0,-10
26823,1,0,1,0,-1
26824,1,1,974,2218,1244
26825,0,0,25,0,-25
26826,1,1,401,1307,906
26827,1,0,5,0,-5
26828,0,0,12,0,-12
26829,1,1,147,1508,1361
26830,1,1,726,1203,477
26831,0,0,6,0,-6
26832,1,0,1,0,-1
26833,0,0,106,0,-106
26834,1,1,324,1672,1348
26835,1,0,52,0,-52
26836,0,0,38,0,-38
26837,1,1,680,1200,520
26838,1,0,0,0,0
26839,0,0,41,0,-41
26840,0,0,24,0,-24
26841,1,1,857,1227,370
26842,1,0,172,0,-172
26843,1,1,1009,1375,366
26844,0,0,3,0,-3
26845,1,0,55,0,-55
26846,1,1,216,1448,1232
26847,1,0,131,0,-131
26848,1,1,464,1333,869
26849,0,0,30,0,-30
26850,1,0,70,0,-70
26851,1,1,2001,1367,-634
26852,1,0,137,0,-137
26853,0,0,1,0,-1
26854,1,0,12,0,-12
26855,0,0,121,0,-121
26856,0,0,73,0,-73
26857,0,0,51,0,-51
26858,0,0,5,0,-5
26859,1,1,1059,1304,245
26860,1,1,189,1483,1294
26861,1,0,27,0,-27
26862,1,1,264,1321,1057
26863,1,1,386,1220,834
26864,1,0,20,0,-20
26865,1,0,148,0,-148
26866,0,0,54,0,-54
26867,0,0,82,0,-82
26868,0,0,54,0,-54
26869,1,0,6,0,-6
26870,1,1,45,1676,1631
26871,1,0,120,0,-120
26872,1,1,201,1288,1087
26873,0,0,38,0,-38
26874,0,0,35,0,-35
26875,1,0,203,0,-203
26876,0,0,13,0,-13
26877,1,0,55,0,-55
26878,1,0,146,0,-146
26879,1,0,91,0,-91
26880,0,0,58,0,-58
26881,1,1,211,1743,1532
26882,1,1,212,1394,1182
26883,1,1,895,1365,470
26884,1,1,370,1368,998
26885,0,0,2,0,-2
26886,1,0,45,0,-45
26887,1,1,246,1889,1643
26888,1,1,115,1319,1204
26889,0,0,37,0,-37
26890,1,1,395,1444,1049
26891,0,0,0,0,0
26892,1,0,39,0,-39
26893,1,0,99,0,-99
26894,0,0,33,0,-33
26895,1,0,87,0,-87
26896,1,1,331,1253,922
26897,0,0,30,0,-30
26898,1,0,34,0,-34
26899,0,0,38,0,-38
26900,1,0,44,0,-44
26901,1,0,61,0,-61
26902,1,0,102,0,-102
26903,1,0,44,0,-44
26904,1,1,228,2416,2188
26905,0,0,2,0,-2
26906,0,0,69,0,-69
26907,1,1,189,1214,1025
26908,1,1,1799,1227,-572
26909,0,0,36,0,-36
26910,0,0,0,0,0
26911,0,0,7,0,-7
26912,1,0,14,0,-14
26913,1,0,86,0,-86
26914,0,0,88,0,-88
26915,1,0,30,0,-30
26916,1,1,97,1952,1855
26917,1,0,58,0,-58
26918,1,1,606,1424,818
26919,0,0,61,0,-61
26920,1,0,10,0,-10
26921,1,1,264,1229,965
26922,1,0,7,0,-7
26923,0,0,73,0,-73
26924,1,1,260,1454,1194
26925,1,1,610,1307,697
26926,0,0,31,0,-31
26927,1,0,101,0,-101
26928,0,0,74,0,-74
26929,1,1,940,1302,362
26930,1,0,2,0,-2
26931,1,1,8,1286,1278
26932,1,1,104,1376,1272
26933,0,0,1,0,-1
26934,1,0,23,0,-23
26935,1,0,13,0,-13
26936,0,0,51,0,-51
26937,0,0,76,0,-76
26938,0,0,5,0,-5
26939,1,1,323,1289,966
26940,1,1,1518,1240,-278
26941,0,0,22,0,-22
26942,0,0,187,0,-187
26943,0,0,70,0,-70
26944,0,0,27,0,-27
26945,0,0,10,0,-10
26946,0,0,115,0,-115
26947,0,0,35,0,-35
26948,1,1,998,1437,439
26949,1,0,68,0,-68
26950,0,0,16,0,-16
26951,1,1,1316,1386,70
26952,0,0,10,0,-10
26953,0,0,50,0,-50
26954,0,0,36,0,-36
26955,0,0,9,0,-9
26956,1,1,136,1467,1331
26957,0,0,0,0,0
26958,0,0,11,0,-11
26959,1,0,11,0,-11
26960,0,0,123,0,-123
26961,1,0,9,0,-9
26962,0,0,25,0,-25
26963,1,1,161,1480,1319
26964,0,0,38,0,-38
26965,1,1,413,1410,997
26966,0,0,142,0,-142
26967,0,0,61,0,-61
26968,0,0,1,0,-1
26969,0,0,48,0,-48
26970,0,0,55,0,-55
26971,1,1,1653,1248,-405
26972,0,0,5,0,-5
26973,0,0,45,0,-45
26974,1,0,141,0,-141
26975,1,1,685,2007,1322
26976,0,0,22,0,-22
26977,1,1,700,1466,766
26978,1,0,4,0,-4
26979,1,0,71,0,-71
26980,1,1,509,1388,879
26981,1,1,1671,1610,-61
26982,1,1,79,1257,1178
26983,1,1,353,1255,902
26984,0,0,21,0,-21
26985,1,1,313,1894,1581
26986,1,0,57,0,-57
26987,1,0,58,0,-58
26988,0,0,34,0,-34
26989,1,0,38,0,-38
26990,1,0,16,0,-16
26991,1,0,32,0,-32
26992,0,0,36,0,-36
26993,1,1,1805,1234,-571
26994,0,0,8,0,-8
26995,0,0,101,0,-101
26996,1,0,45,0,-45
26997,1,0,19,0,-19
26998,1,1,1029,1347,318
26999,0,0,30,0,-30
27000,1,0,57,0,-57
27001,1,0,21,0,-21
27002,1,1,355,1347,992
27003,1,0,12,0,-12
27004,1,1,1242,2163,921
27005,1,0,12,0,-12
27006,1,0,42,0,-42
27007,0,0,45,0,-45
27008,1,0,116,0,-116
27009,1,1,411,1536,1125
27010,0,0,67,0,-67
27011,1,1,474,1423,949
27012,1,1,782,1367,585
27013,1,1,457,1621,1164
27014,1,0,47,0,-47
27015,0,0,92,0,-92
27016,0,0,20,0,-20
27017,0,0,124,0,-124
27018,1,1,271,1254,983
27019,0,0,122,0,-122
27020,0,0,11,0,-11
27021,0,0,11,0,-11
27022,1,0,8,0,-8
27023,0,0,17,0,-17
27024,1,1,435,1878,1443
27025,1,0,80,0,-80
27026,1,1,351,1493,1142
27027,0,0,90,0,-90
27028,0,0,80,0,-80
27029,1,0,83,0,-83
27030,0,0,0,0,0
27031,0,0,16,0,-16
27032,1,1,304,1517,1213
27033,0,0,8,0,-8
27034,0,0,13,0,-13
27035,1,0,53,0,-53
27036,0,0,7,0,-7
27037,1,0,166,0,-166
27038,1,1,164,1964,1800
27039,1,0,66,0,-66
27040,0,0,53,0,-53
27041,1,1,1219,1319,100
27042,1,1,1026,1433,407
27043,1,1,239,2516,2277
27044,1,0,12,0,-12
27045,1,1,400,7383,6983
27046,0,0,162,0,-162
27047,1,0,8,0,-8
27048,0,0,2,0,-2
27049,1,1,1314,1223,-91
27050,0,0,12,0,-12
27051,0,0,5,0,-5
27052,1,0,17,0,-17
27053,0,0,54,0,-54
27054,1,1,484,1590,1106
27055,1,1,343,1472,1129
27056,0,0,69,0,-69
27057,1,1,181,1800,1619
27058,1,0,6,0,-6
27059,0,0,131,0,-131
27060,0,0,5,0,-5
27061,1,1,813,1261,448
27062,1,1,587,1206,619
27063,0,0,4,0,-4
27064,1,1,648,1306,658
27065,1,0,1,0,-1
27066,0,0,161,0,-161
27067,1,1,409,1608,1199
27068,1,1,178,1294,1116
27069,0,0,117,0,-117
27070,0,0,80,0,-80
27071,0,0,121,0,-121
27072,1,0,19,0,-19
27073,1,0,90,0,-90
27074,1,0,102,0,-102
27075,1,0,6,0,-6
27076,1,1,248,1471,1223
27077,1,1,267,1288,1021
27078,1,1,1233,2953,1720
27079,0,0,5,0,-5
27080,0,0,56,0,-56
27081,1,1,119,1856,1737
27082,1,1,612,1202,590
27083,1,1,357,1845,1488
27084,1,1,810,1228,418
27085,0,0,49,0,-49
27086,0,0,52,0,-52
27087,0,0,57,0,-57
27088,0,0,33,0,-33
27089,0,0,121,0,-121
27090,0,0,62,0,-62
27091,1,1,156,1222,1066
27092,1,0,125,0,-125
27093,0,0,70,0,-70
27094,1,0,30,0,-30
27095,0,0,12,0,-12
27096,1,0,53,0,-53
27097,1,1,592,1639,1047
27098,1,1,839,1223,384
27099,0,0,50,0,-50
27100,1,0,36,0,-36
27101,1,1,963,1226,263
27102,0,0,37,0,-37
27103,1,1,1774,2990,1216
27104,0,0,11,0,-11
27105,1,0,4,0,-4
27106,1,1,279,1262,983
27107,1,0,83,0,-83
27108,0,0,10,0,-10
27109,1,0,59,0,-59
27110,1,1,145,1724,1579
27111,0,0,68,0,-68
27112,0,0,173,0,-173
27113,0,0,18,0,-18
27114,1,1,119,1909,1790
27115,0,0,0,0,0
27116,1,0,37,0,-37
27117,1,0,90,0,-90
27118,0,0,18,0,-18
27119,1,1,615,1368,753
27120,1,1,80,1478,1398
27121,1,1,1096,1697,601
27122,1,0,7,0,-7
27123,0,0,8,0,-8
27124,1,1,110,1414,1304
27125,1,0,36,0,-36
27126,0,0,30,0,-30
27127,1,0,4,0,-4
27128,0,0,20,0,-20
27129,0,0,95,0,-95
27130,0,0,15,0,-15
27131,1,0,9,0,-9
27132,1,1,811,1443,632
27133,0,0,35,0,-35
27134,1,0,63,0,-63
27135,1,0,81,0,-81
27136,1,0,7,0,-7
27137,1,1,277,1308,1031
27138,0,0,66,0,-66
27139,0,0,15,0,-15
27140,0,0,7,0,-7
27141,1,1,446,1295,849
27142,1,0,42,0,-42
27143,1,1,73,2404,2331
27144,1,0,0,0,0
27145,1,0,16,0,-16
27146,1,0,2,0,-2
27147,1,0,8,0,-8
27148,0,0,47,0,-47
27149,1,1,178,1366,1188
27150,1,1,570,2041,1471
27151,1,0,131,0,-131
27152,1,1,1127,1760,633
27153,1,1,511,1581,1070
27154,1,0,193,0,-193
27155,1,1,1723,2037,314
27156,1,0,137,0,-137
27157,1,0,127,0,-127
27158,0,0,86,0,-86
27159,0,0,34,0,-34
27160,1,0,36,0,-36
27161,1,1,500,1745,1245
27162,0,0,4,0,-4
27163,0,0,7,0,-7
27164,1,1,242,1440,1198
27165,1,0,88,0,-88
27166,1,1,202,1242,1040
27167,1,0,31,0,-31
27168,1,0,174,0,-174
27169,1,0,38,0,-38
27170,1,1,913,1552,639
27171,1,1,277,2183,1906
27172,1,1,270,1649,1379
27173,0,0,23,0,-23
27174,1,1,375,1282,907
27175,0,0,11,0,-11
27176,1,1,177,1273,1096
27177,1,1,499,1293,794
27178,0,0,81,0,-81
27179,0,0,33,0,-33
27180,0,0,12,0,-12
27181,1,1,216,1826,1610
27182,1,1,113,1589,1476
27183,1,1,85,1257,1172
27184,1,0,53,0,-53
27185,0,0,44,0,-44
27186,1,0,10,0,-10
27187,1,0,18,0,-18
27188,1,0,83,0,-83
27189,1,1,1334,1857,523
27190,1,0,58,0,-58
27191,0,0,23,0,-23
27192,0,0,11,0,-11
27193,1,0,1,0,-1
27194,0,0,233,0,-233
27195,1,0,113,0,-113
27196,0,0,63,0,-63
27197,1,0,36,0,-36
27198,1,1,813,1677,864
27199,1,1,484,2105,1621
27200,1,0,111,0,-111
27201,1,0,5,0,-5
27202,0,0,72,0,-72
27203,1,0,64,0,-64
27204,1,1,1324,1446,122
27205,0,0,53,0,-53
27206,0,0,75,0,-75
27207,1,0,93,0,-93
27208,1,1,83,2227,2144
27209,1,0,51,0,-51
27210,0,0,72,0,-72
27211,1,1,218,1511,1293
27212,1,0,44,0,-44
27213,0,0,33,0,-33
27214,1,1,420,1939,1519
27215,1,1,798,1386,588
27216,1,0,40,0,-40
27217,0,0,46,0,-46
27218,1,0,11,0,-11
27219,0,0,45,0,-45
27220,1,0,48,0,-48
27221,1,1,509,1379,870
27222,1,0,73,0,-73
27223,0,0,6,0,-6
27224,1,0,20,0,-20
27225,0,0,4,0,-4
27226,1,0,5,0,-5
27227,1,0,17,0,-17
27228,1,0,195,0,-195
27229,1,0,2,0,-2
27230,1,0,19,0,-19
27231,0,0,10,0,-10
27232,0,0,122,0,-122
27233,1,0,188,0,-188
27234,1,1,171,1459,1288
27235,0,0,105,0,-105
27236,1,0,15,0,-15
27237,1,0,3,0,-3
27238,1,1,368,1561,1193
27239,1,1,176,1590,1414
27240,0,0,27,0,-27
27241,1,1,102,1268,1166
27242,1,1,383,1612,1229
27243,1,1,199,2027,1828
27244,1,0,219,0,-219
27245,0,0,7,0,-7
27246,1,1,439,1644,1205
27247,1,0,7,0,-7
27248,1,1,161,1400,1239
27249,1,0,7,0,-7
27250,1,0,71,0,-71
27251,1,0,116,0,-116
27252,1,0,31,0,-31
27253,0,0,13,0,-13
27254,0,0,50,0,-50
27255,0,0,22,0,-22
27256,1,1,624,3216,2592
27257,1,1,56,1468,1412
27258,0,0,34,0,-34
27259,0,0,79,0,-79
27260,0,0,93,0,-93
27261,1,0,160,0,-160
27262,0,0,3,0,-3
27263,1,0,165,0,-165
27264,1,0,85,0,-85
27265,1,1,215,1421,1206
27266,0,0,2,0,-2
27267,1,0,21,0,-21
27268,0,0,31,0,-31
27269,1,0,0,0,0
27270,1,1,398,1270,872
27271,1,0,6,0,-6
27272,0,0,50,0,-50
27273,1,1,217,1315,1098
27274,1,1,50,2202,2152
27275,0,0,72,0,-72
27276,0,0,89,0,-89
27277,0,0,7,0,-7
27278,0,0,56,0,-56
27279,0,0,39,0,-39
27280,1,1,844,1554,710
27281,1,0,31,0,-31
27282,1,0,118,0,-118
27283,1,0,4,0,-4
27284,0,0,47,0,-47
27285,1,1,12,1334,1322
27286,1,0,62,0,-62
27287,0,0,23,0,-23
27288,1,0,67,0,-67
27289,0,0,29,0,-29
27290,1,0,20,0,-20
27291,1,0,75,0,-75
27292,0,0,36,0,-36
27293,0,0,6,0,-6
27294,1,1,581,1317,736
27295,1,1,525,1213,688
27296,1,1,334,3007,2673
27297,0,0,119,0,-119
27298,0,0,46,0,-46
27299,1,1,138,1223,1085
27300,0,0,29,0,-29
27301,0,0,5,0,-5
27302,0,0,17,0,-17
27303,1,1,567,1331,764
27304,1,1,719,1311,592
27305,1,0,130,0,-130
27306,1,0,29,0,-29
27307,0,0,57,0,-57
27308,1,0,12,0,-12
27309,1,0,24,0,-24
27310,0,0,9,0,-9
27311,0,0,67,0,-67
27312,1,0,31,0,-31
27313,0,0,4,0,-4
27314,1,0,0,0,0
27315,1,0,37,0,-37
27316,1,1,145,1770,1625
27317,1,1,1323,1975,652
27318,1,1,1090,1234,144
27319,0,0,17,0,-17
27320,0,0,49,0,-49
27321,0,0,63,0,-63
27322,0,0,119,0,-119
27323,0,0,4,0,-4
27324,1,0,2,0,-2
27325,1,0,19,0,-19
27326,0,0,27,0,-27
27327,1,0,51,0,-51
27328,1,0,35,0,-35
27329,1,0,150,0,-150
27330,0,0,6,0,-6
27331,0,0,12,0,-12
27332,1,1,347,2586,2239
27333,0,0,36,0,-36
27334,0,0,63,0,-63
27335,1,0,64,0,-64
27336,1,0,16,0,-16
27337,1,1,403,1285,882
27338,1,1,430,1315,885
27339,1,1,201,1400,1199
27340,0,0,39,0,-39
27341,0,0,13,0,-13
27342,1,0,132,0,-132
27343,1,0,1,0,-1
27344,0,0,31,0,-31
27345,1,0,13,0,-13
27346,1,1,754,1490,736
27347,0,0,17,0,-17
27348,1,1,439,1385,946
27349,1,1,1072,1913,841
27350,0,0,78,0,-78
27351,0,0,147,0,-147
27352,1,1,983,2119,1136
27353,1,1,287,1273,986
27354,1,0,32,0,-32
27355,0,0,21,0,-21
27356,1,0,0,0,0
27357,1,0,24,0,-24
27358,0,0,7,0,-7
27359,1,1,1254,1232,-22
27360,0,0,27,0,-27
27361,1,0,41,0,-41
27362,1,0,16,0,-16
27363,1,1,1462,1734,272
27364,1,1,1814,1812,-2
27365,1,0,52,0,-52
27366,0,0,3,0,-3
27367,1,1,787,1951,1164
27368,0,0,34,0,-34
27369,0,0,54,0,-54
27370,1,1,118,1514,1396
27371,1,0,146,0,-146
27372,1,0,1,0,-1
27373,1,0,49,0,-49
27374,1,0,74,0,-74
27375,1,1,29,1971,1942
27376,0,0,35,0,-35
27377,0,0,37,0,-37
27378,1,0,29,0,-29
27379,1,1,1064,1230,166
27380,0,0,50,0,-50
27381,0,0,75,0,-75
27382,0,0,7,0,-7
27383,0,0,88,0,-88
27384,0,0,43,0,-43
27385,0,0,63,0,-63
27386,0,0,12,0,-12
27387,1,0,101,0,-101
27388,0,0,33,0,-33
27389,0,0,94,0,-94
27390,0,0,151,0,-151
27391,0,0,0,0,0
27392,1,0,18,0,-18
27393,0,0,18,0,-18
27394,1,1,373,2021,1648
27395,0,0,89,0,-89
27396,1,1,142,1561,1419
27397,1,0,52,0,-52
27398,1,0,28,0,-28
27399,1,0,50,0,-50
27400,0,0,3,0,-3
27401,0,0,125,0,-125
27402,0,0,15,0,-15
27403,0,0,62,0,-62
27404,1,1,881,1208,327
27405,1,1,642,1822,1180
27406,0,0,68,0,-68
27407,0,0,95,0,-95
27408,0,0,41,0,-41
27409,1,1,461,1380,919
27410,0,0,46,0,-46
27411,1,1,365,2421,2056
27412,1,1,342,1557,1215
27413,0,0,46,0,-46
27414,1,1,71,1225,1154
27415,0,0,31,0,-31
27416,1,1,195,1508,1313
27417,1,0,20,0,-20
27418,0,0,70,0,-70
27419,1,1,124,2241,2117
27420,1,1,1459,1513,54
27421,0,0,163,0,-163
27422,1,0,18,0,-18
27423,0,0,10,0,-10
27424,0,0,60,0,-60
27425,0,0,56,0,-56
27426,0,0,9,0,-9
27427,1,1,1163,1365,202
27428,1,0,166,0,-166
27429,1,0,43,0,-43
27430,0,0,14,0,-14
27431,1,0,76,0,-76
27432,0,0,104,0,-104
27433,0,0,19,0,-19
27434,1,1,702,1806,1104
27435,1,0,25,0,-25
27436,0,0,15,0,-15
27437,1,0,4,0,-4
27438,0,0,75,0,-75
27439,1,1,243,1565,1322
27440,0,0,79,0,-79
27441,0,0,14,0,-14
27442,1,0,53,0,-53
27443,0,0,9,0,-9
27444,0,0,1,0,-1
27445,0,0,29,0,-29
27446,1,1,199,1381,1182
27447,0,0,118,0,-118
27448,1,0,81,0,-81
27449,0,0,43,0,-43
27450,0,0,37,0,-37
27451,1,1,610,1502,892
27452,1,1,1111,1562,451
27453,1,0,58,0,-58
27454,1,1,262,1288,1026
27455,1,0,47,0,-47
27456,1,1,747,1275,528
27457,0,0,62,0,-62
27458,1,1,186,1738,1552
27459,0,0,130,0,-130
27460,1,0,5,0,-5
27461,1,1,221,1384,1163
27462,1,1,270,1298,1028
27463,1,1,195,1246,1051
27464,0,0,86,0,-86
27465,0,0,8,0,-8
27466,0,0,138,0,-138
27467,1,0,9,0,-9
27468,1,0,49,0,-49
27469,1,0,5,0,-5
27470,1,1,916,1350,434
27471,1,1,736,2264,1528
27472,0,0,132,0,-132
27473,1,1,733,1283,550
27474,1,1,837,1368,531
27475,1,1,1763,1925,162
27476,0,0,12,0,-12
27477,1,1,196,1269,1073
27478,1,1,34,1333,1299
27479,0,0,45,0,-45
27480,0,0,70,0,-70
27481,1,0,20,0,-20
27482,0,0,99,0,-99
27483,0,0,6,0,-6
27484,0,0,4,0,-4
27485,1,1,531,1205,674
27486,0,0,283,0,-283
27487,1,1,1183,2539,1356
27488,1,1,1490,1479,-11
27489,1,0,77,0,-77
27490,1,1,1564,1406,-158
27491,1,0,3,0,-3
27492,1,1,346,1214,868
27493,0,0,35,0,-35
27494,1,0,57,0,-57
27495,0,0,103,0,-103
27496,1,1,32,1316,1284
27497,1,1,318,1362,1044
27498,1,1,374,1429,1055
27499,0,0,13,0,-13
27500,1,0,20,0,-20
27501,1,1,1037,2316,1279
27502,1,1,1202,1571,369
27503,0,0,54,0,-54
27504,1,1,677,1672,995
27505,1,0,33,0,-33
27506,1,0,10,0,-10
27507,1,1,542,1250,708
27508,1,1,958,1251,293
27509,1,0,39,0,-39
27510,1,0,177,0,-177
27511,0,0,166,0,-166
27512,1,0,22,0,-22
27513,0,0,60,0,-60
27514,1,0,9,0,-9
27515,1,0,38,0,-38
27516,0,0,160,0,-160
27517,1,1,108,1606,1498
27518,1,0,22,0,-22
27519,0,0,128,0,-128
27520,1,1,342,1714,1372
27521,1,1,282,2287,2005
27522,0,0,6,0,-6
27523,0,0,62,0,-62
27524,1,0,194,0,-194
27525,0,0,125,0,-125
27526,0,0,148,0,-148
27527,1,1,233,2515,2282
27528,0,0,0,0,0
27529,1,1,2035,1430,-605
27530,1,0,39,0,-39
27531,1,0,47,0,-47
27532,0,0,3,0,-3
27533,1,1,903,1282,379
27534,1,1,1168,1550,382
27535,1,0,22,0,-22
27536,1,1,39,1970,1931
27537,1,1,772,3056,2284
27538,1,0,32,0,-32
27539,0,0,7,0,-7
27540,0,0,12,0,-12
27541,1,0,24,0,-24
27542,0,0,178,0,-178
27543,1,0,1,0,-1
27544,1,1,1119,9003,7884
27545,0,0,10,0,-10
27546,1,1,171,1960,1789
27547,0,0,110,0,-110
27548,1,0,66,0,-66
27549,1,0,102,0,-102
27550,0,0,19,0,-19
27551,1,1,465,1224,759
27552,1,1,724,1213,489
27553,0,0,16,0,-16
27554,0,0,94,0,-94
27555,1,0,23,0,-23
27556,0,0,36,0,-36
27557,0,0,8,0,-8
27558,0,0,9,0,-9
27559,1,0,80,0,-80
27560,1,0,13,0,-13
27561,1,0,85,0,-85
27562,0,0,11,0,-11
27563,0,0,1,0,-1
27564,0,0,40,0,-40
27565,1,1,377,1202,825
27566,1,0,160,0,-160
27567,1,1,69,1293,1224
27568,0,0,101,0,-101
27569,1,0,93,0,-93
27570,0,0,21,0,-21
27571,1,1,290,1508,1218
27572,0,0,272,0,-272
27573,1,0,20,0,-20
27574,1,1,179,1441,1262
27575,1,0,24,0,-24
27576,0,0,17,0,-17
27577,0,0,32,0,-32
27578,1,1,70,1285,1215
27579,0,0,12,0,-12
27580,1,0,126,0,-126
27581,0,0,74,0,-74
27582,1,1,92,1872,1780
27583,1,1,570,1238,668
27584,0,0,1,0,-1
27585,0,0,140,0,-140
27586,0,0,80,0,-80
27587,0,0,43,0,-43
27588,0,0,80,0,-80
27589,0,0,79,0,-79
27590,1,0,0,0,0
27591,1,1,2815,2337,-478
27592,1,0,5,0,-5
27593,0,0,49,0,-49
27594,1,0,75,0,-75
27595,1,1,677,1227,550
27596,0,0,8,0,-8
27597,1,1,306,1377,1071
27598,1,1,155,1490,1335
27599,1,0,22,0,-22
27600,1,1,43,1579,1536
27601,1,1,126,2572,2446
27602,1,0,20,0,-20
27603,1,0,15,0,-15
27604,0,0,2,0,-2
27605,0,0,15,0,-15
27606,1,0,2,0,-2
27607,1,0,33,0,-33
27608,1,1,382,1667,1285
27609,0,0,16,0,-16
27610,1,1,474,1373,899
27611,0,0,42,0,-42
27612,0,0,42,0,-42
27613,1,0,0,0,0
27614,1,1,218,1573,1355
27615,0,0,117,0,-117
27616,0,0,19,0,-19
27617,1,1,392,1808,1416
27618,0,0,22,0,-22
27619,1,0,49,0,-49
27620,1,1,181,1212,1031
27621,1,1,496,1851,1355
27622,1,1,547,1350,803
27623,1,0,9,0,-9
27624,0,0,48,0,-48
27625,0,0,61,0,-61
27626,1,1,558,1516,958
27627,0,0,43,0,-43
27628,1,0,45,0,-45
27629,1,0,11,0,-11
27630,1,0,32,0,-32
27631,0,0,13,0,-13
27632,1,0,50,0,-50
27633,0,0,64,0,-64
27634,1,1,540,1216,676
27635,1,0,14,0,-14
27636,1,1,28,1631,1603
27637,0,0,127,0,-127
27638,1,1,326,1281,955
27639,1,0,12,0,-12
27640,1,0,2,0,-2
27641,1,0,71,0,-71
27642,1,0,127,0,-127
27643,1,1,1153,2384,1231
27644,0,0,49,0,-49
27645,1,1,29,1403,1374
27646,1,0,20,0,-20
27647,1,1,157,1223,1066
27648,1,1,791,1644,853
27649,0,0,46,0,-46
27650,1,1,2379,1293,-1086
27651,1,1,291,1774,1483
27652,1,0,88,0,-88
27653,1,0,125,0,-125
27654,1,0,10,0,-10
27655,0,0,50,0,-50
27656,1,0,24,0,-24
27657,1,1,120,1627,1507
27658,1,0,24,0,-24
27659,1,1,201,2530,2329
27660,1,0,70,0,-70
27661,0,0,62,0,-62
27662,1,0,23,0,-23
27663,1,1,574,2291,1717
27664,0,0,11,0,-11
27665,0,0,88,0,-88
27666,0,0,41,0,-41
27667,0,0,39,0,-39
27668,0,0,158,0,-158
27669,1,0,25,0,-25
27670,1,0,2,0,-2
27671,0,0,37,0,-37
27672,0,0,20,0,-20
27673,1,1,331,1208,877
27674,1,1,202,1416,1214
27675,0,0,130,0,-130
27676,0,0,22,0,-22
27677,0,0,27,0,-27
27678,1,1,402,1383,981
27679,0,0,65,0,-65
27680,0,0,15,0,-15
27681,0,0,11,0,-11
27682,0,0,5,0,-5
27683,1,1,99,1351,1252
27684,0,0,14,0,-14
27685,0,0,51,0,-51
27686,1,1,340,1295,955
27687,1,1,1145,2035,890
27688,0,0,19,0,-19
27689,1,0,5,0,-5
27690,0,0,23,0,-23
27691,1,0,21,0,-21
27692,1,0,18,0,-18
27693,1,0,33,0,-33
27694,0,0,84,0,-84
27695,1,0,47,0,-47
27696,1,0,25,0,-25
27697,0,0,71,0,-71
27698,0,0,38,0,-38
27699,1,0,22,0,-22
27700,0,0,45,0,-45
27701,1,0,3,0,-3
27702,1,0,26,0,-26
27703,1,1,1408,1461,53
27704,1,0,20,0,-20
27705,1,0,40,0,-40
27706,0,0,19,0,-19
27707,1,1,437,1341,904
27708,0,0,96,0,-96
27709,0,0,165,0,-165
27710,1,1,50,1511,1461
27711,0,0,40,0,-40
27712,1,1,1199,3038,1839
27713,1,1,114,1436,1322
27714,1,1,237,1270,1033
27715,1,1,1309,2392,1083
27716,1,0,120,0,-120
27717,0,0,10,0,-10
27718,1,0,44,0,-44
27719,1,0,21,0,-21
27720,1,0,38,0,-38
27721,1,1,609,1364,755
27722,0,0,127,0,-127
27723,0,0,45,0,-45
27724,1,1,336,1202,866
27725,0,0,4,0,-4
27726,1,1,90,1243,1153
27727,1,0,201,0,-201
27728,1,0,51,0,-51
27729,1,0,5,0,-5
27730,1,0,120,0,-120
27731,0,0,78,0,-78
27732,1,1,630,1299,669
27733,1,1,1124,1302,178
27734,0,0,43,0,-43
27735,1,1,449,1693,1244
27736,0,0,38,0,-38
27737,0,0,3,0,-3
27738,0,0,94,0,-94
27739,0,0,54,0,-54
27740,0,0,0,0,0
27741,1,0,51,0,-51
27742,0,0,93,0,-93
27743,1,0,47,0,-47
27744,0,0,69,0,-69
27745,1,1,490,1841,1351
27746,1,0,40,0,-40
27747,1,1,53,1254,1201
27748,1,1,132,1343,1211
27749,1,0,1,0,-1
27750,1,1,2222,1741,-481
27751,0,0,74,0,-74
27752,1,0,46,0,-46
27753,0,0,10,0,-10
27754,1,0,13,0,-13
27755,0,0,148,0,-148
27756,0,0,2,0,-2
27757,0,0,10,0,-10
27758,1,1,457,1963,1506
27759,0,0,50,0,-50
27760,1,0,24,0,-24
27761,1,1,283,2317,2034
27762,1,0,25,0,-25
27763,1,1,738,1485,747
27764,1,0,3,0,-3
27765,0,0,162,0,-162
27766,1,0,50,0,-50
27767,0,0,37,0,-37
27768,1,1,295,1488,1193
27769,0,0,76,0,-76
27770,0,0,8,0,-8
27771,1,1,1657,1216,-441
27772,1,0,50,0,-50
27773,0,0,124,0,-124
27774,1,1,844,1294,450
27775,0,0,7,0,-7
27776,0,0,113,0,-113
27777,1,0,27,0,-27
27778,1,0,48,0,-48
27779,0,0,31,0,-31
27780,1,0,17,0,-17
27781,1,1,280,2040,1760
27782,1,1,316,1233,917
27783,1,1,456,1290,834
27784,0,0,53,0,-53
27785,1,0,27,0,-27
27786,0,0,20,0,-20
27787,1,0,6,0,-6
27788,1,0,50,0,-50
27789,1,1,522,1511,989
27790,0,0,21,0,-21
27791,1,0,21,0,-21
27792,1,1,311,1492,1181
27793,0,0,6,0,-6
27794,0,0,36,0,-36
27795,0,0,65,0,-65
27796,1,1,121,1627,1506
27797,0,0,48,0,-48
27798,0,0,2,0,-2
27799,1,1,587,1384,797
27800,1,1,1532,1433,-99
27801,1,1,85,1825,1740
27802,1,0,94,0,-94
27803,1,1,626,2384,1758
27804,1,0,6,0,-6
27805,1,0,181,0,-181
27806,0,0,165,0,-165
27807,1,1,643,2280,1637
27808,0,0,35,0,-35
27809,1,1,447,2335,1888
27810,1,0,31,0,-31
27811,1,0,12,0,-12
27812,1,1,144,1376,1232
27813,1,1,1650,1443,-207
27814,1,1,91,1687,1596
27815,1,0,24,0,-24
27816,1,0,55,0,-55
27817,1,0,59,0,-59
27818,1,0,3,0,-3
27819,1,0,25,0,-25
27820,1,1,740,1264,524
27821,0,0,166,0,-166
27822,0,0,97,0,-97
27823,1,1,94,1621,1527
27824,1,1,218,1455,1237
27825,1,1,1134,1329,195
27826,1,1,121,1358,1237
27827,0,0,95,0,-95
27828,1,1,66,1338,1272
27829,0,0,82,0,-82
27830,0,0,62,0,-62
27831,0,0,22,0,-22
27832,1,1,80,1537,1457
27833,1,0,21,0,-21
27834,1,0,3,0,-3
27835,0,0,87,0,-87
27836,1,0,41,0,-41
27837,1,0,99,0,-99
27838,0,0,38,0,-38
27839,1,0,108,0,-108
27840,1,1,316,1441,1125
27841,1,1,911,2540,1629
27842,1,0,21,0,-21
27843,1,0,18,0,-18
27844,1,0,8,0,-8
27845,0,0,47,0,-47
27846,0,0,25,0,-25
27847,1,1,344,1323,979
27848,1,1,77,1289,1212
27849,0,0,102,0,-102
27850,1,1,701,1381,680
27851,1,0,1,0,-1
27852,1,1,439,3401,2962
27853,1,0,4,0,-4
27854,1,0,99,0,-99
27855,1,0,46,0,-46
27856,1,0,22,0,-22
27857,1,0,33,0,-33
27858,1,1,702,1265,563
27859,1,1,2457,1354,-1103
27860,1,1,71,1345,1274
27861,1,1,301,1559,1258
27862,0,0,39,0,-39
27863,1,0,103,0,-103
27864,1,1,2,1243,1241
27865,0,0,13,0,-13
27866,0,0,20,0,-20
27867,0,0,76,0,-76
27868,0,0,96,0,-96
27869,1,0,22,0,-22
27870,1,1,195,1825,1630
27871,1,0,45,0,-45
27872,1,1,1585,1360,-225
27873,0,0,50,0,-50
27874,1,0,103,0,-103
27875,1,1,1200,1453,253
27876,0,0,2,0,-2
27877,1,0,94,0,-94
27878,1,1,903,2713,1810
27879,1,0,12,0,-12
27880,1,1,41,1206,1165
27881,0,0,49,0,-49
27882,0,0,55,0,-55
27883,1,0,26,0,-26
27884,0,0,8,0,-8
27885,0,0,50,0,-50
27886,1,1,244,1429,1185
27887,1,1,706,1913,1207
27888,0,0,11,0,-11
27889,0,0,13,0,-13
27890,1,1,1199,1795,596
27891,0,0,25,0,-25
27892,1,0,3,0,-3
27893,0,0,28,0,-28
27894,1,1,207,1345,1138
27895,1,1,440,1503,1063
27896,0,0,96,0,-96
27897,0,0,15,0,-15
27898,1,0,15,0,-15
27899,1,0,39,0,-39
27900,1,1,586,1665,1079
27901,0,0,52,0,-52
27902,1,0,39,0,-39
27903,0,0,90,0,-90
27904,1,1,85,1453,1368
27905,1,1,244,1274,1030
27906,0,0,21,0,-21
27907,1,0,14,0,-14
27908,0,0,13,0,-13
27909,1,1,169,1271,1102
27910,0,0,97,0,-97
27911,1,0,33,0,-33
27912,0,0,39,0,-39
27913,1,1,1105,1536,431
27914,0,0,42,0,-42
27915,1,1,378,1409,1031
27916,0,0,66,0,-66
27917,0,0,6,0,-6
27918,1,1,155,2213,2058
27919,1,1,310,2887,2577
27920,1,0,124,0,-124
27921,0,0,106,0,-106
27922,1,0,171,0,-171
27923,0,0,29,0,-29
27924,1,1,103,2428,2325
27925,1,0,17,0,-17
27926,0,0,51,0,-51
27927,0,0,30,0,-30
27928,1,1,809,1374,565
27929,0,0,38,0,-38
27930,1,0,34,0,-34
27931,0,0,80,0,-80
27932,1,1,693,1277,584
27933,1,1,395,1322,927
27934,1,1,557,1715,1158
27935,1,0,78,0,-78
27936,1,1,492,1230,738
27937,0,0,87,0,-87
27938,0,0,38,0,-38
27939,0,0,22,0,-22
27940,1,1,838,1595,757
27941,1,0,9,0,-9
27942,1,1,1270,1319,49
27943,1,0,0,0,0
27944,0,0,74,0,-74
27945,0,0,45,0,-45
27946,1,0,57,0,-57
27947,1,0,9,0,-9
27948,1,1,225,1720,1495
27949,1,1,1795,1398,-397
27950,1,1,208,1370,1162
27951,1,1,49,1236,1187
27952,1,1,1727,1392,-335
27953,1,1,413,1612,1199
27954,0,0,32,0,-32
27955,0,0,15,0,-15
27956,0,0,1,0,-1
27957,0,0,20,0,-20
27958,1,1,264,1871,1607
27959,1,1,901,1486,585
27960,0,0,31,0,-31
27961,0,0,86,0,-86
27962,1,0,3,0,-3
27963,1,1,1227,1698,471
27964,1,1,1482,1206,-276
27965,0,0,117,0,-117
27966,0,0,182,0,-182
27967,1,1,201,1221,1020
27968,0,0,106,0,-106
27969,1,0,48,0,-48
27970,1,0,57,0,-57
27971,1,1,330,1233,903
27972,1,0,13,0,-13
27973,1,0,25,0,-25
27974,0,0,50,0,-50
27975,0,0,69,0,-69
27976,1,1,71,1286,1215
27977,0,0,0,0,0
27978,1,0,1,0,-1
27979,1,1,329,1381,1052
27980,1,0,30,0,-30
27981,1,1,83,1494,1411
27982,1,1,239,1364,1125
27983,1,0,31,0,-31
27984,1,0,13,0,-13
27985,0,0,7,0,-7
27986,0,0,180,0,-180
27987,1,1,550,1265,715
27988,1,1,365,2299,1934
27989,0,0,15,0,-15
27990,1,0,19,0,-19
27991,0,0,22,0,-22
27992,1,1,554,1838,1284
27993,1,0,28,0,-28
27994,0,0,12,0,-12
27995,1,1,1105,1243,138
27996,1,0,35,0,-35
27997,1,1,329,1393,1064
27998,1,0,19,0,-19
27999,1,1,1760,1520,-240
28000,1,1,556,2082,1526
28001,1,0,12,0,-12
28002,1,1,762,1232,470
28003,1,0,2,0,-2
28004,1,1,191,1571,1380
28005,0,0,23,0,-23
28006,1,1,284,1333,1049
28007,1,1,375,1494,1119
28008,1,0,82,0,-82
28009,0,0,20,0,-20
28010,1,1,759,1321,562
28011,0,0,16,0,-16
28012,1,1,288,1395,1107
28013,1,1,829,1206,377
28014,1,1,1144,1209,65
28015,1,0,19,0,-19
28016,1,1,707,1359,652
28017,1,1,156,1399,1243
28018,1,1,78,2820,2742
28019,1,0,2,0,-2
28020,1,1,275,1234,959
28021,1,1,278,1240,962
28022,1,1,633,1314,681
28023,1,0,12,0,-12
28024,1,1,852,1239,387
28025,1,1,1222,1277,55
28026,0,0,36,0,-36
28027,0,0,68,0,-68
28028,0,0,27,0,-27
28029,0,0,95,0,-95
28030,1,0,58,0,-58
28031,1,0,12,0,-12
28032,1,0,213,0,-213
28033,1,0,104,0,-104
28034,1,1,1236,1455,219
28035,1,1,276,1704,1428
28036,1,1,334,1641,1307
28037,0,0,41,0,-41
28038,1,0,3,0,-3
28039,0,0,25,0,-25
28040,1,0,74,0,-74
28041,0,0,27,0,-27
28042,1,1,383,1312,929
28043,0,0,55,0,-55
28044,1,0,44,0,-44
28045,1,0,48,0,-48
28046,1,0,7,0,-7
28047,0,0,45,0,-45
28048,0,0,2,0,-2
28049,0,0,19,0,-19
28050,1,0,159,0,-159
28051,1,0,63,0,-63
28052,1,1,421,1201,780
28053,1,0,36,0,-36
28054,1,1,400,3305,2905
28055,0,0,83,0,-83
28056,1,0,29,0,-29
28057,0,0,15,0,-15
28058,1,1,1043,1219,176
28059,0,0,9,0,-9
28060,0,0,109,0,-109
28061,0,0,39,0,-39
28062,1,0,74,0,-74
28063,1,1,265,2718,2453
28064,1,0,40,0,-40
28065,1,1,79,1230,1151
28066,1,0,43,0,-43
28067,0,0,4,0,-4
28068,0,0,48,0,-48
28069,1,0,72,0,-72
28070,1,1,1715,1958,243
28071,1,0,47,0,-47
28072,1,1,2646,1909,-737
28073,0,0,81,0,-81
28074,0,0,45,0,-45
28075,0,0,52,0,-52
28076,1,0,23,0,-23
28077,1,0,10,0,-10
28078,1,1,1010,1326,316
28079,0,0,36,0,-36
28080,1,0,42,0,-42
28081,1,1,157,1497,1340
28082,0,0,29,0,-29
28083,1,1,275,1563,1288
28084,1,1,950,1401,451
28085,0,0,29,0,-29
28086,0,0,84,0,-84
28087,1,1,711,1709,998
28088,1,1,308,1539,1231
28089,0,0,62,0,-62
28090,1,1,204,1570,1366
28091,1,1,1339,1947,608
28092,1,1,203,1525,1322
28093,1,0,2,0,-2
28094,1,0,62,0,-62
28095,0,0,5,0,-5
28096,1,1,275,1264,989
28097,0,0,123,0,-123
28098,0,0,45,0,-45
28099,0,0,17,0,-17
28100,1,1,1057,2383,1326
28101,0,0,27,0,-27
28102,0,0,28,0,-28
28103,1,0,18,0,-18
28104,1,0,45,0,-45
28105,0,0,11,0,-11
28106,0,0,3,0,-3
28107,0,0,64,0,-64
28108,0,0,54,0,-54
28109,1,0,9,0,-9
28110,1,1,765,2925,2160
28111,1,0,84,0,-84
28112,0,0,29,0,-29
28113,1,0,217,0,-217
28114,1,0,42,0,-42
28115,1,1,860,1290,430
28116,1,0,14,0,-14
28117,0,0,4,0,-4
28118,1,0,1,0,-1
28119,0,0,113,0,-113
28120,0,0,8,0,-8
28121,1,0,4,0,-4
28122,1,0,140,0,-140
28123,0,0,64,0,-64
28124,1,0,13,0,-13
28125,0,0,15,0,-15
28126,1,1,1265,1291,26
28127,1,1,1002,1375,373
28128,1,0,36,0,-36
28129,1,1,59,1685,1626
28130,1,1,1558,1470,-88
28131,0,0,0,0,0
28132,1,1,728,1439,711
28133,1,1,482,1237,755
28134,1,1,187,1333,1146
28135,1,0,22,0,-22
28136,0,0,61,0,-61
28137,1,1,159,1201,1042
28138,1,1,802,2889,2087
28139,1,1,464,1403,939
28140,0,0,83,0,-83
28141,0,0,83,0,-83
28142,1,1,715,1229,514
28143,1,0,110,0,-110
28144,0,0,23,0,-23
28145,1,0,47,0,-47
28146,0,0,44,0,-44
28147,1,1,996,1224,228
28148,0,0,45,0,-45
28149,1,1,384,1598,1214
28150,0,0,94,0,-94
28151,1,0,58,0,-58
28152,1,0,245,0,-245
28153,1,0,40,0,-40
28154,1,0,54,0,-54
28155,1,1,780,1351,571
28156,1,0,16,0,-16
28157,1,0,47,0,-47
28158,1,1,422,1363,941
28159,1,0,147,0,-147
28160,1,0,1,0,-1
28161,0,0,6,0,-6
28162,1,0,16,0,-16
28163,1,1,431,1814,1383
28164,0,0,30,0,-30
28165,0,0,16,0,-16
28166,0,0,7,0,-7
28167,1,1,920,1217,297
28168,0,0,34,0,-34
28169,1,0,70,0,-70
28170,1,0,96,0,-96
28171,0,0,23,0,-23
28172,0,0,26,0,-26
28173,1,1,130,1241,1111
28174,0,0,13,0,-13
28175,1,0,52,0,-52
28176,1,1,133,1463,1330
28177,1,1,338,1523,1185
28178,0,0,2,0,-2
28179,1,1,919,2148,1229
28180,1,1,629,1503,874
28181,0,0,16,0,-16
28182,1,0,54,0,-54
28183,1,1,743,1430,687
28184,1,1,1185,1537,352
28185,0,0,3,0,-3
28186,0,0,4,0,-4
28187,1,1,608,1934,1326
28188,1,1,178,1202,1024
28189,1,0,17,0,-17
28190,0,0,46,0,-46
28191,1,0,17,0,-17
28192,1,0,60,0,-60
28193,1,1,923,1596,673
28194,0,0,14,0,-14
28195,0,0,12,0,-12
28196,1,1,1033,2074,1041
28197,0,0,40,0,-40
28198,1,0,112,0,-112
28199,1,0,144,0,-144
28200,0,0,59,0,-59
28201,0,0,46,0,-46
28202,1,1,137,1487,1350
28203,0,0,61,0,-61
28204,1,0,14,0,-14
28205,0,0,3,0,-3
28206,1,1,360,1634,1274
28207,1,1,185,1455,1270
28208,1,1,171,1944,1773
28209,1,1,761,1275,514
28210,1,1,250,1326,1076
28211,0,0,37,0,-37
28212,0,0,223,0,-223
28213,0,0,91,0,-91
28214,1,0,2,0,-2
28215,1,1,586,1970,1384
28216,0,0,29,0,-29
28217,1,0,86,0,-86
28218,1,0,3,0,-3
28219,0,0,20,0,-20
28220,0,0,0,0,0
28221,1,1,180,1377,1197
28222,0,0,38,0,-38
28223,1,1,340,1332,992
28224,0,0,31,0,-31
28225,0,0,54,0,-54
28226,0,0,15,0,-15
28227,1,1,1589,1280,-309
28228,0,0,10,0,-10
28229,1,1,374,1687,1313
28230,1,1,198,1217,1019
28231,1,0,22,0,-22
28232,0,0,37,0,-37
28233,0,0,52,0,-52
28234,1,0,8,0,-8
28235,0,0,80,0,-80
28236,1,0,19,0,-19
28237,1,1,179,1364,1185
28238,0,0,12,0,-12
28239,1,1,222,1256,1034
28240,1,1,54,1320,1266
28241,1,0,27,0,-27
28242,1,1,109,1241,1132
28243,0,0,7,0,-7
28244,0,0,5,0,-5
28245,1,1,77,1561,1484
28246,1,1,1171,1393,222
28247,1,1,666,1744,1078
28248,0,0,3,0,-3
28249,1,1,515,1607,1092
28250,1,0,5,0,-5
28251,0,0,27,0,-27
28252,0,0,91,0,-91
28253,1,0,217,0,-217
28254,1,1,156,2202,2046
28255,1,0,1,0,-1
28256,1,1,483,1590,1107
28257,0,0,16,0,-16
28258,1,0,4,0,-4
28259,1,0,42,0,-42
28260,0,0,29,0,-29
28261,1,0,5,0,-5
28262,0,0,80,0,-80
28263,0,0,104,0,-104
28264,0,0,70,0,-70
28265,0,0,28,0,-28
28266,0,0,25,0,-25
28267,1,1,924,1246,322
28268,0,0,32,0,-32
28269,1,1,640,1376,736
28270,1,0,43,0,-43
28271,1,0,4,0,-4
28272,1,0,21,0,-21
28273,0,0,12,0,-12
28274,1,1,79,1303,1224
28275,0,0,53,0,-53
28276,1,1,1021,1887,866
28277,0,0,36,0,-36
28278,0,0,46,0,-46
28279,1,0,10,0,-10
28280,1,1,563,1226,663
28281,1,0,68,0,-68
28282,0,0,35,0,-35
28283,1,1,153,1341,1188
28284,1,1,618,1373,755
28285,1,0,41,0,-41
28286,1,0,137,0,-137
28287,1,1,49,2717,2668
28288,1,1,48,1776,1728
28289,0,0,54,0,-54
28290,1,0,58,0,-58
28291,0,0,26,0,-26
28292,1,0,103,0,-103
28293,0,0,36,0,-36
28294,0,0,15,0,-15
28295,0,0,17,0,-17
28296,1,1,900,1373,473
28297,1,0,17,0,-17
28298,1,0,3,0,-3
28299,1,0,14,0,-14
28300,1,0,78,0,-78
28301,1,0,33,0,-33
28302,1,0,78,0,-78
28303,0,0,38,0,-38
28304,0,0,36,0,-36
28305,1,0,44,0,-44
28306,1,0,38,0,-38
28307,1,0,42,0,-42
28308,0,0,31,0,-31
28309,0,0,1,0,-1
28310,0,0,88,0,-88
28311,0,0,2,0,-2
28312,1,1,378,1695,1317
28313,1,1,550,1635,1085
28314,0,0,10,0,-10
28315,1,1,501,1371,870
28316,0,0,22,0,-22
28317,1,0,138,0,-138
28318,1,1,279,1420,1141
28319,1,0,54,0,-54
28320,0,0,121,0,-121
28321,1,0,30,0,-30
28322,1,1,180,1346,1166
28323,1,1,393,1401,1008
28324,1,0,10,0,-10
28325,1,1,743,1213,470
28326,1,0,4,0,-4
28327,0,0,13,0,-13
28328,0,0,11,0,-11
28329,1,0,45,0,-45
28330,0,0,19,0,-19
28331,0,0,20,0,-20
28332,0,0,85,0,-85
28333,1,1,393,1202,809
28334,0,0,1,0,-1
28335,1,0,45,0,-45
28336,1,0,7,0,-7
28337,0,0,17,0,-17
28338,1,0,19,0,-19
28339,1,0,106,0,-106
28340,0,0,110,0,-110
28341,1,0,21,0,-21
28342,0,0,40,0,-40
28343,0,0,13,0,-13
28344,0,0,28,0,-28
28345,1,0,38,0,-38
28346,1,0,7,0,-7
28347,1,1,17,1359,1342
28348,1,0,13,0,-13
28349,1,0,18,0,-18
28350,0,0,61,0,-61
28351,0,0,158,0,-158
28352,1,1,123,1262,1139
28353,0,0,89,0,-89
28354,1,0,65,0,-65
28355,0,0,24,0,-24
28356,0,0,78,0,-78
28357,0,0,10,0,-10
28358,1,0,101,0,-101
28359,0,0,62,0,-62
28360,1,1,289,1439,1150
28361,1,0,283,0,-283
28362,0,0,20,0,-20
28363,0,0,3,0,-3
28364,1,1,732,1347,615
28365,0,0,82,0,-82
28366,1,0,83,0,-83
28367,1,1,460,1248,788
28368,1,0,258,0,-258
28369,0,0,29,0,-29
28370,0,0,143,0,-143
28371,0,0,194,0,-194
28372,1,0,34,0,-34
28373,1,0,122,0,-122
28374,0,0,6,0,-6
28375,1,0,3,0,-3
28376,1,1,145,1848,1703
28377,1,1,1036,2446,1410
28378,1,0,38,0,-38
28379,0,0,50,0,-50
28380,1,1,358,1303,945
28381,0,0,23,0,-23
28382,0,0,8,0,-8
28383,1,0,47,0,-47
28384,1,0,29,0,-29
28385,1,1,131,1213,1082
28386,1,1,32,1224,1192
28387,0,0,99,0,-99
28388,0,0,49,0,-49
28389,0,0,1,0,-1
28390,0,0,13,0,-13
28391,1,1,729,1229,500
28392,0,0,65,0,-65
28393,1,1,109,2153,2044
28394,0,0,19,0,-19
28395,0,0,109,0,-109
28396,0,0,113,0,-113
28397,1,1,437,1221,784
28398,0,0,5,0,-5
28399,0,0,57,0,-57
28400,1,1,402,1278,876
28401,1,0,36,0,-36
28402,1,1,630,2167,1537
28403,1,1,136,1336,1200
28404,1,0,20,0,-20
28405,1,1,118,1654,1536
28406,0,0,35,0,-35
28407,1,0,38,0,-38
28408,0,0,11,0,-11
28409,0,0,184,0,-184
28410,0,0,146,0,-146
28411,0,0,33,0,-33
28412,1,1,1461,1832,371
28413,1,0,81,0,-81
28414,0,0,58,0,-58
28415,0,0,8,0,-8
28416,1,0,23,0,-23
28417,0,0,5,0,-5
28418,1,0,23,0,-23
28419,1,1,562,1321,759
28420,1,1,247,1822,1575
28421,1,1,126,1285,1159
28422,1,1,599,1255,656
28423,0,0,27,0,-27
28424,1,1,1118,1306,188
28425,1,0,52,0,-52
28426,1,0,99,0,-99
28427,0,0,8,0,-8
28428,1,0,160,0,-160
28429,1,0,17,0,-17
28430,0,0,5,0,-5
28431,1,0,18,0,-18
28432,1,0,22,0,-22
28433,1,1,1187,1264,77
28434,1,1,580,1206,626
28435,1,0,11,0,-11
28436,0,0,41,0,-41
28437,1,1,931,1302,371
28438,1,0,75,0,-75
28439,0,0,41,0,-41
28440,1,1,124,2216,2092
28441,1,1,365,1306,941
28442,1,1,84,1260,1176
28443,0,0,16,0,-16
28444,0,0,55,0,-55
28445,0,0,6,0,-6
28446,1,1,489,1413,924
28447,0,0,87,0,-87
28448,1,1,146,1481,1335
28449,0,0,92,0,-92
28450,0,0,74,0,-74
28451,1,1,175,1316,1141
28452,0,0,43,0,-43
28453,1,0,20,0,-20
28454,1,1,952,1635,683
28455,1,0,9,0,-9
28456,1,1,296,1262,966
28457,0,0,103,0,-103
28458,1,0,10,0,-10
28459,1,0,120,0,-120
28460,0,0,51,0,-51
28461,1,1,1025,1433,408
28462,0,0,17,0,-17
28463,0,0,7,0,-7
28464,0,0,6,0,-6
28465,1,0,95,0,-95
28466,1,1,441,1201,760
28467,1,0,28,0,-28
28468,1,0,69,0,-69
28469,1,1,308,1942,1634
28470,1,0,27,0,-27
28471,0,0,99,0,-99
28472,1,1,559,1216,657
28473,0,0,1,0,-1
28474,1,0,25,0,-25
28475,0,0,54,0,-54
28476,0,0,28,0,-28
28477,0,0,5,0,-5
28478,0,0,73,0,-73
28479,1,1,473,1380,907
28480,0,0,7,0,-7
28481,0,0,44,0,-44
28482,0,0,225,0,-225
28483,1,0,170,0,-170
28484,1,1,140,1759,1619
28485,1,0,38,0,-38
28486,1,0,23,0,-23
28487,1,0,21,0,-21
28488,0,0,0,0,0
28489,0,0,70,0,-70
28490,1,1,527,1214,687
28491,0,0,36,0,-36
28492,0,0,34,0,-34
28493,1,0,33,0,-33
28494,1,0,7,0,-7
28495,0,0,7,0,-7
28496,0,0,76,0,-76
28497,1,0,63,0,-63
28498,0,0,1,0,-1
28499,1,1,38,1503,1465
28500,1,0,11,0,-11
28501,0,0,2,0,-2
28502,1,1,1637,1664,27
28503,1,0,1,0,-1
28504,1,1,590,1837,1247
28505,1,1,117,1551,1434
28506,0,0,12,0,-12
28507,0,0,189,0,-189
28508,1,1,138,1736,1598
28509,0,0,15,0,-15
28510,0,0,115,0,-115
28511,0,0,132,0,-132
28512,0,0,121,0,-121
28513,1,1,371,1474,1103
28514,1,1,435,1232,797
28515,1,1,477,1300,823
28516,1,0,11,0,-11
28517,1,0,27,0,-27
28518,0,0,31,0,-31
28519,1,1,482,1474,992
28520,0,0,80,0,-80
28521,1,1,96,1367,1271
28522,0,0,59,0,-59
28523,0,0,13,0,-13
28524,0,0,32,0,-32
28525,1,1,211,4358,4147
28526,1,1,1085,1606,521
28527,1,1,1139,1817,678
28528,1,0,38,0,-38
28529,0,0,11,0,-11
28530,0,0,8,0,-8
28531,0,0,81,0,-81
28532,1,1,1424,1307,-117
28533,1,0,48,0,-48
28534,1,0,73,0,-73
28535,0,0,144,0,-144
28536,0,0,50,0,-50
28537,0,0,53,0,-53
28538,0,0,111,0,-111
28539,1,1,225,1236,1011
28540,1,0,34,0,-34
28541,0,0,60,0,-60
28542,1,1,494,2128,1634
28543,0,0,127,0,-127
28544,0,0,5,0,-5
28545,1,0,6,0,-6
28546,1,0,18,0,-18
28547,1,0,44,0,-44
28548,0,0,0,0,0
28549,1,0,17,0,-17
28550,1,1,278,1601,1323
28551,1,0,41,0,-41
28552,1,1,1102,1418,316
28553,0,0,5,0,-5
28554,0,0,1,0,-1
28555,1,1,123,1956,1833
28556,0,0,6,0,-6
28557,1,0,67,0,-67
28558,1,1,209,1363,1154
28559,0,0,22,0,-22
28560,0,0,137,0,-137
28561,1,0,9,0,-9
28562,1,1,1664,1316,-348
28563,0,0,87,0,-87
28564,0,0,1,0,-1
28565,1,0,18,0,-18
28566,1,0,24,0,-24
28567,1,0,9,0,-9
28568,0,0,31,0,-31
28569,1,1,790,2091,1301
28570,0,0,2,0,-2
28571,1,1,548,2652,2104
28572,1,0,27,0,-27
28573,0,0,19,0,-19
28574,0,0,31,0,-31
28575,1,0,97,0,-97
28576,1,1,621,1283,662
28577,0,0,60,0,-60
28578,1,1,87,1463,1376
28579,0,0,109,0,-109
28580,0,0,6,0,-6
28581,0,0,16,0,-16
28582,1,1,483,1609,1126
28583,0,0,33,0,-33
28584,1,1,1707,1235,-472
28585,1,0,54,0,-54
28586,1,1,262,1451,1189
28587,1,1,200,1446,1246
28588,0,0,115,0,-115
28589,0,0,26,0,-26
28590,1,0,67,0,-67
28591,1,1,352,1915,1563
28592,0,0,2,0,-2
28593,1,1,174,1299,1125
28594,1,0,0,0,0
28595,1,0,56,0,-56
28596,1,0,193,0,-193
28597,1,0,28,0,-28
28598,1,1,62,1543,1481
28599,1,1,68,2400,2332
28600,0,0,1,0,-1
28601,0,0,40,0,-40
28602,1,0,116,0,-116
28603,1,0,117,0,-117
28604,0,0,75,0,-75
28605,1,1,182,1366,1184
28606,1,0,121,0,-121
28607,0,0,34,0,-34
28608,1,1,173,1847,1674
28609,1,1,167,1340,1173
28610,1,1,543,1462,919
28611,1,1,603,1440,837
28612,1,0,13,0,-13
28613,1,1,811,1293,482
28614,1,0,169,0,-169
28615,0,0,40,0,-40
28616,0,0,19,0,-19
28617,1,0,4,0,-4
28618,1,0,33,0,-33
28619,1,0,104,0,-104
28620,0,0,74,0,-74
28621,0,0,47,0,-47
28622,1,0,51,0,-51
28623,1,1,819,1283,464
28624,1,0,74,0,-74
28625,0,0,2,0,-2
28626,0,0,26,0,-26
28627,0,0,19,0,-19
28628,0,0,49,0,-49
28629,1,1,443,1256,813
28630,0,0,5,0,-5
28631,1,1,666,1288,622
28632,1,1,172,1204,1032
28633,1,1,170,1559,1389
28634,1,1,424,1278,854
28635,1,1,1747,1850,103
28636,0,0,123,0,-123
28637,0,0,7,0,-7
28638,1,1,564,1274,710
28639,1,0,6,0,-6
28640,1,1,213,1273,1060
28641,1,0,30,0,-30
28642,1,0,9,0,-9
28643,0,0,89,0,-89
28644,1,1,970,1211,241
28645,1,0,167,0,-167
28646,0,0,4,0,-4
28647,1,0,42,0,-42
28648,1,1,733,1538,805
28649,0,0,55,0,-55
28650,1,0,1,0,-1
28651,0,0,37,0,-37
28652,1,1,551,1352,801
28653,1,1,108,1580,1472
28654,1,1,755,1232,477
28655,1,0,85,0,-85
28656,1,1,96,1217,1121
28657,0,0,161,0,-161
28658,1,0,61,0,-61
28659,1,1,77,1360,1283
28660,1,1,74,2648,2574
28661,1,1,1023,1492,469
28662,1,1,1136,1343,207
28663,1,1,95,1387,1292
28664,1,0,31,0,-31
28665,1,1,411,1617,1206
28666,0,0,43,0,-43
28667,1,0,214,0,-214
28668,1,0,22,0,-22
28669,0,0,48,0,-48
28670,0,0,2,0,-2
28671,1,1,877,1206,329
