ID,Флаг дозвона,Флаг продажи,Расходы,PV,NPV
0,1,1,240,2052,1812
1,1,1,203,1247,1044
2,0,0,37,0,-37
3,1,0,39,0,-39
4,1,0,46,0,-46
5,0,0,83,0,-83
6,1,0,2,0,-2
7,1,1,166,1295,1129
8,1,1,558,1420,862
9,1,0,24,0,-24
10,0,0,6,0,-6
11,1,0,61,0,-61
12,0,0,1,0,-1
13,0,0,121,0,-121
14,0,0,121,0,-121
15,1,0,0,0,0
16,1,0,95,0,-95
17,1,1,357,1881,1524
18,1,0,43,0,-43
19,1,1,346,1338,992
20,1,1,279,1275,996
21,1,1,380,2634,2254
22,1,0,42,0,-42
23,1,1,417,1333,916
24,1,0,7,0,-7
25,1,0,45,0,-45
26,1,1,484,1600,1116
27,1,1,781,1810,1029
28,0,0,6,0,-6
29,1,1,989,1619,630
30,1,0,66,0,-66
31,1,0,55,0,-55
32,1,1,406,1975,1569
33,1,0,27,0,-27
34,1,0,29,0,-29
35,1,1,342,1510,1168
36,1,0,1,0,-1
37,1,0,23,0,-23
38,0,0,9,0,-9
39,0,0,96,0,-96
40,0,0,26,0,-26
41,1,1,305,1260,955
42,1,1,272,2664,2392
43,1,0,71,0,-71
44,0,0,8,0,-8
45,0,0,34,0,-34
46,1,1,363,1628,1265
47,1,0,20,0,-20
48,1,0,25,0,-25
49,0,0,11,0,-11
50,1,1,271,1389,1118
51,1,1,318,1584,1266
52,1,1,371,1308,937
53,1,0,56,0,-56
54,0,0,16,0,-16
55,0,0,56,0,-56
56,1,0,14,0,-14
57,1,1,1625,1798,173
58,1,1,453,2029,1576
59,1,1,548,2022,1474
60,1,0,9,0,-9
61,1,0,52,0,-52
62,0,0,52,0,-52
63,0,0,79,0,-79
64,1,0,111,0,-111
65,0,0,37,0,-37
66,1,1,52,1380,1328
67,0,0,0,0,0
68,1,1,86,2055,1969
69,1,1,1113,1253,140
70,1,0,1,0,-1
71,1,0,31,0,-31
72,0,0,22,0,-22
73,1,0,10,0,-10
74,1,0,0,0,0
75,1,0,30,0,-30
76,1,0,1,0,-1
77,1,1,507,1240,733
78,1,1,88,1433,1345
79,0,0,49,0,-49
80,1,0,27,0,-27
81,0,0,34,0,-34
82,0,0,22,0,-22
83,0,0,12,0,-12
84,1,0,30,0,-30
85,0,0,158,0,-158
86,1,0,35,0,-35
87,1,0,3,0,-3
88,1,0,38,0,-38
89,1,1,1082,1473,391
90,1,1,1260,1454,194
91,0,0,16,0,-16
92,1,1,135,1401,1266
93,1,0,18,0,-18
94,1,1,725,2111,1386
95,1,1,239,3794,3555
96,1,0,1,0,-1
97,1,1,447,1525,1078
98,1,0,21,0,-21
99,1,1,1296,1881,585
100,0,0,192,0,-192
101,1,1,1502,1686,184
102,1,0,0,0,0
103,1,1,33,1950,1917
104,1,1,68,1295,1227
105,1,1,474,1400,926
106,1,1,1411,1331,-80
107,0,0,50,0,-50
108,1,1,146,1268,1122
109,1,0,7,0,-7
110,0,0,27,0,-27
111,1,1,167,1928,1761
112,1,1,2886,1267,-1619
113,1,0,55,0,-55
114,1,1,99,1554,1455
115,1,0,143,0,-143
116,0,0,19,0,-19
117,1,0,1,0,-1
118,1,1,856,2389,1533
119,0,0,39,0,-39
120,0,0,52,0,-52
121,1,0,24,0,-24
122,1,0,30,0,-30
123,0,0,90,0,-90
124,0,0,72,0,-72
125,0,0,14,0,-14
126,1,1,287,1352,1065
127,1,1,505,1482,977
128,0,0,8,0,-8
129,1,1,3095,2162,-933
130,1,1,683,2211,1528
131,0,0,8,0,-8
132,1,1,163,1249,1086
133,1,0,156,0,-156
134,0,0,53,0,-53
135,1,0,18,0,-18
136,1,0,55,0,-55
137,1,1,286,1531,1245
138,1,1,1715,1283,-432
139,1,0,17,0,-17
140,0,0,65,0,-65
141,1,0,8,0,-8
142,0,0,44,0,-44
143,0,0,50,0,-50
144,1,1,486,1446,960
145,1,1,236,1242,1006
146,0,0,40,0,-40
147,0,0,13,0,-13
148,0,0,20,0,-20
149,1,0,48,0,-48
150,1,0,5,0,-5
151,1,0,7,0,-7
152,0,0,5,0,-5
153,1,1,327,1578,1251
154,1,1,737,1631,894
155,0,0,22,0,-22
156,0,0,0,0,0
157,1,0,27,0,-27
158,1,1,648,1997,1349
159,1,1,209,1489,1280
160,1,1,424,1584,1160
161,0,0,15,0,-15
162,0,0,49,0,-49
163,1,1,198,1386,1188
164,1,0,12,0,-12
165,1,1,234,1429,1195
166,1,1,148,1510,1362
167,0,0,7,0,-7
168,1,1,1008,1259,251
169,1,1,1526,1841,315
170,0,0,223,0,-223
171,1,0,53,0,-53
172,1,1,58,1613,1555
173,0,0,100,0,-100
174,1,0,1,0,-1
175,0,0,65,0,-65
176,1,1,339,1283,944
177,1,1,766,2369,1603
178,1,1,189,1834,1645
179,0,0,194,0,-194
180,1,0,28,0,-28
181,1,0,20,0,-20
182,1,1,58,1239,1181
183,0,0,3,0,-3
184,0,0,32,0,-32
185,1,0,42,0,-42
186,1,0,49,0,-49
187,1,0,3,0,-3
188,1,0,282,0,-282
189,1,0,88,0,-88
190,1,0,24,0,-24
191,1,1,1208,1774,566
192,0,0,65,0,-65
193,0,0,10,0,-10
194,0,0,153,0,-153
195,0,0,187,0,-187
196,1,0,8,0,-8
197,1,0,144,0,-144
198,1,1,804,1283,479
199,1,0,11,0,-11
200,0,0,26,0,-26
201,1,1,313,1249,936
202,1,0,42,0,-42
203,1,1,1740,1780,40
204,1,0,23,0,-23
205,1,1,1023,1767,744
206,1,0,35,0,-35
207,1,0,26,0,-26
208,1,1,870,2040,1170
209,0,0,130,0,-130
210,1,0,18,0,-18
211,1,1,360,1269,909
212,0,0,257,0,-257
213,0,0,88,0,-88
214,1,1,281,1285,1004
215,1,0,1,0,-1
216,1,0,32,0,-32
217,1,1,454,1394,940
218,1,0,31,0,-31
219,0,0,15,0,-15
220,1,1,284,1661,1377
221,1,1,94,1277,1183
222,1,1,664,1318,654
223,1,0,15,0,-15
224,0,0,73,0,-73
225,1,0,48,0,-48
226,1,1,206,2515,2309
227,0,0,26,0,-26
228,1,1,505,1502,997
229,0,0,55,0,-55
230,1,1,55,1253,1198
231,1,1,925,2347,1422
232,1,1,177,4481,4304
233,1,0,29,0,-29
234,1,1,730,1384,654
235,1,0,121,0,-121
236,1,1,112,1320,1208
237,0,0,40,0,-40
238,0,0,5,0,-5
239,1,0,12,0,-12
240,1,1,323,1267,944
241,1,0,10,0,-10
242,1,1,36,1637,1601
243,1,0,23,0,-23
244,1,1,1467,1629,162
245,0,0,7,0,-7
246,0,0,13,0,-13
247,1,1,254,1765,1511
248,1,0,5,0,-5
249,1,1,792,1268,476
250,1,0,82,0,-82
251,1,0,11,0,-11
252,1,0,48,0,-48
253,0,0,97,0,-97
254,1,1,496,1592,1096
255,1,0,40,0,-40
256,1,0,47,0,-47
257,1,1,569,1300,731
258,0,0,12,0,-12
259,0,0,86,0,-86
260,0,0,97,0,-97
261,1,0,31,0,-31
262,0,0,32,0,-32
263,1,1,301,1247,946
264,0,0,82,0,-82
265,0,0,17,0,-17
266,1,0,105,0,-105
267,0,0,35,0,-35
268,1,1,145,1410,1265
269,1,0,58,0,-58
270,0,0,113,0,-113
271,0,0,64,0,-64
272,0,0,56,0,-56
273,1,0,59,0,-59
274,1,0,61,0,-61
275,0,0,22,0,-22
276,1,0,130,0,-130
277,0,0,22,0,-22
278,1,1,100,1249,1149
279,1,1,182,1454,1272
280,1,0,62,0,-62
281,1,0,24,0,-24
282,0,0,27,0,-27
283,1,1,89,1265,1176
284,1,1,228,1642,1414
285,1,1,665,1264,599
286,1,0,22,0,-22
287,1,1,332,1344,1012
288,0,0,29,0,-29
289,0,0,9,0,-9
290,1,1,154,1284,1130
291,1,0,27,0,-27
292,1,1,617,1347,730
293,1,1,380,1554,1174
294,1,0,64,0,-64
295,1,1,545,2151,1606
296,1,0,33,0,-33
297,1,0,37,0,-37
298,1,1,272,2177,1905
299,0,0,156,0,-156
300,1,1,110,1393,1283
301,1,0,174,0,-174
302,1,0,3,0,-3
303,0,0,37,0,-37
304,0,0,19,0,-19
305,0,0,41,0,-41
306,1,0,9,0,-9
307,1,1,569,1339,770
308,0,0,99,0,-99
309,1,1,203,1319,1116
310,0,0,36,0,-36
311,1,1,214,1475,1261
312,0,0,8,0,-8
313,0,0,1,0,-1
314,1,1,547,1512,965
315,1,1,510,1235,725
316,1,1,1406,1339,-67
317,0,0,23,0,-23
318,1,0,41,0,-41
319,1,1,908,1902,994
320,1,0,41,0,-41
321,1,0,159,0,-159
322,0,0,89,0,-89
323,1,1,90,1729,1639
324,1,1,139,1242,1103
325,1,1,114,2322,2208
326,1,0,23,0,-23
327,1,0,56,0,-56
328,0,0,35,0,-35
329,1,1,322,1544,1222
330,1,0,132,0,-132
331,1,1,406,2069,1663
332,1,1,515,1646,1131
333,1,1,726,1560,834
334,0,0,18,0,-18
335,0,0,72,0,-72
336,1,1,244,1516,1272
337,0,0,36,0,-36
338,1,1,180,1426,1246
339,1,1,354,1490,1136
340,1,0,11,0,-11
341,0,0,3,0,-3
342,0,0,42,0,-42
343,0,0,11,0,-11
344,1,1,315,2346,2031
345,1,0,30,0,-30
346,1,0,7,0,-7
347,1,0,14,0,-14
348,1,0,88,0,-88
349,0,0,42,0,-42
350,1,1,817,1907,1090
351,1,1,279,1252,973
352,1,1,1304,1684,380
353,1,1,216,1368,1152
354,1,1,707,1465,758
355,1,1,1027,1327,300
356,1,1,381,1351,970
357,1,0,37,0,-37
358,0,0,4,0,-4
359,1,1,239,1675,1436
360,1,0,15,0,-15
361,1,0,60,0,-60
362,1,0,0,0,0
363,1,0,5,0,-5
364,1,1,278,1242,964
365,0,0,142,0,-142
366,1,1,271,1428,1157
367,1,1,1288,1413,125
368,1,0,120,0,-120
369,1,1,178,2333,2155
370,0,0,39,0,-39
371,1,1,352,1778,1426
372,1,0,76,0,-76
373,1,0,17,0,-17
374,1,1,205,1428,1223
375,0,0,6,0,-6
376,0,0,23,0,-23
377,1,0,0,0,0
378,0,0,23,0,-23
379,0,0,31,0,-31
380,0,0,295,0,-295
381,1,1,135,1349,1214
382,1,0,69,0,-69
383,0,0,20,0,-20
384,1,0,93,0,-93
385,1,0,34,0,-34
386,0,0,6,0,-6
387,1,0,28,0,-28
388,1,1,447,1764,1317
389,1,1,299,1641,1342
390,0,0,10,0,-10
391,1,1,347,1878,1531
392,1,1,245,5749,5504
393,1,1,674,1253,579
394,1,1,971,1599,628
395,1,0,68,0,-68
396,0,0,43,0,-43
397,0,0,52,0,-52
398,0,0,15,0,-15
399,0,0,2,0,-2
400,1,0,69,0,-69
401,0,0,8,0,-8
402,1,1,26,2064,2038
403,0,0,7,0,-7
404,0,0,17,0,-17
405,1,0,260,0,-260
406,1,1,1370,2083,713
407,1,1,826,1240,414
408,1,1,171,1695,1524
409,1,1,364,1372,1008
410,1,1,1630,1261,-369
411,0,0,54,0,-54
412,0,0,85,0,-85
413,0,0,13,0,-13
414,1,1,1782,2522,740
415,1,0,10,0,-10
416,1,0,55,0,-55
417,1,0,34,0,-34
418,1,1,890,1296,406
419,0,0,70,0,-70
420,0,0,75,0,-75
421,1,0,70,0,-70
422,1,0,35,0,-35
423,1,1,884,2904,2020
424,1,0,34,0,-34
425,1,0,100,0,-100
426,1,0,85,0,-85
427,1,1,1723,3661,1938
428,0,0,31,0,-31
429,0,0,96,0,-96
430,1,1,1045,1481,436
431,1,0,123,0,-123
432,1,0,27,0,-27
433,0,0,29,0,-29
434,0,0,59,0,-59
435,0,0,162,0,-162
436,1,0,0,0,0
437,0,0,55,0,-55
438,0,0,6,0,-6
439,1,1,207,1254,1047
440,1,0,60,0,-60
441,1,1,99,1352,1253
442,0,0,45,0,-45
443,1,1,308,1814,1506
444,0,0,48,0,-48
445,0,0,24,0,-24
446,0,0,35,0,-35
447,1,0,6,0,-6
448,1,0,8,0,-8
449,0,0,30,0,-30
450,0,0,87,0,-87
451,1,0,21,0,-21
452,1,0,34,0,-34
453,1,0,15,0,-15
454,1,0,6,0,-6
455,1,1,319,1988,1669
456,0,0,46,0,-46
457,0,0,143,0,-143
458,0,0,6,0,-6
459,0,0,23,0,-23
460,1,0,10,0,-10
461,0,0,46,0,-46
462,1,1,531,1394,863
463,0,0,100,0,-100
464,0,0,45,0,-45
465,0,0,73,0,-73
466,0,0,40,0,-40
467,1,0,92,0,-92
468,1,0,99,0,-99
469,1,0,69,0,-69
470,0,0,24,0,-24
471,1,0,13,0,-13
472,0,0,109,0,-109
473,0,0,16,0,-16
474,1,1,262,1321,1059
475,1,1,362,1550,1188
476,1,1,259,1569,1310
477,1,1,40,1242,1202
478,1,0,29,0,-29
479,1,1,90,2248,2158
480,1,0,20,0,-20
481,1,0,159,0,-159
482,1,0,8,0,-8
483,1,1,366,1634,1268
484,1,0,0,0,0
485,1,0,8,0,-8
486,1,0,44,0,-44
487,1,1,403,1377,974
488,1,1,336,2286,1950
489,0,0,63,0,-63
490,0,0,40,0,-40
491,0,0,152,0,-152
492,1,1,319,1321,1002
493,1,1,145,1421,1276
494,0,0,15,0,-15
495,0,0,89,0,-89
496,0,0,7,0,-7
497,1,1,1015,1537,522
498,1,0,93,0,-93
499,1,1,1305,1588,283
500,1,0,148,0,-148
501,1,1,1144,1386,242
502,0,0,23,0,-23
503,0,0,61,0,-61
504,1,0,16,0,-16
505,0,0,24,0,-24
506,1,1,580,1394,814
507,1,1,267,1932,1665
508,0,0,0,0,0
509,1,1,299,1250,951
510,1,0,26,0,-26
511,1,0,3,0,-3
512,0,0,24,0,-24
513,1,0,97,0,-97
514,0,0,24,0,-24
515,0,0,17,0,-17
516,1,1,2002,1265,-737
517,1,1,25,1704,1679
518,1,0,7,0,-7
519,1,1,80,1387,1307
520,1,1,2630,1605,-1025
521,0,0,41,0,-41
522,1,1,522,3846,3324
523,0,0,12,0,-12
524,0,0,2,0,-2
525,1,1,406,1278,872
526,0,0,73,0,-73
527,0,0,147,0,-147
528,1,0,62,0,-62
529,1,1,875,1495,620
530,0,0,13,0,-13
531,1,0,0,0,0
532,0,0,139,0,-139
533,0,0,36,0,-36
534,0,0,62,0,-62
535,0,0,64,0,-64
536,1,1,247,1286,1039
537,1,0,153,0,-153
538,1,0,5,0,-5
539,1,1,703,1657,954
540,0,0,13,0,-13
541,1,1,883,2082,1199
542,1,1,697,2434,1737
543,1,0,144,0,-144
544,1,0,179,0,-179
545,1,1,273,2281,2008
546,1,0,57,0,-57
547,1,0,19,0,-19
548,0,0,93,0,-93
549,1,1,524,1448,924
550,1,1,1585,1595,10
551,1,0,70,0,-70
552,1,0,104,0,-104
553,1,0,112,0,-112
554,0,0,3,0,-3
555,0,0,86,0,-86
556,0,0,24,0,-24
557,1,1,178,1256,1078
558,0,0,77,0,-77
559,1,1,150,1584,1434
560,1,0,37,0,-37
561,0,0,41,0,-41
562,1,0,37,0,-37
563,1,1,635,2135,1500
564,0,0,39,0,-39
565,1,0,7,0,-7
566,1,0,20,0,-20
567,1,0,62,0,-62
568,0,0,16,0,-16
569,1,1,103,2027,1924
570,1,1,192,1716,1524
571,1,0,59,0,-59
572,0,0,29,0,-29
573,1,1,658,1480,822
574,0,0,69,0,-69
575,0,0,9,0,-9
576,1,1,1223,1737,514
577,0,0,32,0,-32
578,1,0,7,0,-7
579,0,0,54,0,-54
580,0,0,39,0,-39
581,1,1,372,1704,1332
582,1,1,1864,1266,-598
583,1,0,133,0,-133
584,0,0,65,0,-65
585,1,1,183,1640,1457
586,1,1,359,1828,1469
587,1,0,161,0,-161
588,1,0,42,0,-42
589,0,0,0,0,0
590,1,0,47,0,-47
591,1,1,74,2298,2224
592,0,0,27,0,-27
593,1,1,2298,1589,-709
594,0,0,37,0,-37
595,0,0,96,0,-96
596,0,0,33,0,-33
597,1,0,29,0,-29
598,0,0,147,0,-147
599,0,0,11,0,-11
600,1,0,76,0,-76
601,0,0,77,0,-77
602,1,1,1778,1258,-520
603,0,0,11,0,-11
604,1,0,5,0,-5
605,0,0,38,0,-38
606,1,0,44,0,-44
607,0,0,174,0,-174
608,1,0,30,0,-30
609,1,0,20,0,-20
610,0,0,96,0,-96
611,0,0,41,0,-41
612,0,0,156,0,-156
613,1,1,926,1237,311
614,0,0,173,0,-173
615,1,0,24,0,-24
616,0,0,115,0,-115
617,1,0,34,0,-34
618,1,0,63,0,-63
619,0,0,11,0,-11
620,0,0,72,0,-72
621,1,0,105,0,-105
622,0,0,5,0,-5
623,1,0,11,0,-11
624,1,1,680,1376,696
625,1,1,614,1352,738
626,0,0,22,0,-22
627,0,0,1,0,-1
628,1,0,4,0,-4
629,1,1,427,1753,1326
630,1,1,220,2451,2231
631,0,0,102,0,-102
632,0,0,30,0,-30
633,1,0,59,0,-59
634,1,1,172,1246,1074
635,1,0,14,0,-14
636,0,0,9,0,-9
637,1,1,1336,1278,-58
638,1,0,118,0,-118
639,1,1,23,1251,1228
640,1,1,684,1363,679
641,0,0,7,0,-7
642,1,0,2,0,-2
643,1,1,119,2900,2781
644,1,0,114,0,-114
645,0,0,68,0,-68
646,0,0,97,0,-97
647,1,0,23,0,-23
648,1,1,11,2077,2066
649,0,0,169,0,-169
650,1,1,469,3243,2774
651,1,1,83,1243,1160
652,0,0,15,0,-15
653,1,1,1115,1249,134
654,1,1,276,1639,1363
655,0,0,103,0,-103
656,1,0,27,0,-27
657,0,0,227,0,-227
658,1,0,68,0,-68
659,1,0,15,0,-15
660,1,1,476,1383,907
661,1,0,22,0,-22
662,1,1,184,1487,1303
663,0,0,43,0,-43
664,0,0,3,0,-3
665,1,0,23,0,-23
666,0,0,37,0,-37
667,1,0,84,0,-84
668,1,1,1851,1683,-168
669,1,0,42,0,-42
670,0,0,105,0,-105
671,0,0,70,0,-70
672,1,0,91,0,-91
673,1,1,352,1539,1187
674,1,0,14,0,-14
675,1,0,119,0,-119
676,1,0,70,0,-70
677,0,0,18,0,-18
678,0,0,39,0,-39
679,0,0,79,0,-79
680,1,0,22,0,-22
681,1,0,18,0,-18
682,1,1,1776,2078,302
683,1,0,69,0,-69
684,1,1,295,1497,1202
685,1,1,1261,1271,10
686,1,0,25,0,-25
687,1,1,344,1400,1056
688,0,0,110,0,-110
689,0,0,6,0,-6
690,1,1,201,1689,1488
691,1,0,101,0,-101
692,1,1,325,1248,923
693,0,0,117,0,-117
694,1,1,170,1470,1300
695,0,0,68,0,-68
696,0,0,3,0,-3
697,0,0,6,0,-6
698,1,0,70,0,-70
699,0,0,7,0,-7
700,0,0,30,0,-30
701,0,0,30,0,-30
702,1,1,1826,1737,-89
703,0,0,37,0,-37
704,1,0,21,0,-21
705,1,1,133,1438,1305
706,1,0,2,0,-2
707,0,0,4,0,-4
708,0,0,7,0,-7
709,1,0,56,0,-56
710,0,0,275,0,-275
711,0,0,50,0,-50
712,1,1,2299,1303,-996
713,0,0,57,0,-57
714,0,0,1,0,-1
715,0,0,37,0,-37
716,1,0,16,0,-16
717,1,0,64,0,-64
718,1,1,1448,1345,-103
719,0,0,63,0,-63
720,0,0,95,0,-95
721,1,0,22,0,-22
722,1,0,12,0,-12
723,0,0,62,0,-62
724,1,1,279,1256,977
725,0,0,36,0,-36
726,1,1,334,1308,974
727,1,1,759,1661,902
728,1,1,464,1659,1195
729,0,0,17,0,-17
730,1,1,731,1452,721
731,1,0,25,0,-25
732,1,1,143,1587,1444
733,1,1,271,1565,1294
734,0,0,28,0,-28
735,0,0,96,0,-96
736,0,0,45,0,-45
737,1,0,2,0,-2
738,0,0,31,0,-31
739,0,0,227,0,-227
740,1,0,11,0,-11
741,1,1,1593,1552,-41
742,1,1,939,1278,339
743,1,0,12,0,-12
744,1,1,619,1292,673
745,1,0,37,0,-37
746,1,1,437,1934,1497
747,0,0,116,0,-116
748,1,1,449,1343,894
749,0,0,128,0,-128
750,1,0,74,0,-74
751,0,0,6,0,-6
752,1,0,48,0,-48
753,1,0,50,0,-50
754,0,0,94,0,-94
755,1,1,133,2301,2168
756,1,0,24,0,-24
757,1,0,57,0,-57
758,1,1,437,1241,804
759,0,0,38,0,-38
760,1,1,1178,1363,185
761,1,1,213,1426,1213
762,1,0,62,0,-62
763,1,0,40,0,-40
764,0,0,15,0,-15
765,1,0,50,0,-50
766,0,0,199,0,-199
767,0,0,252,0,-252
768,0,0,57,0,-57
769,1,1,533,5773,5240
770,1,0,5,0,-5
771,1,0,17,0,-17
772,1,1,86,1328,1242
773,1,1,306,1410,1104
774,1,0,47,0,-47
775,0,0,7,0,-7
776,0,0,86,0,-86
777,1,0,61,0,-61
778,1,0,52,0,-52
779,1,0,35,0,-35
780,1,0,51,0,-51
781,0,0,32,0,-32
782,0,0,28,0,-28
783,0,0,115,0,-115
784,0,0,25,0,-25
785,1,0,21,0,-21
786,0,0,2,0,-2
787,1,0,8,0,-8
788,1,1,160,1275,1115
789,1,0,47,0,-47
790,0,0,47,0,-47
791,1,1,863,1984,1121
792,1,1,387,1491,1104
793,1,0,75,0,-75
794,1,1,561,1924,1363
795,1,1,392,1286,894
796,0,0,26,0,-26
797,0,0,1,0,-1
798,0,0,64,0,-64
799,1,1,1249,1331,82
800,1,0,100,0,-100
801,1,0,61,0,-61
802,1,1,115,1344,1229
803,0,0,94,0,-94
804,1,0,17,0,-17
805,1,1,518,1547,1029
806,1,1,724,1765,1041
807,1,0,4,0,-4
808,1,1,619,1628,1009
809,0,0,42,0,-42
810,1,0,57,0,-57
811,1,0,2,0,-2
812,1,1,214,1313,1099
813,0,0,1,0,-1
814,1,1,684,1409,725
815,0,0,23,0,-23
816,0,0,8,0,-8
817,1,1,207,1661,1454
818,1,1,68,1782,1714
819,1,1,442,1765,1323
820,1,0,22,0,-22
821,1,1,997,1351,354
822,0,0,110,0,-110
823,1,0,46,0,-46
824,0,0,112,0,-112
825,0,0,15,0,-15
826,1,1,489,1314,825
827,1,0,19,0,-19
828,1,0,11,0,-11
829,1,1,600,1568,968
830,0,0,145,0,-145
831,1,1,1143,1536,393
832,1,1,1739,1651,-88
833,0,0,90,0,-90
834,1,1,751,1560,809
835,1,0,34,0,-34
836,1,1,65,1502,1437
837,1,1,575,1699,1124
838,0,0,124,0,-124
839,1,0,22,0,-22
840,0,0,50,0,-50
841,1,1,850,1305,455
842,1,1,493,1371,878
843,1,1,389,4247,3858
844,0,0,50,0,-50
845,1,1,810,1251,441
846,0,0,33,0,-33
847,0,0,8,0,-8
848,0,0,62,0,-62
849,1,0,92,0,-92
850,1,0,12,0,-12
851,0,0,57,0,-57
852,1,1,622,1386,764
853,1,1,193,1769,1576
854,1,0,161,0,-161
855,0,0,7,0,-7
856,1,1,420,1296,876
857,1,0,2,0,-2
858,0,0,16,0,-16
859,0,0,133,0,-133
860,1,0,47,0,-47
861,1,0,10,0,-10
862,1,1,1472,1408,-64
863,0,0,39,0,-39
864,1,1,337,1333,996
865,0,0,111,0,-111
866,1,0,11,0,-11
867,0,0,15,0,-15
868,0,0,120,0,-120
869,0,0,18,0,-18
870,0,0,21,0,-21
871,0,0,98,0,-98
872,1,0,11,0,-11
873,1,1,696,1531,835
874,1,0,44,0,-44
875,0,0,12,0,-12
876,0,0,28,0,-28
877,1,0,66,0,-66
878,0,0,0,0,0
879,0,0,43,0,-43
880,0,0,1,0,-1
881,1,0,11,0,-11
882,1,0,27,0,-27
883,1,0,5,0,-5
884,1,0,46,0,-46
885,1,1,139,1247,1108
886,0,0,2,0,-2
887,1,1,138,2177,2039
888,1,1,969,1950,981
889,1,1,831,1950,1119
890,0,0,43,0,-43
891,1,1,11,1412,1401
892,1,1,310,1717,1407
893,0,0,8,0,-8
894,1,0,5,0,-5
895,1,0,19,0,-19
896,1,0,109,0,-109
897,1,0,147,0,-147
898,0,0,2,0,-2
899,1,0,2,0,-2
900,1,1,545,1592,1047
901,1,0,53,0,-53
902,0,0,48,0,-48
903,0,0,71,0,-71
904,1,1,496,1341,845
905,1,1,753,1355,602
906,1,1,186,1740,1554
907,0,0,0,0,0
908,1,1,456,1417,961
909,1,1,984,1349,365
910,1,1,121,1290,1169
911,1,1,1072,1236,164
912,1,0,84,0,-84
913,0,0,39,0,-39
914,1,0,29,0,-29
915,0,0,21,0,-21
916,0,0,47,0,-47
917,1,1,894,1810,916
918,1,0,26,0,-26
919,1,0,33,0,-33
920,1,1,500,1328,828
921,1,1,2120,1239,-881
922,0,0,42,0,-42
923,0,0,3,0,-3
924,0,0,43,0,-43
925,1,0,8,0,-8
926,1,1,290,1642,1352
927,0,0,2,0,-2
928,1,0,29,0,-29
929,1,1,82,1321,1239
930,1,0,46,0,-46
931,0,0,27,0,-27
932,1,1,609,1488,879
933,1,0,56,0,-56
934,1,1,1672,1286,-386
935,0,0,46,0,-46
936,1,1,425,1515,1090
937,0,0,7,0,-7
938,1,1,90,1414,1324
939,0,0,13,0,-13
940,1,1,277,1326,1049
941,0,0,180,0,-180
942,0,0,7,0,-7
943,0,0,41,0,-41
944,0,0,10,0,-10
945,1,1,543,1507,964
946,0,0,47,0,-47
947,0,0,26,0,-26
948,1,0,45,0,-45
949,0,0,42,0,-42
950,1,1,376,1442,1066
951,1,1,449,1475,1026
952,1,0,9,0,-9
953,1,1,446,1291,845
954,0,0,24,0,-24
955,1,0,0,0,0
956,1,1,564,1707,1143
957,1,0,2,0,-2
958,1,0,19,0,-19
959,1,1,1137,1647,510
960,1,1,396,1359,963
961,1,0,58,0,-58
962,1,1,280,1857,1577
963,0,0,28,0,-28
964,1,1,1256,3678,2422
965,0,0,295,0,-295
966,1,1,123,1456,1333
967,0,0,27,0,-27
968,1,0,5,0,-5
969,0,0,41,0,-41
970,1,1,214,1329,1115
971,0,0,129,0,-129
972,1,0,31,0,-31
973,1,0,83,0,-83
974,1,0,2,0,-2
975,0,0,42,0,-42
976,0,0,17,0,-17
977,1,1,736,1370,634
978,1,1,146,1254,1108
979,0,0,2,0,-2
980,0,0,65,0,-65
981,1,0,54,0,-54
982,1,1,848,2293,1445
983,0,0,111,0,-111
984,1,1,540,1440,900
985,0,0,2,0,-2
986,1,0,4,0,-4
987,1,0,5,0,-5
988,0,0,167,0,-167
989,0,0,19,0,-19
990,1,1,108,5716,5608
991,1,0,14,0,-14
992,1,0,5,0,-5
993,0,0,22,0,-22
994,0,0,31,0,-31
995,1,0,48,0,-48
996,1,0,5,0,-5
997,0,0,6,0,-6
998,1,0,9,0,-9
999,1,1,360,1878,1518
1000,1,0,95,0,-95
1001,0,0,57,0,-57
1002,0,0,6,0,-6
1003,1,0,68,0,-68
1004,0,0,18,0,-18
1005,1,0,28,0,-28
1006,0,0,113,0,-113
1007,1,0,78,0,-78
1008,1,0,15,0,-15
1009,1,1,858,1261,403
1010,0,0,94,0,-94
1011,0,0,101,0,-101
1012,0,0,44,0,-44
1013,0,0,55,0,-55
1014,1,0,24,0,-24
1015,0,0,24,0,-24
1016,1,0,2,0,-2
1017,0,0,26,0,-26
1018,1,0,3,0,-3
1019,0,0,137,0,-137
1020,1,0,36,0,-36
1021,1,0,75,0,-75
1022,1,0,56,0,-56
1023,0,0,53,0,-53
1024,1,0,19,0,-19
1025,0,0,17,0,-17
1026,1,0,4,0,-4
1027,1,0,49,0,-49
1028,0,0,35,0,-35
1029,1,1,731,1851,1120
1030,1,1,1006,1425,419
1031,1,0,2,0,-2
1032,0,0,7,0,-7
1033,0,0,112,0,-112
1034,1,1,1804,2514,710
1035,1,0,65,0,-65
1036,0,0,41,0,-41
1037,1,0,56,0,-56
1038,1,1,407,1440,1033
1039,1,1,50,1560,1510
1040,1,0,7,0,-7
1041,0,0,25,0,-25
1042,1,0,121,0,-121
1043,1,1,1436,1579,143
1044,0,0,43,0,-43
1045,1,1,694,1362,668
1046,1,0,93,0,-93
1047,1,0,43,0,-43
1048,1,0,30,0,-30
1049,1,1,875,1386,511
1050,1,1,1053,1447,394
1051,1,0,5,0,-5
1052,0,0,77,0,-77
1053,0,0,31,0,-31
1054,1,0,39,0,-39
1055,1,1,296,1558,1262
1056,0,0,57,0,-57
1057,1,0,101,0,-101
1058,1,1,666,1864,1198
1059,0,0,6,0,-6
1060,1,0,49,0,-49
1061,0,0,34,0,-34
1062,0,0,71,0,-71
1063,0,0,26,0,-26
1064,1,1,432,1819,1387
1065,1,0,14,0,-14
1066,1,1,44,1257,1213
1067,1,1,164,1248,1084
1068,1,0,4,0,-4
1069,1,1,514,1465,951
1070,1,1,697,1680,983
1071,0,0,112,0,-112
1072,0,0,49,0,-49
1073,1,0,74,0,-74
1074,0,0,26,0,-26
1075,1,1,307,1447,1140
1076,1,1,186,1775,1589
1077,0,0,48,0,-48
1078,0,0,15,0,-15
1079,1,1,995,1269,274
1080,1,1,524,1588,1064
1081,0,0,12,0,-12
1082,1,0,37,0,-37
1083,1,1,742,1504,762
1084,1,0,24,0,-24
1085,1,0,89,0,-89
1086,1,1,114,13678,13564
1087,0,0,61,0,-61
1088,1,0,23,0,-23
1089,0,0,68,0,-68
1090,1,1,365,1274,909
1091,1,0,81,0,-81
1092,1,1,173,1708,1535
1093,0,0,2,0,-2
1094,0,0,30,0,-30
1095,0,0,56,0,-56
1096,0,0,14,0,-14
1097,0,0,88,0,-88
1098,0,0,14,0,-14
1099,0,0,105,0,-105
1100,0,0,48,0,-48
1101,1,1,40,1406,1366
1102,1,0,23,0,-23
1103,1,0,7,0,-7
1104,1,0,7,0,-7
1105,1,1,51,1531,1480
1106,1,1,170,1685,1515
1107,1,1,654,1480,826
1108,1,0,49,0,-49
1109,0,0,9,0,-9
1110,1,0,70,0,-70
1111,1,1,1119,1237,118
1112,0,0,48,0,-48
1113,1,0,52,0,-52
1114,1,1,303,1586,1283
1115,1,1,885,1585,700
1116,1,1,21,1436,1415
1117,0,0,127,0,-127
1118,0,0,35,0,-35
1119,1,1,1085,1420,335
1120,1,0,23,0,-23
1121,1,0,1,0,-1
1122,0,0,74,0,-74
1123,1,0,7,0,-7
1124,1,0,27,0,-27
1125,1,0,35,0,-35
1126,0,0,8,0,-8
1127,1,0,15,0,-15
1128,0,0,12,0,-12
1129,0,0,32,0,-32
1130,1,0,14,0,-14
1131,0,0,71,0,-71
1132,0,0,97,0,-97
1133,0,0,33,0,-33
1134,1,1,228,1426,1198
1135,1,0,3,0,-3
1136,0,0,8,0,-8
1137,1,1,91,1352,1261
1138,0,0,17,0,-17
1139,0,0,57,0,-57
1140,0,0,87,0,-87
1141,0,0,0,0,0
1142,1,0,17,0,-17
1143,0,0,67,0,-67
1144,0,0,0,0,0
1145,1,1,181,1353,1172
1146,0,0,52,0,-52
1147,0,0,45,0,-45
1148,1,0,23,0,-23
1149,1,1,1078,1271,193
1150,0,0,19,0,-19
1151,0,0,69,0,-69
1152,0,0,32,0,-32
1153,1,0,29,0,-29
1154,1,0,6,0,-6
1155,1,0,37,0,-37
1156,1,1,944,1654,710
1157,1,1,383,1419,1036
1158,1,0,36,0,-36
1159,0,0,71,0,-71
1160,0,0,30,0,-30
1161,0,0,25,0,-25
1162,1,1,841,1404,563
1163,1,1,489,1992,1503
1164,1,1,416,2295,1879
1165,1,0,29,0,-29
1166,1,0,27,0,-27
1167,1,1,255,1429,1174
1168,0,0,101,0,-101
1169,1,0,5,0,-5
1170,1,0,25,0,-25
1171,1,1,1133,1300,167
1172,0,0,137,0,-137
1173,1,1,1408,1451,43
1174,1,1,1369,1914,545
1175,0,0,9,0,-9
1176,1,1,154,1266,1112
1177,1,1,884,1259,375
1178,1,0,58,0,-58
1179,1,1,252,1982,1730
1180,0,0,35,0,-35
1181,0,0,7,0,-7
1182,1,0,23,0,-23
1183,0,0,89,0,-89
1184,0,0,24,0,-24
1185,0,0,215,0,-215
1186,0,0,21,0,-21
1187,0,0,124,0,-124
1188,1,1,645,1787,1142
1189,0,0,1,0,-1
1190,1,1,6,1244,1238
1191,0,0,19,0,-19
1192,1,0,50,0,-50
1193,1,0,58,0,-58
1194,1,1,849,1739,890
1195,0,0,35,0,-35
1196,0,0,38,0,-38
1197,1,1,784,1724,940
1198,1,0,48,0,-48
1199,1,1,303,1677,1374
1200,0,0,106,0,-106
1201,1,0,68,0,-68
1202,1,0,27,0,-27
1203,0,0,25,0,-25
1204,1,0,154,0,-154
1205,0,0,28,0,-28
1206,0,0,56,0,-56
1207,1,0,71,0,-71
1208,1,0,148,0,-148
1209,1,0,39,0,-39
1210,1,1,393,1407,1014
1211,0,0,9,0,-9
1212,1,1,74,1682,1608
1213,1,0,10,0,-10
1214,0,0,5,0,-5
1215,1,1,211,1306,1095
1216,1,1,1220,1269,49
1217,1,1,85,1368,1283
1218,0,0,49,0,-49
1219,1,0,290,0,-290
1220,1,0,7,0,-7
1221,0,0,41,0,-41
1222,0,0,109,0,-109
1223,0,0,16,0,-16
1224,0,0,24,0,-24
1225,0,0,20,0,-20
1226,0,0,0,0,0
1227,1,0,101,0,-101
1228,1,1,1087,1257,170
1229,0,0,29,0,-29
1230,0,0,102,0,-102
1231,1,1,875,1436,561
1232,1,1,254,1744,1490
1233,0,0,62,0,-62
1234,1,1,299,1585,1286
1235,1,0,3,0,-3
1236,0,0,11,0,-11
1237,0,0,48,0,-48
1238,1,0,15,0,-15
1239,1,0,3,0,-3
1240,0,0,125,0,-125
1241,0,0,57,0,-57
1242,1,1,56,1622,1566
1243,0,0,35,0,-35
1244,1,1,385,1418,1033
1245,1,1,207,1235,1028
1246,1,1,1759,1974,215
1247,0,0,8,0,-8
1248,1,1,371,1998,1627
1249,0,0,100,0,-100
1250,0,0,99,0,-99
1251,0,0,69,0,-69
1252,1,0,56,0,-56
1253,1,0,2,0,-2
1254,1,0,114,0,-114
1255,0,0,12,0,-12
1256,1,1,1045,1702,657
1257,0,0,3,0,-3
1258,0,0,55,0,-55
1259,0,0,66,0,-66
1260,0,0,13,0,-13
1261,1,1,264,2005,1741
1262,0,0,2,0,-2
1263,1,0,68,0,-68
1264,0,0,79,0,-79
1265,1,0,43,0,-43
1266,0,0,12,0,-12
1267,0,0,4,0,-4
1268,1,1,172,1390,1218
1269,0,0,13,0,-13
1270,1,1,84,1405,1321
1271,0,0,6,0,-6
1272,1,0,15,0,-15
1273,1,1,344,2032,1688
1274,0,0,73,0,-73
1275,0,0,102,0,-102
1276,1,1,53,1508,1455
1277,0,0,32,0,-32
1278,0,0,66,0,-66
1279,1,0,141,0,-141
1280,0,0,17,0,-17
1281,1,1,139,1270,1131
1282,1,1,358,1326,968
1283,1,0,31,0,-31
1284,0,0,146,0,-146
1285,0,0,20,0,-20
1286,1,0,71,0,-71
1287,1,1,1435,1572,137
1288,1,0,90,0,-90
1289,0,0,0,0,0
1290,1,1,617,1497,880
1291,1,1,158,1333,1175
1292,1,0,3,0,-3
1293,1,0,31,0,-31
1294,1,1,63,1649,1586
1295,1,1,763,1308,545
1296,1,1,379,2281,1902
1297,1,0,14,0,-14
1298,0,0,26,0,-26
1299,1,0,156,0,-156
1300,1,0,45,0,-45
1301,1,0,221,0,-221
1302,1,0,65,0,-65
1303,1,1,290,1263,973
1304,1,0,84,0,-84
1305,1,0,47,0,-47
1306,1,1,1188,1265,77
1307,0,0,33,0,-33
1308,1,1,764,3055,2291
1309,1,1,1387,1265,-122
1310,1,1,1245,1578,333
1311,1,1,710,1273,563
1312,1,0,161,0,-161
1313,1,1,1272,1372,100
1314,1,0,50,0,-50
1315,1,1,227,1610,1383
1316,1,1,90,2220,2130
1317,1,0,72,0,-72
1318,1,0,25,0,-25
1319,0,0,150,0,-150
1320,0,0,117,0,-117
1321,1,1,1523,1591,68
1322,0,0,92,0,-92
1323,1,1,357,1418,1061
1324,1,1,563,1342,779
1325,0,0,31,0,-31
1326,0,0,26,0,-26
1327,1,1,964,1414,450
1328,1,1,151,1316,1165
1329,0,0,6,0,-6
1330,0,0,57,0,-57
1331,1,0,92,0,-92
1332,0,0,41,0,-41
1333,1,0,75,0,-75
1334,1,1,838,3380,2542
1335,0,0,27,0,-27
1336,0,0,71,0,-71
1337,1,0,165,0,-165
1338,0,0,29,0,-29
1339,0,0,10,0,-10
1340,0,0,14,0,-14
1341,1,0,54,0,-54
1342,1,0,4,0,-4
1343,1,1,387,1654,1267
1344,0,0,121,0,-121
1345,1,1,302,2016,1714
1346,0,0,21,0,-21
1347,1,0,33,0,-33
1348,0,0,5,0,-5
1349,1,1,116,1937,1821
1350,0,0,34,0,-34
1351,1,0,65,0,-65
1352,1,1,161,1625,1464
1353,0,0,72,0,-72
1354,0,0,21,0,-21
1355,1,0,39,0,-39
1356,1,1,170,1718,1548
1357,1,0,17,0,-17
1358,0,0,56,0,-56
1359,1,0,131,0,-131
1360,0,0,64,0,-64
1361,1,0,106,0,-106
1362,1,0,10,0,-10
1363,1,1,598,1381,783
1364,1,1,1149,3790,2641
1365,0,0,1,0,-1
1366,1,0,103,0,-103
1367,1,1,429,1494,1065
1368,1,1,1940,1684,-256
1369,1,1,892,1907,1015
1370,1,1,817,1524,707
1371,1,0,23,0,-23
1372,1,0,10,0,-10
1373,0,0,48,0,-48
1374,1,0,94,0,-94
1375,0,0,35,0,-35
1376,1,1,570,1314,744
1377,0,0,64,0,-64
1378,1,0,0,0,0
1379,1,1,141,1517,1376
1380,0,0,67,0,-67
1381,1,0,77,0,-77
1382,1,0,2,0,-2
1383,0,0,267,0,-267
1384,1,0,48,0,-48
1385,0,0,35,0,-35
1386,0,0,9,0,-9
1387,0,0,71,0,-71
1388,0,0,173,0,-173
1389,1,1,297,2301,2004
1390,0,0,9,0,-9
1391,1,1,592,1267,675
1392,1,1,707,2378,1671
1393,1,0,39,0,-39
1394,1,0,30,0,-30
1395,0,0,13,0,-13
1396,1,0,48,0,-48
1397,1,1,225,1256,1031
1398,1,0,13,0,-13
1399,0,0,57,0,-57
1400,1,1,399,1367,968
1401,1,1,999,1512,513
1402,1,1,167,1442,1275
1403,1,0,5,0,-5
1404,1,1,115,1303,1188
1405,1,0,242,0,-242
1406,1,0,10,0,-10
1407,1,0,21,0,-21
1408,1,0,25,0,-25
1409,1,0,49,0,-49
1410,0,0,215,0,-215
1411,0,0,37,0,-37
1412,1,0,29,0,-29
1413,1,1,198,1322,1124
1414,1,1,27,1274,1247
1415,1,1,1178,1512,334
1416,1,0,181,0,-181
1417,0,0,22,0,-22
1418,0,0,7,0,-7
1419,1,0,31,0,-31
1420,0,0,55,0,-55
1421,0,0,17,0,-17
1422,1,0,68,0,-68
1423,0,0,15,0,-15
1424,1,0,11,0,-11
1425,0,0,2,0,-2
1426,1,1,431,1350,919
1427,1,0,16,0,-16
1428,0,0,94,0,-94
1429,1,1,421,1278,857
1430,1,1,726,1245,519
1431,1,0,45,0,-45
1432,1,1,2173,1747,-426
1433,1,1,431,1560,1129
1434,1,0,8,0,-8
1435,0,0,5,0,-5
1436,0,0,262,0,-262
1437,0,0,36,0,-36
1438,1,0,1,0,-1
1439,0,0,13,0,-13
1440,1,0,31,0,-31
1441,0,0,11,0,-11
1442,0,0,93,0,-93
1443,1,1,22,2294,2272
1444,1,0,37,0,-37
1445,1,1,285,1272,987
1446,1,1,404,1313,909
1447,0,0,45,0,-45
1448,1,1,582,2151,1569
1449,0,0,14,0,-14
1450,1,1,72,2141,2069
1451,1,0,133,0,-133
1452,1,1,165,2113,1948
1453,0,0,57,0,-57
1454,1,1,314,2477,2163
1455,1,1,265,1609,1344
1456,1,0,32,0,-32
1457,1,0,26,0,-26
1458,0,0,37,0,-37
1459,1,1,514,7437,6923
1460,1,0,86,0,-86
1461,1,1,341,1282,941
1462,1,1,660,1431,771
1463,1,0,72,0,-72
1464,1,0,12,0,-12
1465,0,0,8,0,-8
1466,1,0,65,0,-65
1467,0,0,77,0,-77
1468,1,0,177,0,-177
1469,0,0,7,0,-7
1470,0,0,4,0,-4
1471,0,0,54,0,-54
1472,1,0,16,0,-16
1473,0,0,80,0,-80
1474,1,0,58,0,-58
1475,1,1,797,1297,500
1476,0,0,33,0,-33
1477,0,0,12,0,-12
1478,0,0,28,0,-28
1479,1,1,149,1628,1479
1480,1,0,11,0,-11
1481,0,0,29,0,-29
1482,0,0,7,0,-7
1483,1,1,280,1660,1380
1484,1,0,40,0,-40
1485,0,0,10,0,-10
1486,0,0,32,0,-32
1487,1,1,196,1660,1464
1488,1,1,775,1634,859
1489,1,0,102,0,-102
1490,1,1,318,2858,2540
1491,1,1,262,1254,992
1492,1,1,412,1878,1466
1493,0,0,18,0,-18
1494,0,0,181,0,-181
1495,0,0,7,0,-7
1496,1,0,65,0,-65
1497,0,0,10,0,-10
1498,1,0,10,0,-10
1499,0,0,58,0,-58
1500,1,1,909,1369,460
1501,1,1,1086,1508,422
1502,1,1,262,1411,1149
1503,1,0,68,0,-68
1504,1,1,271,2028,1757
1505,0,0,45,0,-45
1506,1,0,102,0,-102
1507,1,0,118,0,-118
1508,1,0,40,0,-40
1509,1,0,131,0,-131
1510,1,1,218,1356,1138
1511,0,0,53,0,-53
1512,0,0,4,0,-4
1513,1,0,5,0,-5
1514,1,1,705,1621,916
1515,1,0,66,0,-66
1516,0,0,12,0,-12
1517,1,0,112,0,-112
1518,1,1,578,1258,680
1519,0,0,3,0,-3
1520,1,1,658,1421,763
1521,0,0,30,0,-30
1522,0,0,5,0,-5
1523,1,1,144,1499,1355
1524,1,1,392,1383,991
1525,1,1,917,1703,786
1526,1,1,150,1239,1089
1527,0,0,27,0,-27
1528,0,0,97,0,-97
1529,0,0,15,0,-15
1530,1,0,1,0,-1
1531,0,0,73,0,-73
1532,1,0,43,0,-43
1533,1,0,74,0,-74
1534,1,1,424,4247,3823
1535,1,1,92,1943,1851
1536,1,1,311,1524,1213
1537,1,1,113,1247,1134
1538,1,1,285,1694,1409
1539,0,0,48,0,-48
1540,1,1,368,1240,872
1541,1,0,16,0,-16
1542,1,1,587,1719,1132
1543,1,1,209,1377,1168
1544,1,0,48,0,-48
1545,1,0,33,0,-33
1546,1,0,45,0,-45
1547,1,0,58,0,-58
1548,1,0,41,0,-41
1549,0,0,14,0,-14
1550,0,0,135,0,-135
1551,0,0,18,0,-18
1552,1,0,25,0,-25
1553,1,0,50,0,-50
1554,0,0,103,0,-103
1555,1,1,263,1244,981
1556,1,0,22,0,-22
1557,1,1,710,1288,578
1558,0,0,26,0,-26
1559,1,1,99,3268,3169
1560,0,0,52,0,-52
1561,0,0,29,0,-29
1562,1,1,695,1566,871
1563,1,1,95,1461,1366
1564,1,0,32,0,-32
1565,1,1,1504,1287,-217
1566,1,0,27,0,-27
1567,1,1,409,1968,1559
1568,0,0,49,0,-49
1569,0,0,148,0,-148
1570,1,0,0,0,0
1571,1,1,883,1242,359
1572,0,0,7,0,-7
1573,0,0,20,0,-20
1574,1,0,42,0,-42
1575,0,0,78,0,-78
1576,0,0,95,0,-95
1577,1,1,118,1571,1453
1578,0,0,50,0,-50
1579,1,1,703,1394,691
1580,1,0,23,0,-23
1581,1,0,36,0,-36
1582,0,0,11,0,-11
1583,1,0,51,0,-51
1584,1,0,126,0,-126
1585,0,0,2,0,-2
1586,1,1,853,2642,1789
1587,1,1,89,1270,1181
1588,0,0,19,0,-19
1589,1,1,728,2722,1994
1590,0,0,97,0,-97
1591,1,0,27,0,-27
1592,0,0,12,0,-12
1593,1,1,661,1659,998
1594,1,1,303,3133,2830
1595,1,1,366,1520,1154
1596,1,0,36,0,-36
1597,1,0,80,0,-80
1598,0,0,20,0,-20
1599,0,0,32,0,-32
1600,0,0,0,0,0
1601,1,1,324,1362,1038
1602,1,1,478,1323,845
1603,0,0,15,0,-15
1604,1,0,5,0,-5
1605,0,0,5,0,-5
1606,1,1,360,2135,1775
1607,1,0,3,0,-3
1608,1,0,23,0,-23
1609,1,0,41,0,-41
1610,1,0,1,0,-1
1611,1,1,801,1486,685
1612,0,0,37,0,-37
1613,1,1,95,1327,1232
1614,0,0,8,0,-8
1615,0,0,5,0,-5
1616,1,0,0,0,0
1617,0,0,54,0,-54
1618,0,0,18,0,-18
1619,1,1,1387,1466,79
1620,1,1,455,1719,1264
1621,1,0,45,0,-45
1622,1,0,18,0,-18
1623,1,1,172,1572,1400
1624,0,0,92,0,-92
1625,0,0,69,0,-69
1626,0,0,109,0,-109
1627,0,0,57,0,-57
1628,1,0,51,0,-51
1629,0,0,18,0,-18
1630,1,1,486,1500,1014
1631,0,0,27,0,-27
1632,0,0,26,0,-26
1633,0,0,36,0,-36
1634,1,0,54,0,-54
1635,0,0,95,0,-95
1636,0,0,77,0,-77
1637,0,0,31,0,-31
1638,1,1,149,1645,1496
1639,0,0,87,0,-87
1640,0,0,121,0,-121
1641,0,0,66,0,-66
1642,1,0,37,0,-37
1643,1,1,161,1281,1120
1644,1,1,855,1279,424
1645,0,0,43,0,-43
1646,1,1,139,1297,1158
1647,0,0,81,0,-81
1648,1,0,125,0,-125
1649,1,1,463,1422,959
1650,1,1,799,1936,1137
1651,0,0,114,0,-114
1652,0,0,21,0,-21
1653,1,1,223,1288,1065
1654,0,0,25,0,-25
1655,0,0,123,0,-123
1656,1,0,28,0,-28
1657,0,0,12,0,-12
1658,0,0,38,0,-38
1659,1,1,156,1951,1795
1660,1,0,29,0,-29
1661,1,1,2283,1598,-685
1662,0,0,26,0,-26
1663,0,0,33,0,-33
1664,0,0,130,0,-130
1665,0,0,156,0,-156
1666,1,1,414,2317,1903
1667,1,0,9,0,-9
1668,1,1,625,1321,696
1669,1,1,245,1560,1315
1670,0,0,4,0,-4
1671,1,1,196,1245,1049
1672,1,0,64,0,-64
1673,1,0,67,0,-67
1674,1,1,20,1854,1834
1675,0,0,105,0,-105
1676,1,0,220,0,-220
1677,1,1,42,1549,1507
1678,1,1,291,1393,1102
1679,0,0,98,0,-98
1680,1,0,25,0,-25
1681,0,0,16,0,-16
1682,0,0,85,0,-85
1683,1,0,18,0,-18
1684,0,0,118,0,-118
1685,0,0,81,0,-81
1686,1,0,55,0,-55
1687,1,0,35,0,-35
1688,1,0,65,0,-65
1689,1,0,13,0,-13
1690,1,0,23,0,-23
1691,1,1,472,1504,1032
1692,1,0,36,0,-36
1693,0,0,24,0,-24
1694,1,1,138,1448,1310
1695,0,0,189,0,-189
1696,1,1,353,2151,1798
1697,0,0,15,0,-15
1698,0,0,37,0,-37
1699,1,1,215,3244,3029
1700,0,0,66,0,-66
1701,0,0,19,0,-19
1702,1,0,84,0,-84
1703,1,1,753,1424,671
1704,1,1,872,1341,469
1705,1,0,101,0,-101
1706,0,0,53,0,-53
1707,1,0,41,0,-41
1708,0,0,21,0,-21
1709,0,0,11,0,-11
1710,1,0,9,0,-9
1711,0,0,5,0,-5
1712,1,0,43,0,-43
1713,1,0,9,0,-9
1714,1,1,1563,1590,27
1715,0,0,9,0,-9
1716,0,0,83,0,-83
1717,1,1,839,1297,458
1718,1,0,22,0,-22
1719,1,1,360,1479,1119
1720,0,0,68,0,-68
1721,1,0,9,0,-9
1722,0,0,9,0,-9
1723,1,1,685,1281,596
1724,0,0,194,0,-194
1725,1,0,131,0,-131
1726,0,0,4,0,-4
1727,0,0,7,0,-7
1728,0,0,7,0,-7
1729,1,0,92,0,-92
1730,1,1,103,1266,1163
1731,1,0,4,0,-4
1732,1,1,462,1355,893
1733,1,1,1152,2116,964
1734,1,0,40,0,-40
1735,1,0,5,0,-5
1736,0,0,5,0,-5
1737,1,0,44,0,-44
1738,1,1,425,1409,984
1739,0,0,29,0,-29
1740,1,0,36,0,-36
1741,0,0,111,0,-111
1742,1,0,28,0,-28
1743,0,0,13,0,-13
1744,1,1,138,2656,2518
1745,1,0,107,0,-107
1746,0,0,21,0,-21
1747,1,0,37,0,-37
1748,1,1,654,1343,689
1749,0,0,112,0,-112
1750,1,0,9,0,-9
1751,0,0,1,0,-1
1752,0,0,73,0,-73
1753,1,1,153,1756,1603
1754,1,0,49,0,-49
1755,0,0,71,0,-71
1756,1,1,112,1681,1569
1757,1,0,57,0,-57
1758,1,1,1558,1326,-232
1759,0,0,3,0,-3
1760,1,1,725,1677,952
1761,1,0,73,0,-73
1762,0,0,31,0,-31
1763,1,0,56,0,-56
1764,0,0,49,0,-49
1765,0,0,25,0,-25
1766,1,1,516,3121,2605
1767,1,1,381,1275,894
1768,0,0,67,0,-67
1769,0,0,27,0,-27
1770,1,1,45,2029,1984
1771,1,0,41,0,-41
1772,1,0,89,0,-89
1773,0,0,199,0,-199
1774,1,0,43,0,-43
1775,1,1,659,1493,834
1776,0,0,31,0,-31
1777,1,0,28,0,-28
1778,1,1,174,1601,1427
1779,1,0,4,0,-4
1780,1,0,28,0,-28
1781,1,1,144,1663,1519
1782,1,0,35,0,-35
1783,0,0,156,0,-156
1784,0,0,21,0,-21
1785,1,1,99,2009,1910
1786,0,0,6,0,-6
1787,0,0,23,0,-23
1788,1,0,84,0,-84
1789,1,0,42,0,-42
1790,1,1,121,2094,1973
1791,1,0,11,0,-11
1792,1,0,0,0,0
1793,1,0,65,0,-65
1794,1,1,291,1403,1112
1795,1,1,637,1580,943
1796,1,1,400,1554,1154
1797,1,1,314,1258,944
1798,1,1,983,1830,847
1799,1,1,944,1315,371
1800,0,0,20,0,-20
1801,1,0,100,0,-100
1802,0,0,20,0,-20
1803,0,0,216,0,-216
1804,0,0,18,0,-18
1805,1,1,251,1900,1649
1806,1,1,340,1403,1063
1807,1,1,71,1305,1234
1808,1,0,86,0,-86
1809,1,1,682,1650,968
1810,1,1,272,1337,1065
1811,1,1,1646,1291,-355
1812,0,0,87,0,-87
1813,1,0,18,0,-18
1814,0,0,13,0,-13
1815,1,1,627,1919,1292
1816,1,1,805,1252,447
1817,1,1,822,2238,1416
1818,0,0,58,0,-58
1819,1,1,265,1376,1111
1820,1,1,111,1440,1329
1821,0,0,136,0,-136
1822,1,0,18,0,-18
1823,0,0,101,0,-101
1824,0,0,52,0,-52
1825,0,0,185,0,-185
1826,1,0,14,0,-14
1827,0,0,24,0,-24
1828,1,1,424,1516,1092
1829,1,1,1051,1323,272
1830,0,0,30,0,-30
1831,1,0,69,0,-69
1832,0,0,28,0,-28
1833,0,0,88,0,-88
1834,0,0,24,0,-24
1835,1,1,133,1569,1436
1836,1,1,508,1401,893
1837,1,0,60,0,-60
1838,0,0,38,0,-38
1839,1,0,295,0,-295
1840,0,0,92,0,-92
1841,0,0,134,0,-134
1842,1,1,350,1279,929
1843,1,1,707,1446,739
1844,1,0,104,0,-104
1845,1,1,787,1608,821
1846,1,1,1333,3845,2512
1847,0,0,1,0,-1
1848,1,1,588,2836,2248
1849,1,0,28,0,-28
1850,0,0,17,0,-17
1851,1,0,95,0,-95
1852,1,1,645,1242,597
1853,0,0,57,0,-57
1854,1,0,78,0,-78
1855,1,1,659,2642,1983
1856,1,0,1,0,-1
1857,1,1,553,1453,900
1858,1,1,245,1330,1085
1859,1,0,104,0,-104
1860,1,0,24,0,-24
1861,1,0,103,0,-103
1862,0,0,24,0,-24
1863,1,0,43,0,-43
1864,1,0,95,0,-95
1865,0,0,87,0,-87
1866,1,1,865,1466,601
1867,1,1,381,1346,965
1868,0,0,56,0,-56
1869,0,0,51,0,-51
1870,1,1,913,1235,322
1871,1,1,215,1755,1540
1872,0,0,197,0,-197
1873,0,0,25,0,-25
1874,0,0,51,0,-51
1875,1,1,486,1297,811
1876,0,0,13,0,-13
1877,1,0,75,0,-75
1878,1,0,68,0,-68
1879,1,0,10,0,-10
1880,0,0,7,0,-7
1881,0,0,6,0,-6
1882,0,0,123,0,-123
1883,1,0,29,0,-29
1884,1,1,368,1864,1496
1885,1,1,471,1460,989
1886,1,0,0,0,0
1887,0,0,73,0,-73
1888,0,0,17,0,-17
1889,0,0,48,0,-48
1890,0,0,0,0,0
1891,1,0,41,0,-41
1892,0,0,43,0,-43
1893,1,1,1471,1622,151
1894,1,0,134,0,-134
1895,1,1,318,1282,964
1896,1,0,40,0,-40
1897,1,0,14,0,-14
1898,1,0,56,0,-56
1899,0,0,6,0,-6
1900,1,0,82,0,-82
1901,1,1,209,1393,1184
1902,1,1,192,1403,1211
1903,0,0,27,0,-27
1904,1,0,42,0,-42
1905,0,0,47,0,-47
1906,1,1,540,2426,1886
1907,1,0,34,0,-34
1908,1,0,61,0,-61
1909,0,0,29,0,-29
1910,0,0,20,0,-20
1911,1,1,241,1334,1093
1912,1,0,87,0,-87
1913,1,0,35,0,-35
1914,0,0,41,0,-41
1915,0,0,8,0,-8
1916,1,0,16,0,-16
1917,1,1,570,1275,705
1918,1,0,31,0,-31
1919,1,0,72,0,-72
1920,1,0,1,0,-1
1921,0,0,44,0,-44
1922,0,0,48,0,-48
1923,1,1,199,1558,1359
1924,1,1,205,1289,1084
1925,1,0,43,0,-43
1926,0,0,22,0,-22
1927,0,0,20,0,-20
1928,0,0,38,0,-38
1929,1,1,1161,2796,1635
1930,1,1,209,1262,1053
1931,0,0,48,0,-48
1932,1,1,893,1455,562
1933,1,0,96,0,-96
1934,1,0,10,0,-10
1935,1,0,40,0,-40
1936,1,1,289,1454,1165
1937,0,0,38,0,-38
1938,0,0,53,0,-53
1939,1,1,871,1524,653
1940,0,0,43,0,-43
1941,0,0,99,0,-99
1942,1,0,25,0,-25
1943,1,0,42,0,-42
1944,0,0,19,0,-19
1945,1,0,34,0,-34
1946,1,0,29,0,-29
1947,0,0,90,0,-90
1948,1,0,13,0,-13
1949,1,1,527,1706,1179
1950,0,0,8,0,-8
1951,1,0,115,0,-115
1952,1,0,31,0,-31
1953,1,0,16,0,-16
1954,1,1,551,1419,868
1955,1,1,685,1934,1249
1956,0,0,49,0,-49
1957,1,1,31,1283,1252
1958,1,1,387,1741,1354
1959,0,0,57,0,-57
1960,1,0,35,0,-35
1961,0,0,1,0,-1
1962,1,1,418,1559,1141
1963,0,0,40,0,-40
1964,0,0,19,0,-19
1965,0,0,21,0,-21
1966,0,0,17,0,-17
1967,1,0,35,0,-35
1968,0,0,119,0,-119
1969,0,0,38,0,-38
1970,0,0,42,0,-42
1971,0,0,55,0,-55
1972,0,0,4,0,-4
1973,1,0,4,0,-4
1974,1,1,498,1272,774
1975,0,0,26,0,-26
1976,1,0,14,0,-14
1977,1,0,75,0,-75
1978,0,0,145,0,-145
1979,0,0,10,0,-10
1980,1,1,729,2624,1895
1981,1,0,37,0,-37
1982,0,0,20,0,-20
1983,1,0,26,0,-26
1984,0,0,24,0,-24
1985,1,0,21,0,-21
1986,1,1,1353,1306,-47
1987,0,0,109,0,-109
1988,1,1,632,2012,1380
1989,1,1,136,1461,1325
1990,0,0,63,0,-63
1991,0,0,28,0,-28
1992,1,0,29,0,-29
1993,1,0,72,0,-72
1994,0,0,9,0,-9
1995,1,1,988,1304,316
1996,1,0,19,0,-19
1997,1,0,53,0,-53
1998,0,0,26,0,-26
1999,1,0,126,0,-126
2000,1,1,261,1575,1314
2001,1,0,20,0,-20
2002,1,0,167,0,-167
2003,0,0,21,0,-21
2004,0,0,13,0,-13
2005,1,1,394,2101,1707
2006,0,0,21,0,-21
2007,1,0,12,0,-12
2008,1,1,893,1481,588
2009,0,0,87,0,-87
2010,0,0,71,0,-71
2011,0,0,217,0,-217
2012,1,0,65,0,-65
2013,1,1,540,1588,1048
2014,1,1,189,1326,1137
2015,1,0,6,0,-6
2016,1,1,734,1377,643
2017,1,0,21,0,-21
2018,1,1,133,1832,1699
2019,1,0,1,0,-1
2020,1,1,70,1289,1219
2021,0,0,13,0,-13
2022,0,0,24,0,-24
2023,1,1,419,1559,1140
2024,0,0,79,0,-79
2025,1,0,4,0,-4
2026,1,0,92,0,-92
2027,1,0,142,0,-142
2028,1,0,59,0,-59
2029,0,0,23,0,-23
2030,1,1,545,1409,864
2031,1,1,311,1724,1413
2032,1,1,1054,1593,539
2033,1,1,156,1691,1535
2034,1,1,84,1616,1532
2035,0,0,35,0,-35
2036,0,0,13,0,-13
2037,1,1,36,1581,1545
2038,0,0,20,0,-20
2039,1,1,804,1269,465
2040,0,0,9,0,-9
2041,0,0,45,0,-45
2042,1,1,430,1359,929
2043,1,0,194,0,-194
2044,0,0,8,0,-8
2045,1,1,570,1275,705
2046,0,0,26,0,-26
2047,1,1,242,1380,1138
2048,1,1,141,1259,1118
2049,0,0,12,0,-12
2050,0,0,15,0,-15
2051,1,0,16,0,-16
2052,1,1,888,1637,749
2053,1,1,368,1422,1054
2054,0,0,3,0,-3
2055,1,1,513,3332,2819
2056,0,0,19,0,-19
2057,1,0,217,0,-217
2058,0,0,165,0,-165
2059,0,0,30,0,-30
2060,1,0,99,0,-99
2061,1,0,124,0,-124
2062,0,0,66,0,-66
2063,0,0,10,0,-10
2064,1,1,422,1333,911
2065,1,0,26,0,-26
2066,1,1,1138,1254,116
2067,1,0,34,0,-34
2068,1,0,103,0,-103
2069,0,0,121,0,-121
2070,0,0,130,0,-130
2071,1,0,28,0,-28
2072,1,1,1850,2163,313
2073,1,1,174,1357,1183
2074,0,0,93,0,-93
2075,0,0,4,0,-4
2076,0,0,35,0,-35
2077,1,0,77,0,-77
2078,1,1,612,1806,1194
2079,1,0,125,0,-125
2080,0,0,6,0,-6
2081,1,1,702,1573,871
2082,0,0,34,0,-34
2083,0,0,1,0,-1
2084,1,1,416,1272,856
2085,1,1,496,1340,844
2086,0,0,19,0,-19
2087,1,0,66,0,-66
2088,1,0,75,0,-75
2089,1,0,6,0,-6
2090,1,1,656,1446,790
2091,1,1,435,1308,873
2092,0,0,55,0,-55
2093,1,1,544,1324,780
2094,1,1,192,1349,1157
2095,1,0,43,0,-43
2096,1,0,1,0,-1
2097,1,1,817,4369,3552
2098,1,0,14,0,-14
2099,1,1,300,2000,1700
2100,1,0,221,0,-221
2101,1,0,111,0,-111
2102,0,0,11,0,-11
2103,1,1,52,1352,1300
2104,0,0,89,0,-89
2105,0,0,42,0,-42
2106,1,0,8,0,-8
2107,1,0,67,0,-67
2108,0,0,21,0,-21
2109,0,0,26,0,-26
2110,1,0,54,0,-54
2111,1,1,190,1255,1065
2112,1,1,348,1318,970
2113,1,1,641,1262,621
2114,0,0,54,0,-54
2115,0,0,137,0,-137
2116,0,0,1,0,-1
2117,1,1,164,1446,1282
2118,0,0,31,0,-31
2119,1,1,649,1675,1026
2120,0,0,30,0,-30
2121,1,0,14,0,-14
2122,0,0,75,0,-75
2123,0,0,99,0,-99
2124,1,1,82,1412,1330
2125,1,1,780,1303,523
2126,1,0,1,0,-1
2127,0,0,123,0,-123
2128,0,0,9,0,-9
2129,1,0,1,0,-1
2130,0,0,4,0,-4
2131,0,0,15,0,-15
2132,1,0,26,0,-26
2133,0,0,14,0,-14
2134,1,1,70,1250,1180
2135,0,0,39,0,-39
2136,1,0,30,0,-30
2137,0,0,39,0,-39
2138,1,0,78,0,-78
2139,0,0,52,0,-52
2140,1,0,99,0,-99
2141,0,0,1,0,-1
2142,0,0,4,0,-4
2143,1,0,10,0,-10
2144,1,1,1087,1550,463
2145,0,0,179,0,-179
2146,1,1,171,1757,1586
2147,1,0,24,0,-24
2148,0,0,33,0,-33
2149,1,0,178,0,-178
2150,1,0,55,0,-55
2151,1,0,6,0,-6
2152,0,0,4,0,-4
2153,0,0,14,0,-14
2154,0,0,5,0,-5
2155,0,0,78,0,-78
2156,1,1,557,2041,1484
2157,1,0,6,0,-6
2158,0,0,7,0,-7
2159,1,1,340,1461,1121
2160,1,0,26,0,-26
2161,0,0,27,0,-27
2162,1,1,144,1292,1148
2163,0,0,51,0,-51
2164,1,0,75,0,-75
2165,0,0,27,0,-27
2166,1,1,530,1551,1021
2167,0,0,46,0,-46
2168,0,0,64,0,-64
2169,1,0,17,0,-17
2170,1,0,13,0,-13
2171,1,1,680,1620,940
2172,0,0,54,0,-54
2173,1,1,360,1286,926
2174,1,1,698,1421,723
2175,1,1,459,1241,782
2176,1,0,6,0,-6
2177,0,0,103,0,-103
2178,0,0,55,0,-55
2179,1,1,388,1462,1074
2180,0,0,42,0,-42
2181,0,0,6,0,-6
2182,1,0,58,0,-58
2183,1,0,71,0,-71
2184,0,0,0,0,0
2185,1,0,4,0,-4
2186,0,0,70,0,-70
2187,1,1,48,1242,1194
2188,0,0,69,0,-69
2189,1,0,98,0,-98
2190,1,1,2040,1369,-671
2191,1,1,306,2133,1827
2192,0,0,66,0,-66
2193,0,0,21,0,-21
2194,0,0,4,0,-4
2195,1,0,47,0,-47
2196,0,0,48,0,-48
2197,1,1,85,1249,1164
2198,1,0,16,0,-16
2199,1,1,12,1472,1460
2200,0,0,41,0,-41
2201,1,1,733,1309,576
2202,1,0,23,0,-23
2203,1,0,1,0,-1
2204,1,1,84,1241,1157
2205,1,1,210,1409,1199
2206,0,0,3,0,-3
2207,0,0,47,0,-47
2208,0,0,182,0,-182
2209,0,0,10,0,-10
2210,1,1,56,1278,1222
2211,0,0,5,0,-5
2212,0,0,7,0,-7
2213,0,0,19,0,-19
2214,0,0,11,0,-11
2215,1,0,21,0,-21
2216,1,0,141,0,-141
2217,1,1,144,1566,1422
2218,0,0,82,0,-82
2219,1,1,1285,1532,247
2220,0,0,8,0,-8
2221,0,0,50,0,-50
2222,1,1,568,2439,1871
2223,1,1,873,1457,584
2224,1,0,4,0,-4
2225,0,0,38,0,-38
2226,0,0,40,0,-40
2227,0,0,18,0,-18
2228,0,0,21,0,-21
2229,0,0,13,0,-13
2230,1,0,51,0,-51
2231,1,1,790,1332,542
2232,1,0,75,0,-75
2233,1,1,510,1259,749
2234,0,0,29,0,-29
2235,1,0,13,0,-13
2236,1,1,353,1563,1210
2237,1,1,109,2657,2548
2238,1,1,2204,1298,-906
2239,1,0,73,0,-73
2240,1,1,328,1415,1087
2241,1,0,133,0,-133
2242,1,0,3,0,-3
2243,1,0,107,0,-107
2244,0,0,1,0,-1
2245,1,1,464,1324,860
2246,0,0,14,0,-14
2247,1,0,25,0,-25
2248,0,0,93,0,-93
2249,1,1,262,1619,1357
2250,1,1,363,2308,1945
2251,0,0,31,0,-31
2252,0,0,20,0,-20
2253,1,1,322,1319,997
2254,0,0,24,0,-24
2255,0,0,4,0,-4
2256,1,0,104,0,-104
2257,1,1,324,2210,1886
2258,1,1,209,1262,1053
2259,1,0,10,0,-10
2260,1,0,55,0,-55
2261,1,0,42,0,-42
2262,1,0,39,0,-39
2263,1,0,12,0,-12
2264,0,0,100,0,-100
2265,0,0,88,0,-88
2266,1,1,575,1570,995
2267,1,1,297,1408,1111
2268,0,0,12,0,-12
2269,1,0,48,0,-48
2270,1,1,1074,1555,481
2271,1,1,1390,1258,-132
2272,1,0,51,0,-51
2273,1,0,130,0,-130
2274,0,0,39,0,-39
2275,1,1,351,2492,2141
2276,1,1,464,1308,844
2277,0,0,25,0,-25
2278,1,1,1999,1364,-635
2279,0,0,5,0,-5
2280,0,0,84,0,-84
2281,1,0,8,0,-8
2282,1,0,42,0,-42
2283,1,1,348,1800,1452
2284,1,1,308,1288,980
2285,1,1,267,1446,1179
2286,1,1,267,1474,1207
2287,1,0,34,0,-34
2288,0,0,43,0,-43
2289,1,1,601,2150,1549
2290,0,0,46,0,-46
2291,0,0,16,0,-16
2292,0,0,185,0,-185
2293,1,1,394,1443,1049
2294,1,1,114,1385,1271
2295,1,1,277,1266,989
2296,0,0,20,0,-20
2297,0,0,37,0,-37
2298,1,0,20,0,-20
2299,0,0,22,0,-22
2300,1,1,1131,1361,230
2301,1,1,524,1376,852
2302,1,1,349,1297,948
2303,1,1,2044,1289,-755
2304,0,0,21,0,-21
2305,0,0,6,0,-6
2306,0,0,233,0,-233
2307,1,1,500,1273,773
2308,1,0,202,0,-202
2309,0,0,29,0,-29
2310,0,0,6,0,-6
2311,0,0,40,0,-40
2312,0,0,27,0,-27
2313,0,0,137,0,-137
2314,0,0,89,0,-89
2315,1,0,283,0,-283
2316,1,1,1322,1411,89
2317,1,1,90,1685,1595
2318,0,0,3,0,-3
2319,1,0,15,0,-15
2320,0,0,46,0,-46
2321,1,0,50,0,-50
2322,1,0,133,0,-133
2323,1,1,688,1638,950
2324,1,1,819,1331,512
2325,1,0,5,0,-5
2326,0,0,62,0,-62
2327,1,0,101,0,-101
2328,1,0,16,0,-16
2329,0,0,4,0,-4
2330,1,1,387,1296,909
2331,0,0,45,0,-45
2332,1,1,325,1626,1301
2333,0,0,69,0,-69
2334,0,0,26,0,-26
2335,1,0,85,0,-85
2336,0,0,13,0,-13
2337,1,0,49,0,-49
2338,1,1,75,1645,1570
2339,0,0,76,0,-76
2340,1,0,28,0,-28
2341,0,0,25,0,-25
2342,0,0,35,0,-35
2343,0,0,56,0,-56
2344,0,0,20,0,-20
2345,1,1,312,1633,1321
2346,1,0,72,0,-72
2347,0,0,99,0,-99
2348,0,0,74,0,-74
2349,0,0,15,0,-15
2350,1,1,740,1833,1093
2351,0,0,114,0,-114
2352,1,0,21,0,-21
2353,0,0,52,0,-52
2354,0,0,70,0,-70
2355,1,0,4,0,-4
2356,0,0,144,0,-144
2357,1,0,85,0,-85
2358,0,0,80,0,-80
2359,0,0,12,0,-12
2360,1,1,1805,1503,-302
2361,1,1,2009,1271,-738
2362,0,0,58,0,-58
2363,1,0,0,0,0
2364,1,1,397,1331,934
2365,1,1,138,2123,1985
2366,1,0,66,0,-66
2367,0,0,42,0,-42
2368,1,0,83,0,-83
2369,1,1,1025,1616,591
2370,1,1,391,2369,1978
2371,1,0,18,0,-18
2372,1,1,463,1424,961
2373,1,0,5,0,-5
2374,1,1,173,1410,1237
2375,1,0,21,0,-21
2376,1,1,27,1445,1418
2377,1,0,75,0,-75
2378,0,0,53,0,-53
2379,1,1,1059,1391,332
2380,1,0,4,0,-4
2381,0,0,1,0,-1
2382,1,0,26,0,-26
2383,1,1,95,1287,1192
2384,1,1,1528,1679,151
2385,1,0,0,0,0
2386,1,1,379,1386,1007
2387,1,1,318,1364,1046
2388,0,0,21,0,-21
2389,0,0,17,0,-17
2390,1,0,39,0,-39
2391,1,0,17,0,-17
2392,1,0,165,0,-165
2393,1,0,55,0,-55
2394,0,0,73,0,-73
2395,1,1,232,1253,1021
2396,1,0,24,0,-24
2397,1,1,653,1339,686
2398,1,1,1090,1238,148
2399,1,1,168,1599,1431
2400,1,0,49,0,-49
2401,0,0,8,0,-8
2402,1,1,35,1274,1239
2403,0,0,23,0,-23
2404,1,0,49,0,-49
2405,0,0,129,0,-129
2406,0,0,28,0,-28
2407,1,1,759,2296,1537
2408,1,0,224,0,-224
2409,0,0,49,0,-49
2410,1,0,34,0,-34
2411,1,1,867,1239,372
2412,0,0,111,0,-111
2413,1,0,38,0,-38
2414,1,1,716,1529,813
2415,0,0,5,0,-5
2416,1,0,10,0,-10
2417,0,0,112,0,-112
2418,1,1,33,1337,1304
2419,1,0,20,0,-20
2420,1,1,468,1725,1257
2421,1,0,57,0,-57
2422,0,0,21,0,-21
2423,0,0,25,0,-25
2424,0,0,27,0,-27
2425,0,0,9,0,-9
2426,0,0,19,0,-19
2427,0,0,19,0,-19
2428,1,1,885,1287,402
2429,0,0,194,0,-194
2430,1,0,27,0,-27
2431,0,0,38,0,-38
2432,1,0,117,0,-117
2433,1,0,60,0,-60
2434,0,0,9,0,-9
2435,1,0,26,0,-26
2436,0,0,34,0,-34
2437,1,0,65,0,-65
2438,1,0,16,0,-16
2439,1,1,103,5934,5831
2440,0,0,24,0,-24
2441,0,0,72,0,-72
2442,1,0,216,0,-216
2443,0,0,36,0,-36
2444,1,1,456,1353,897
2445,1,1,1020,1242,222
2446,1,0,55,0,-55
2447,1,1,1136,1986,850
2448,0,0,106,0,-106
2449,1,1,97,2218,2121
2450,1,0,38,0,-38
2451,1,1,113,4647,4534
2452,1,1,47,1642,1595
2453,1,1,918,1285,367
2454,1,1,529,1274,745
2455,0,0,56,0,-56
2456,1,1,1298,1956,658
2457,0,0,24,0,-24
2458,1,1,559,5469,4910
2459,0,0,139,0,-139
2460,0,0,84,0,-84
2461,1,1,315,1462,1147
2462,0,0,9,0,-9
2463,1,1,217,2123,1906
2464,1,0,65,0,-65
2465,1,1,351,1410,1059
2466,1,1,2199,1634,-565
2467,1,0,24,0,-24
2468,1,0,12,0,-12
2469,1,1,1449,1330,-119
2470,1,1,352,1557,1205
2471,1,0,1,0,-1
2472,1,0,33,0,-33
2473,0,0,5,0,-5
2474,1,1,455,1668,1213
2475,1,1,256,2694,2438
2476,1,0,14,0,-14
2477,1,1,44,1238,1194
2478,1,0,2,0,-2
2479,0,0,27,0,-27
2480,1,1,279,1312,1033
2481,0,0,112,0,-112
2482,1,1,59,1336,1277
2483,1,1,273,1852,1579
2484,1,1,349,1508,1159
2485,0,0,20,0,-20
2486,0,0,53,0,-53
2487,0,0,33,0,-33
2488,0,0,105,0,-105
2489,1,0,3,0,-3
2490,0,0,46,0,-46
2491,0,0,38,0,-38
2492,0,0,46,0,-46
2493,0,0,128,0,-128
2494,1,1,900,2091,1191
2495,1,1,384,3290,2906
2496,1,0,113,0,-113
2497,0,0,23,0,-23
2498,0,0,69,0,-69
2499,0,0,58,0,-58
2500,1,1,446,1704,1258
2501,1,0,186,0,-186
2502,0,0,12,0,-12
2503,1,1,286,1320,1034
2504,1,0,15,0,-15
2505,1,1,82,1356,1274
2506,1,0,41,0,-41
2507,0,0,10,0,-10
2508,1,0,18,0,-18
2509,1,0,11,0,-11
2510,1,1,36,2917,2881
2511,1,0,37,0,-37
2512,0,0,122,0,-122
2513,0,0,0,0,0
2514,1,0,23,0,-23
2515,1,0,30,0,-30
2516,0,0,37,0,-37
2517,0,0,4,0,-4
2518,1,1,357,2034,1677
2519,1,1,495,1422,927
2520,0,0,50,0,-50
2521,0,0,62,0,-62
2522,1,1,1891,1353,-538
2523,1,0,30,0,-30
2524,1,1,286,1402,1116
2525,0,0,28,0,-28
2526,1,1,242,1380,1138
2527,0,0,68,0,-68
2528,1,1,164,1887,1723
2529,0,0,54,0,-54
2530,1,0,11,0,-11
2531,1,0,9,0,-9
2532,0,0,30,0,-30
2533,1,1,488,1337,849
2534,1,1,505,1331,826
2535,1,1,696,1278,582
2536,1,1,794,1796,1002
2537,1,0,7,0,-7
2538,0,0,150,0,-150
2539,0,0,36,0,-36
2540,0,0,5,0,-5
2541,1,0,53,0,-53
2542,1,0,16,0,-16
2543,1,0,10,0,-10
2544,1,0,57,0,-57
2545,1,1,161,2364,2203
2546,0,0,7,0,-7
2547,1,1,425,1445,1020
2548,1,1,518,1497,979
2549,1,0,37,0,-37
2550,0,0,5,0,-5
2551,1,1,400,1810,1410
2552,0,0,84,0,-84
2553,1,0,47,0,-47
2554,0,0,10,0,-10
2555,0,0,68,0,-68
2556,1,0,3,0,-3
2557,0,0,44,0,-44
2558,1,0,34,0,-34
2559,1,0,18,0,-18
2560,1,0,2,0,-2
2561,0,0,234,0,-234
2562,1,1,341,1874,1533
2563,1,0,35,0,-35
2564,0,0,44,0,-44
2565,0,0,18,0,-18
2566,1,1,840,1417,577
2567,1,0,250,0,-250
2568,1,1,251,3121,2870
2569,0,0,22,0,-22
2570,1,0,75,0,-75
2571,1,0,56,0,-56
2572,0,0,29,0,-29
2573,0,0,10,0,-10
2574,0,0,23,0,-23
2575,1,1,684,1704,1020
2576,1,1,536,1464,928
2577,1,1,2948,2064,-884
2578,1,1,603,1245,642
2579,1,1,148,1388,1240
2580,0,0,95,0,-95
2581,0,0,2,0,-2
2582,1,0,54,0,-54
2583,1,0,55,0,-55
2584,0,0,2,0,-2
2585,0,0,21,0,-21
2586,0,0,33,0,-33
2587,1,0,3,0,-3
2588,0,0,85,0,-85
2589,0,0,22,0,-22
2590,1,0,76,0,-76
2591,0,0,55,0,-55
2592,1,1,284,2145,1861
2593,1,1,362,1385,1023
2594,1,1,217,1348,1131
2595,0,0,23,0,-23
2596,1,1,847,1364,517
2597,1,1,944,1299,355
2598,1,0,116,0,-116
2599,1,1,485,2580,2095
2600,0,0,46,0,-46
2601,1,1,408,1368,960
2602,1,1,200,1322,1122
2603,1,0,73,0,-73
2604,0,0,77,0,-77
2605,1,1,17,1242,1225
2606,0,0,103,0,-103
2607,1,0,51,0,-51
2608,1,1,293,1249,956
2609,0,0,8,0,-8
2610,0,0,5,0,-5
2611,0,0,81,0,-81
2612,1,1,1100,1295,195
2613,1,1,175,2122,1947
2614,1,1,501,2133,1632
2615,1,0,36,0,-36
2616,0,0,70,0,-70
2617,1,0,41,0,-41
2618,0,0,163,0,-163
2619,0,0,122,0,-122
2620,1,1,154,1728,1574
2621,1,0,15,0,-15
2622,0,0,37,0,-37
2623,1,1,1807,1861,54
2624,1,0,2,0,-2
2625,1,0,32,0,-32
2626,1,1,251,1511,1260
2627,1,1,256,2011,1755
2628,0,0,46,0,-46
2629,1,1,375,1311,936
2630,1,1,678,1314,636
2631,0,0,98,0,-98
2632,0,0,59,0,-59
2633,1,0,22,0,-22
2634,1,0,5,0,-5
2635,1,0,31,0,-31
2636,1,0,8,0,-8
2637,1,0,77,0,-77
2638,1,0,24,0,-24
2639,1,1,213,1334,1121
2640,0,0,41,0,-41
2641,1,0,27,0,-27
2642,1,1,231,1392,1161
2643,1,0,130,0,-130
2644,1,0,61,0,-61
2645,1,1,395,1379,984
2646,0,0,25,0,-25
2647,1,0,21,0,-21
2648,1,0,1,0,-1
2649,1,1,258,1510,1252
2650,1,1,923,1539,616
2651,0,0,7,0,-7
2652,1,1,253,1280,1027
2653,0,0,125,0,-125
2654,1,0,26,0,-26
2655,0,0,18,0,-18
2656,0,0,35,0,-35
2657,0,0,108,0,-108
2658,1,0,12,0,-12
2659,0,0,205,0,-205
2660,1,0,27,0,-27
2661,0,0,4,0,-4
2662,1,0,81,0,-81
2663,1,0,108,0,-108
2664,0,0,21,0,-21
2665,1,0,12,0,-12
2666,0,0,33,0,-33
2667,1,1,3655,1683,-1972
2668,0,0,146,0,-146
2669,1,1,319,1280,961
2670,0,0,111,0,-111
2671,0,0,55,0,-55
2672,1,1,288,1278,990
2673,1,1,1164,1302,138
2674,0,0,4,0,-4
2675,1,1,1008,1362,354
2676,1,0,47,0,-47
2677,1,0,59,0,-59
2678,1,1,1310,1271,-39
2679,1,1,806,1299,493
2680,1,0,30,0,-30
2681,1,0,5,0,-5
2682,1,0,278,0,-278
2683,0,0,123,0,-123
2684,0,0,10,0,-10
2685,0,0,17,0,-17
2686,1,0,76,0,-76
2687,1,1,355,1897,1542
2688,1,0,1,0,-1
2689,0,0,141,0,-141
2690,0,0,69,0,-69
2691,0,0,24,0,-24
2692,0,0,7,0,-7
2693,0,0,19,0,-19
2694,1,1,855,1249,394
2695,1,0,40,0,-40
2696,1,0,18,0,-18
2697,0,0,39,0,-39
2698,0,0,47,0,-47
2699,0,0,40,0,-40
2700,1,0,41,0,-41
2701,0,0,26,0,-26
2702,1,0,1,0,-1
2703,1,1,120,1485,1365
2704,1,1,370,1880,1510
2705,1,0,0,0,0
2706,1,0,19,0,-19
2707,1,0,101,0,-101
2708,1,0,143,0,-143
2709,0,0,85,0,-85
2710,1,1,499,1490,991
2711,0,0,53,0,-53
2712,0,0,33,0,-33
2713,1,1,692,1286,594
2714,1,0,0,0,0
2715,1,1,2843,1389,-1454
2716,0,0,61,0,-61
2717,0,0,175,0,-175
2718,0,0,41,0,-41
2719,1,0,19,0,-19
2720,0,0,12,0,-12
2721,0,0,98,0,-98
2722,0,0,331,0,-331
2723,1,0,10,0,-10
2724,0,0,25,0,-25
2725,0,0,18,0,-18
2726,0,0,11,0,-11
2727,0,0,79,0,-79
2728,1,1,1376,2158,782
2729,0,0,115,0,-115
2730,0,0,0,0,0
2731,1,0,60,0,-60
2732,1,0,47,0,-47
2733,0,0,69,0,-69
2734,0,0,59,0,-59
2735,1,1,843,1937,1094
2736,0,0,22,0,-22
2737,0,0,26,0,-26
2738,1,1,335,1442,1107
2739,1,0,19,0,-19
2740,0,0,89,0,-89
2741,1,0,66,0,-66
2742,1,0,4,0,-4
2743,1,0,118,0,-118
2744,0,0,48,0,-48
2745,1,0,85,0,-85
2746,0,0,107,0,-107
2747,1,0,22,0,-22
2748,1,0,16,0,-16
2749,1,1,72,1561,1489
2750,0,0,19,0,-19
2751,1,1,216,1994,1778
2752,1,1,1428,1296,-132
2753,0,0,27,0,-27
2754,1,0,43,0,-43
2755,1,1,1236,1241,5
2756,1,0,101,0,-101
2757,0,0,55,0,-55
2758,1,0,51,0,-51
2759,0,0,82,0,-82
2760,1,0,43,0,-43
2761,1,0,31,0,-31
2762,0,0,52,0,-52
2763,0,0,16,0,-16
2764,1,0,24,0,-24
2765,0,0,37,0,-37
2766,1,1,345,1553,1208
2767,1,1,813,2559,1746
2768,0,0,7,0,-7
2769,0,0,13,0,-13
2770,0,0,61,0,-61
2771,1,1,566,1404,838
2772,1,0,19,0,-19
2773,0,0,137,0,-137
2774,1,0,27,0,-27
2775,1,1,503,1913,1410
2776,1,0,24,0,-24
2777,1,0,74,0,-74
2778,1,1,266,1575,1309
2779,1,1,275,1375,1100
2780,0,0,5,0,-5
2781,0,0,73,0,-73
2782,1,0,14,0,-14
2783,0,0,6,0,-6
2784,0,0,10,0,-10
2785,1,0,22,0,-22
2786,0,0,0,0,0
2787,1,0,19,0,-19
2788,0,0,25,0,-25
2789,0,0,28,0,-28
2790,0,0,13,0,-13
2791,1,0,11,0,-11
2792,0,0,80,0,-80
2793,1,1,542,1256,714
2794,0,0,97,0,-97
2795,0,0,0,0,0
2796,1,1,252,2406,2154
2797,1,1,344,1407,1063
2798,1,0,33,0,-33
2799,1,1,580,2121,1541
2800,1,0,50,0,-50
2801,1,1,431,1573,1142
2802,1,0,115,0,-115
2803,0,0,75,0,-75
2804,1,0,50,0,-50
2805,1,0,48,0,-48
2806,1,0,7,0,-7
2807,0,0,34,0,-34
2808,0,0,13,0,-13
2809,1,1,433,1647,1214
2810,1,1,27,1480,1453
2811,0,0,43,0,-43
2812,1,0,33,0,-33
2813,1,1,1586,3571,1985
2814,1,1,169,1409,1240
2815,0,0,1,0,-1
2816,1,0,36,0,-36
2817,1,1,122,1272,1150
2818,1,1,1532,1391,-141
2819,1,1,165,1416,1251
2820,0,0,139,0,-139
2821,1,1,439,1247,808
2822,0,0,66,0,-66
2823,1,0,38,0,-38
2824,0,0,11,0,-11
2825,0,0,74,0,-74
2826,0,0,39,0,-39
2827,1,1,929,1654,725
2828,1,0,53,0,-53
2829,1,0,20,0,-20
2830,1,0,62,0,-62
2831,1,1,549,1791,1242
2832,0,0,190,0,-190
2833,1,1,2737,1551,-1186
2834,0,0,24,0,-24
2835,1,0,47,0,-47
2836,0,0,31,0,-31
2837,1,1,1035,1296,261
2838,1,0,21,0,-21
2839,1,0,14,0,-14
2840,1,1,254,1926,1672
2841,0,0,1,0,-1
2842,0,0,19,0,-19
2843,1,1,184,2481,2297
2844,1,1,358,1292,934
2845,0,0,15,0,-15
2846,1,0,153,0,-153
2847,1,0,11,0,-11
2848,1,0,27,0,-27
2849,0,0,40,0,-40
2850,0,0,15,0,-15
2851,0,0,30,0,-30
2852,1,0,54,0,-54
2853,0,0,169,0,-169
2854,1,0,12,0,-12
2855,1,1,161,1585,1424
2856,1,0,4,0,-4
2857,1,1,593,1438,845
2858,1,1,1738,1457,-281
2859,1,1,71,1344,1273
2860,0,0,158,0,-158
2861,1,1,342,1824,1482
2862,1,1,199,1437,1238
2863,0,0,3,0,-3
2864,0,0,43,0,-43
2865,0,0,38,0,-38
2866,0,0,18,0,-18
2867,1,1,495,1368,873
2868,1,0,26,0,-26
2869,0,0,26,0,-26
2870,1,1,218,1334,1116
2871,1,1,780,1770,990
2872,1,1,622,1276,654
2873,1,0,52,0,-52
2874,1,1,497,1564,1067
2875,0,0,7,0,-7
2876,1,0,123,0,-123
2877,0,0,120,0,-120
2878,0,0,18,0,-18
2879,1,0,52,0,-52
2880,1,0,86,0,-86
2881,0,0,25,0,-25
2882,1,0,30,0,-30
2883,0,0,5,0,-5
2884,0,0,25,0,-25
2885,1,0,131,0,-131
2886,0,0,15,0,-15
2887,1,0,26,0,-26
2888,0,0,37,0,-37
2889,1,0,93,0,-93
2890,0,0,7,0,-7
2891,1,1,275,1460,1185
2892,0,0,6,0,-6
2893,0,0,60,0,-60
2894,1,0,40,0,-40
2895,0,0,66,0,-66
2896,0,0,15,0,-15
2897,1,0,66,0,-66
2898,0,0,22,0,-22
2899,0,0,107,0,-107
2900,1,1,598,1435,837
2901,1,0,85,0,-85
2902,0,0,65,0,-65
2903,0,0,2,0,-2
2904,0,0,18,0,-18
2905,0,0,40,0,-40
2906,1,1,1412,1860,448
2907,0,0,35,0,-35
2908,1,0,24,0,-24
2909,1,0,57,0,-57
2910,1,1,59,1345,1286
2911,0,0,47,0,-47
2912,0,0,58,0,-58
2913,1,1,287,2167,1880
2914,1,1,1392,1377,-15
2915,0,0,25,0,-25
2916,1,1,192,1372,1180
2917,1,0,48,0,-48
2918,1,1,148,1637,1489
2919,0,0,2,0,-2
2920,1,1,1095,1591,496
2921,1,0,81,0,-81
2922,1,0,20,0,-20
2923,1,1,252,1271,1019
2924,0,0,119,0,-119
2925,1,1,568,1308,740
2926,0,0,72,0,-72
2927,1,0,38,0,-38
2928,1,0,9,0,-9
2929,0,0,144,0,-144
2930,1,1,890,1240,350
2931,1,1,459,3342,2883
2932,0,0,115,0,-115
2933,1,1,753,1280,527
2934,1,0,34,0,-34
2935,1,1,606,1906,1300
2936,1,1,187,1368,1181
2937,1,1,1588,1719,131
2938,0,0,72,0,-72
2939,0,0,74,0,-74
2940,1,0,134,0,-134
2941,1,0,24,0,-24
2942,0,0,0,0,0
2943,1,0,137,0,-137
2944,1,1,344,1590,1246
2945,0,0,57,0,-57
2946,1,0,40,0,-40
2947,0,0,39,0,-39
2948,0,0,37,0,-37
2949,0,0,27,0,-27
2950,0,0,73,0,-73
2951,1,0,35,0,-35
2952,1,1,372,1711,1339
2953,0,0,100,0,-100
2954,1,0,7,0,-7
2955,1,0,53,0,-53
2956,1,1,385,1917,1532
2957,0,0,130,0,-130
2958,1,0,37,0,-37
2959,0,0,81,0,-81
2960,1,1,922,1261,339
2961,0,0,54,0,-54
2962,1,0,23,0,-23
2963,0,0,6,0,-6
2964,0,0,57,0,-57
2965,1,0,107,0,-107
2966,1,0,328,0,-328
2967,1,1,450,1947,1497
2968,1,1,421,1411,990
2969,0,0,157,0,-157
2970,0,0,29,0,-29
2971,1,0,62,0,-62
2972,0,0,2,0,-2
2973,1,0,33,0,-33
2974,1,1,417,1331,914
2975,1,1,213,1612,1399
2976,1,1,700,1311,611
2977,0,0,42,0,-42
2978,0,0,18,0,-18
2979,0,0,77,0,-77
2980,1,0,23,0,-23
2981,1,1,518,1312,794
2982,1,1,216,1250,1034
2983,1,0,9,0,-9
2984,0,0,87,0,-87
2985,1,1,2105,1251,-854
2986,0,0,36,0,-36
2987,1,0,127,0,-127
2988,1,1,1229,1412,183
2989,1,0,62,0,-62
2990,1,0,18,0,-18
2991,1,1,282,1330,1048
2992,0,0,109,0,-109
2993,1,0,3,0,-3
2994,1,0,159,0,-159
2995,1,0,8,0,-8
2996,0,0,54,0,-54
2997,1,0,31,0,-31
2998,0,0,189,0,-189
2999,1,0,41,0,-41
3000,1,0,4,0,-4
3001,0,0,25,0,-25
3002,1,0,8,0,-8
3003,0,0,131,0,-131
3004,1,1,395,1633,1238
3005,1,1,187,1383,1196
3006,1,1,154,1244,1090
3007,1,1,287,2194,1907
3008,0,0,48,0,-48
3009,0,0,21,0,-21
3010,0,0,52,0,-52
3011,1,0,19,0,-19
3012,0,0,29,0,-29
3013,1,0,24,0,-24
3014,1,1,115,2061,1946
3015,1,0,90,0,-90
3016,1,1,119,1489,1370
3017,0,0,7,0,-7
3018,1,0,40,0,-40
3019,1,0,60,0,-60
3020,1,0,0,0,0
3021,0,0,4,0,-4
3022,0,0,62,0,-62
3023,0,0,21,0,-21
3024,1,1,719,1667,948
3025,0,0,57,0,-57
3026,1,0,59,0,-59
3027,1,0,65,0,-65
3028,1,1,1005,1362,357
3029,0,0,127,0,-127
3030,0,0,26,0,-26
3031,1,1,244,1495,1251
3032,1,1,934,1490,556
3033,0,0,78,0,-78
3034,1,1,340,1630,1290
3035,1,1,79,1738,1659
3036,1,0,104,0,-104
3037,1,0,181,0,-181
3038,1,1,204,2084,1880
3039,1,1,161,1441,1280
3040,1,0,8,0,-8
3041,0,0,21,0,-21
3042,1,1,878,1299,421
3043,1,0,100,0,-100
3044,0,0,49,0,-49
3045,1,0,101,0,-101
3046,0,0,5,0,-5
3047,1,1,254,1363,1109
3048,1,0,85,0,-85
3049,1,0,68,0,-68
3050,1,0,5,0,-5
3051,0,0,97,0,-97
3052,0,0,99,0,-99
3053,1,1,122,1467,1345
3054,1,1,400,3040,2640
3055,0,0,126,0,-126
3056,0,0,22,0,-22
3057,0,0,50,0,-50
3058,1,0,41,0,-41
3059,1,1,250,2031,1781
3060,1,0,35,0,-35
3061,1,0,31,0,-31
3062,1,1,233,1400,1167
3063,1,0,92,0,-92
3064,0,0,16,0,-16
3065,1,0,57,0,-57
3066,0,0,17,0,-17
3067,1,0,102,0,-102
3068,0,0,4,0,-4
3069,0,0,22,0,-22
3070,1,1,151,1384,1233
3071,1,1,450,1333,883
3072,0,0,27,0,-27
3073,1,0,90,0,-90
3074,0,0,26,0,-26
3075,1,0,18,0,-18
3076,1,1,106,1265,1159
3077,0,0,110,0,-110
3078,1,1,1286,1253,-33
3079,1,0,6,0,-6
3080,0,0,17,0,-17
3081,1,0,49,0,-49
3082,1,0,2,0,-2
3083,1,0,1,0,-1
3084,0,0,50,0,-50
3085,1,0,49,0,-49
3086,0,0,37,0,-37
3087,1,1,1999,1517,-482
3088,1,1,481,1255,774
3089,0,0,15,0,-15
3090,0,0,45,0,-45
3091,0,0,51,0,-51
3092,1,1,440,2176,1736
3093,0,0,59,0,-59
3094,1,1,398,1473,1075
3095,0,0,236,0,-236
3096,1,1,324,1990,1666
3097,1,1,129,1373,1244
3098,0,0,14,0,-14
3099,1,1,798,1240,442
3100,1,0,75,0,-75
3101,1,0,40,0,-40
3102,1,1,342,1780,1438
3103,1,0,28,0,-28
3104,0,0,160,0,-160
3105,1,1,212,1353,1141
3106,0,0,124,0,-124
3107,1,0,5,0,-5
3108,1,1,190,1444,1254
3109,1,1,678,1257,579
3110,1,0,8,0,-8
3111,1,1,161,1348,1187
3112,1,0,5,0,-5
3113,1,0,52,0,-52
3114,0,0,56,0,-56
3115,1,1,596,1584,988
3116,0,0,2,0,-2
3117,1,1,175,2142,1967
3118,0,0,26,0,-26
3119,0,0,11,0,-11
3120,1,1,495,1253,758
3121,1,1,495,1875,1380
3122,1,0,7,0,-7
3123,1,1,2284,1433,-851
3124,1,1,408,1528,1120
3125,0,0,12,0,-12
3126,0,0,1,0,-1
3127,1,0,3,0,-3
3128,0,0,17,0,-17
3129,1,1,291,1716,1425
3130,1,0,30,0,-30
3131,1,1,246,1967,1721
3132,1,1,44,1680,1636
3133,0,0,144,0,-144
3134,0,0,5,0,-5
3135,1,1,973,1410,437
3136,1,0,42,0,-42
3137,1,1,213,1292,1079
3138,1,0,252,0,-252
3139,1,0,36,0,-36
3140,1,0,272,0,-272
3141,0,0,41,0,-41
3142,1,1,279,1948,1669
3143,1,0,10,0,-10
3144,1,0,117,0,-117
3145,1,1,150,2520,2370
3146,1,1,316,1434,1118
3147,1,1,131,1435,1304
3148,1,0,101,0,-101
3149,1,1,235,1372,1137
3150,0,0,40,0,-40
3151,1,1,767,1426,659
3152,0,0,32,0,-32
3153,1,1,594,2255,1661
3154,0,0,55,0,-55
3155,1,0,58,0,-58
3156,0,0,40,0,-40
3157,1,0,15,0,-15
3158,0,0,16,0,-16
3159,0,0,117,0,-117
3160,0,0,36,0,-36
3161,1,1,1168,2069,901
3162,1,1,170,1329,1159
3163,1,1,133,1422,1289
3164,1,1,180,2569,2389
3165,0,0,34,0,-34
3166,0,0,7,0,-7
3167,1,1,323,1283,960
3168,0,0,32,0,-32
3169,0,0,43,0,-43
3170,1,0,13,0,-13
3171,0,0,142,0,-142
3172,1,1,669,1519,850
3173,0,0,12,0,-12
3174,0,0,72,0,-72
3175,1,1,425,2127,1702
3176,1,1,156,1422,1266
3177,0,0,118,0,-118
3178,1,1,1185,1323,138
3179,1,0,86,0,-86
3180,1,0,63,0,-63
3181,0,0,87,0,-87
3182,1,0,5,0,-5
3183,1,1,785,2578,1793
3184,1,0,89,0,-89
3185,1,1,599,1387,788
3186,1,0,11,0,-11
3187,0,0,40,0,-40
3188,1,0,18,0,-18
3189,1,1,742,2501,1759
3190,0,0,96,0,-96
3191,1,1,424,1277,853
3192,0,0,131,0,-131
3193,1,0,7,0,-7
3194,0,0,21,0,-21
3195,0,0,65,0,-65
3196,0,0,47,0,-47
3197,0,0,67,0,-67
3198,0,0,8,0,-8
3199,1,0,92,0,-92
3200,0,0,73,0,-73
3201,0,0,18,0,-18
3202,0,0,206,0,-206
3203,0,0,90,0,-90
3204,1,1,143,1485,1342
3205,1,0,29,0,-29
3206,1,0,7,0,-7
3207,1,0,41,0,-41
3208,1,0,33,0,-33
3209,1,1,760,1343,583
3210,1,1,1042,4006,2964
3211,1,1,1893,1530,-363
3212,0,0,1,0,-1
3213,1,1,679,1362,683
3214,0,0,3,0,-3
3215,0,0,66,0,-66
3216,0,0,29,0,-29
3217,1,1,491,1571,1080
3218,1,0,10,0,-10
3219,1,1,257,2781,2524
3220,0,0,44,0,-44
3221,0,0,19,0,-19
3222,1,0,37,0,-37
3223,1,1,1037,1584,547
3224,1,1,659,1374,715
3225,1,1,255,1250,995
3226,1,1,314,1910,1596
3227,0,0,28,0,-28
3228,1,0,27,0,-27
3229,1,1,1081,1868,787
3230,1,0,72,0,-72
3231,1,0,151,0,-151
3232,1,1,136,1925,1789
3233,0,0,41,0,-41
3234,0,0,107,0,-107
3235,1,0,31,0,-31
3236,1,1,90,1751,1661
3237,0,0,37,0,-37
3238,0,0,164,0,-164
3239,1,1,233,1669,1436
3240,1,1,2495,1520,-975
3241,1,1,1306,1882,576
3242,1,0,23,0,-23
3243,0,0,19,0,-19
3244,0,0,93,0,-93
3245,1,1,529,2326,1797
3246,1,0,160,0,-160
3247,0,0,66,0,-66
3248,1,0,146,0,-146
3249,1,0,27,0,-27
3250,1,1,270,1281,1011
3251,0,0,14,0,-14
3252,1,1,259,1570,1311
3253,0,0,115,0,-115
3254,1,1,721,1508,787
3255,1,0,41,0,-41
3256,1,1,97,1273,1176
3257,1,0,9,0,-9
3258,0,0,42,0,-42
3259,0,0,105,0,-105
3260,0,0,1,0,-1
3261,1,0,0,0,0
3262,1,0,1,0,-1
3263,1,0,24,0,-24
3264,1,0,39,0,-39
3265,0,0,10,0,-10
3266,1,1,718,1396,678
3267,1,0,7,0,-7
3268,1,1,466,1591,1125
3269,0,0,27,0,-27
3270,0,0,102,0,-102
3271,0,0,6,0,-6
3272,1,1,230,1414,1184
3273,1,0,0,0,0
3274,0,0,90,0,-90
3275,1,0,82,0,-82
3276,1,1,162,1430,1268
3277,1,0,47,0,-47
3278,1,1,146,2350,2204
3279,1,0,116,0,-116
3280,1,1,1023,2318,1295
3281,1,0,12,0,-12
3282,1,0,13,0,-13
3283,1,0,0,0,0
3284,0,0,58,0,-58
3285,1,0,40,0,-40
3286,0,0,117,0,-117
3287,0,0,5,0,-5
3288,0,0,2,0,-2
3289,1,0,47,0,-47
3290,1,0,51,0,-51
3291,1,1,902,1246,344
3292,1,0,26,0,-26
3293,0,0,46,0,-46
3294,1,0,63,0,-63
3295,1,1,1269,1599,330
3296,1,0,74,0,-74
3297,0,0,37,0,-37
3298,1,0,13,0,-13
3299,0,0,20,0,-20
3300,0,0,29,0,-29
3301,1,0,13,0,-13
3302,1,0,13,0,-13
3303,0,0,52,0,-52
3304,1,0,148,0,-148
3305,1,1,364,1713,1349
3306,1,1,822,1404,582
3307,0,0,35,0,-35
3308,1,1,441,1473,1032
3309,0,0,42,0,-42
3310,1,1,210,1362,1152
3311,0,0,53,0,-53
3312,0,0,48,0,-48
3313,1,0,94,0,-94
3314,0,0,28,0,-28
3315,1,1,1180,2669,1489
3316,1,0,12,0,-12
3317,1,1,1191,1435,244
3318,1,1,327,1476,1149
3319,0,0,41,0,-41
3320,1,1,761,1819,1058
3321,1,0,26,0,-26
3322,1,0,40,0,-40
3323,1,1,387,1577,1190
3324,1,1,555,1411,856
3325,0,0,57,0,-57
3326,1,1,337,1699,1362
3327,1,1,169,1527,1358
3328,1,0,11,0,-11
3329,1,1,752,1411,659
3330,0,0,35,0,-35
3331,0,0,43,0,-43
3332,1,0,43,0,-43
3333,1,0,32,0,-32
3334,0,0,40,0,-40
3335,0,0,98,0,-98
3336,1,1,2157,1615,-542
3337,0,0,79,0,-79
3338,1,1,202,1440,1238
3339,0,0,35,0,-35
3340,1,1,909,1301,392
3341,1,0,4,0,-4
3342,1,0,47,0,-47
3343,0,0,66,0,-66
3344,0,0,34,0,-34
3345,1,0,64,0,-64
3346,1,0,75,0,-75
3347,1,0,2,0,-2
3348,0,0,34,0,-34
3349,1,0,10,0,-10
3350,1,1,371,1823,1452
3351,1,1,202,1247,1045
3352,1,0,67,0,-67
3353,0,0,163,0,-163
3354,0,0,22,0,-22
3355,1,1,36,1253,1217
3356,1,1,569,1250,681
3357,1,1,935,1436,501
3358,1,0,58,0,-58
3359,0,0,165,0,-165
3360,0,0,19,0,-19
3361,0,0,37,0,-37
3362,1,1,290,1318,1028
3363,0,0,13,0,-13
3364,1,0,14,0,-14
3365,1,1,109,1692,1583
3366,0,0,143,0,-143
3367,1,1,159,2221,2062
3368,1,1,736,1520,784
3369,1,0,71,0,-71
3370,0,0,25,0,-25
3371,1,1,196,1394,1198
3372,1,0,13,0,-13
3373,0,0,6,0,-6
3374,1,1,419,1814,1395
3375,0,0,5,0,-5
3376,0,0,27,0,-27
3377,1,0,52,0,-52
3378,1,0,34,0,-34
3379,0,0,38,0,-38
3380,1,1,515,1277,762
3381,0,0,5,0,-5
3382,0,0,21,0,-21
3383,0,0,34,0,-34
3384,1,0,35,0,-35
3385,1,1,146,1432,1286
3386,1,0,78,0,-78
3387,1,0,23,0,-23
3388,1,0,42,0,-42
3389,1,1,515,1560,1045
3390,1,0,26,0,-26
3391,1,1,148,1365,1217
3392,1,1,1707,1262,-445
3393,1,0,1,0,-1
3394,0,0,59,0,-59
3395,1,1,610,1803,1193
3396,1,1,1450,3438,1988
3397,0,0,75,0,-75
3398,0,0,21,0,-21
3399,1,0,88,0,-88
3400,1,1,357,1537,1180
3401,1,0,78,0,-78
3402,0,0,94,0,-94
3403,0,0,57,0,-57
3404,1,0,49,0,-49
3405,1,1,610,1740,1130
3406,1,0,2,0,-2
3407,0,0,10,0,-10
3408,1,0,176,0,-176
3409,0,0,1,0,-1
3410,1,0,29,0,-29
3411,1,1,178,1861,1683
3412,0,0,4,0,-4
3413,1,0,71,0,-71
3414,1,0,49,0,-49
3415,0,0,4,0,-4
3416,0,0,194,0,-194
3417,0,0,16,0,-16
3418,0,0,82,0,-82
3419,1,0,9,0,-9
3420,0,0,42,0,-42
3421,1,1,758,1475,717
3422,1,1,33,1601,1568
3423,0,0,9,0,-9
3424,1,1,23,2729,2706
3425,0,0,41,0,-41
3426,1,0,3,0,-3
3427,1,1,56,1347,1291
3428,1,0,40,0,-40
3429,1,0,22,0,-22
3430,0,0,46,0,-46
3431,0,0,71,0,-71
3432,1,0,89,0,-89
3433,0,0,33,0,-33
3434,1,1,321,1342,1021
3435,1,0,10,0,-10
3436,1,1,1210,1250,40
3437,0,0,80,0,-80
3438,1,0,90,0,-90
3439,1,0,37,0,-37
3440,0,0,17,0,-17
3441,0,0,127,0,-127
3442,1,0,56,0,-56
3443,0,0,106,0,-106
3444,0,0,92,0,-92
3445,1,0,7,0,-7
3446,0,0,85,0,-85
3447,1,1,1070,1760,690
3448,0,0,15,0,-15
3449,1,1,1134,2326,1192
3450,1,1,1366,1294,-72
3451,1,0,29,0,-29
3452,0,0,18,0,-18
3453,1,0,9,0,-9
3454,1,0,4,0,-4
3455,0,0,14,0,-14
3456,0,0,64,0,-64
3457,1,1,624,1286,662
3458,1,1,740,1320,580
3459,1,1,137,1515,1378
3460,1,1,25,1359,1334
3461,1,1,559,2154,1595
3462,0,0,7,0,-7
3463,1,1,1076,1373,297
3464,1,1,453,1309,856
3465,1,1,284,1241,957
3466,0,0,3,0,-3
3467,0,0,64,0,-64
3468,0,0,230,0,-230
3469,0,0,33,0,-33
3470,1,0,27,0,-27
3471,0,0,48,0,-48
3472,1,0,37,0,-37
3473,1,1,1315,1275,-40
3474,1,0,38,0,-38
3475,0,0,31,0,-31
3476,1,0,89,0,-89
3477,0,0,49,0,-49
3478,0,0,35,0,-35
3479,1,0,124,0,-124
3480,1,1,578,2091,1513
3481,0,0,95,0,-95
3482,1,1,219,1716,1497
3483,0,0,107,0,-107
3484,1,1,95,1428,1333
3485,0,0,44,0,-44
3486,1,1,850,1741,891
3487,0,0,115,0,-115
3488,1,0,0,0,0
3489,0,0,93,0,-93
3490,1,0,45,0,-45
3491,1,1,149,1347,1198
3492,1,0,1,0,-1
3493,1,0,5,0,-5
3494,1,0,6,0,-6
3495,0,0,18,0,-18
3496,1,0,61,0,-61
3497,1,1,294,1814,1520
3498,1,1,1319,1520,201
3499,0,0,29,0,-29
3500,1,0,47,0,-47
3501,0,0,96,0,-96
3502,1,0,75,0,-75
3503,0,0,18,0,-18
3504,0,0,82,0,-82
3505,1,1,884,1354,470
3506,1,1,94,1340,1246
3507,1,0,62,0,-62
3508,0,0,37,0,-37
3509,1,1,267,1757,1490
3510,1,1,2140,2801,661
3511,0,0,30,0,-30
3512,0,0,3,0,-3
3513,1,1,479,1460,981
3514,0,0,70,0,-70
3515,0,0,56,0,-56
3516,1,0,0,0,0
3517,1,1,94,1595,1501
3518,1,0,69,0,-69
3519,0,0,114,0,-114
3520,1,0,22,0,-22
3521,1,0,43,0,-43
3522,1,0,61,0,-61
3523,0,0,80,0,-80
3524,1,0,1,0,-1
3525,0,0,11,0,-11
3526,0,0,109,0,-109
3527,1,0,33,0,-33
3528,1,1,396,1446,1050
3529,1,0,10,0,-10
3530,0,0,81,0,-81
3531,1,0,8,0,-8
3532,1,1,410,1253,843
3533,1,1,148,1238,1090
3534,1,0,84,0,-84
3535,0,0,72,0,-72
3536,1,0,306,0,-306
3537,1,1,412,1323,911
3538,0,0,48,0,-48
3539,1,1,1288,1318,30
3540,1,1,517,1653,1136
3541,1,1,753,1286,533
3542,1,0,14,0,-14
3543,1,1,52,2077,2025
3544,0,0,14,0,-14
3545,1,0,115,0,-115
3546,1,0,2,0,-2
3547,1,1,1046,1714,668
3548,0,0,57,0,-57
3549,1,0,8,0,-8
3550,1,1,342,1347,1005
3551,1,1,1754,1511,-243
3552,1,1,88,1302,1214
3553,1,1,174,1573,1399
3554,1,0,17,0,-17
3555,0,0,5,0,-5
3556,1,1,1439,2589,1150
3557,1,1,367,1332,965
3558,1,1,324,1452,1128
3559,0,0,13,0,-13
3560,0,0,96,0,-96
3561,0,0,81,0,-81
3562,0,0,47,0,-47
3563,1,1,769,1530,761
3564,1,1,114,1326,1212
3565,0,0,22,0,-22
3566,0,0,79,0,-79
3567,1,0,50,0,-50
3568,1,1,302,1388,1086
3569,1,0,24,0,-24
3570,1,0,78,0,-78
3571,1,1,638,1386,748
3572,0,0,32,0,-32
3573,1,1,66,1484,1418
3574,1,1,211,1785,1574
3575,0,0,18,0,-18
3576,1,1,254,1526,1272
3577,0,0,3,0,-3
3578,0,0,13,0,-13
3579,0,0,21,0,-21
3580,0,0,14,0,-14
3581,1,1,214,1568,1354
3582,0,0,40,0,-40
3583,0,0,30,0,-30
3584,1,1,1230,1381,151
3585,1,1,56,1252,1196
3586,0,0,57,0,-57
3587,1,0,74,0,-74
3588,1,1,209,1415,1206
3589,0,0,51,0,-51
3590,1,0,0,0,0
3591,1,0,33,0,-33
3592,0,0,9,0,-9
3593,1,1,646,1556,910
3594,1,0,26,0,-26
3595,1,1,567,1330,763
3596,1,0,0,0,0
3597,0,0,30,0,-30
3598,0,0,6,0,-6
3599,1,1,430,1705,1275
3600,1,1,488,1715,1227
3601,0,0,62,0,-62
3602,1,1,569,1260,691
3603,0,0,49,0,-49
3604,0,0,58,0,-58
3605,1,1,142,1463,1321
3606,0,0,39,0,-39
3607,0,0,18,0,-18
3608,1,1,142,1355,1213
3609,1,0,10,0,-10
3610,1,0,87,0,-87
3611,0,0,98,0,-98
3612,0,0,22,0,-22
3613,1,1,115,1687,1572
3614,1,1,269,1434,1165
3615,0,0,23,0,-23
3616,1,1,266,2185,1919
3617,0,0,22,0,-22
3618,1,1,963,1386,423
3619,0,0,83,0,-83
3620,0,0,18,0,-18
3621,0,0,53,0,-53
3622,0,0,17,0,-17
3623,1,1,195,1566,1371
3624,0,0,33,0,-33
3625,0,0,17,0,-17
3626,0,0,63,0,-63
3627,1,0,78,0,-78
3628,0,0,122,0,-122
3629,0,0,62,0,-62
3630,0,0,76,0,-76
3631,1,0,15,0,-15
3632,1,0,14,0,-14
3633,1,0,61,0,-61
3634,1,0,205,0,-205
3635,1,1,972,1463,491
3636,1,1,115,2193,2078
3637,1,1,2725,1576,-1149
3638,1,1,467,1531,1064
3639,0,0,39,0,-39
3640,0,0,67,0,-67
3641,0,0,12,0,-12
3642,1,0,24,0,-24
3643,1,1,404,1458,1054
3644,1,1,309,1328,1019
3645,0,0,2,0,-2
3646,0,0,202,0,-202
3647,1,1,488,2202,1714
3648,1,1,1509,1734,225
3649,1,0,14,0,-14
3650,1,0,120,0,-120
3651,1,1,89,1707,1618
3652,1,1,241,3697,3456
3653,1,0,77,0,-77
3654,1,0,6,0,-6
3655,1,0,10,0,-10
3656,1,0,56,0,-56
3657,1,0,41,0,-41
3658,1,0,41,0,-41
3659,0,0,35,0,-35
3660,1,1,98,1470,1372
3661,1,1,192,1947,1755
3662,1,1,44,1472,1428
3663,0,0,66,0,-66
3664,1,1,98,1468,1370
3665,1,0,32,0,-32
3666,0,0,13,0,-13
3667,1,1,502,1381,879
3668,1,1,445,1317,872
3669,1,1,311,1331,1020
3670,1,1,772,1429,657
3671,1,0,78,0,-78
3672,1,1,761,1481,720
3673,0,0,21,0,-21
3674,1,0,298,0,-298
3675,0,0,36,0,-36
3676,1,0,11,0,-11
3677,1,1,995,1504,509
3678,0,0,32,0,-32
3679,1,0,31,0,-31
3680,1,0,32,0,-32
3681,1,1,656,1940,1284
3682,0,0,34,0,-34
3683,0,0,28,0,-28
3684,1,1,1040,1461,421
3685,0,0,3,0,-3
3686,0,0,42,0,-42
3687,0,0,46,0,-46
3688,1,1,1661,1678,17
3689,0,0,2,0,-2
3690,1,1,829,1419,590
3691,1,0,6,0,-6
3692,1,0,51,0,-51
3693,1,0,62,0,-62
3694,1,1,1350,1394,44
3695,0,0,73,0,-73
3696,1,0,78,0,-78
3697,1,1,626,1778,1152
3698,1,1,544,1259,715
3699,0,0,13,0,-13
3700,0,0,95,0,-95
3701,1,0,32,0,-32
3702,1,0,7,0,-7
3703,1,0,48,0,-48
3704,0,0,33,0,-33
3705,1,1,655,1317,662
3706,0,0,62,0,-62
3707,0,0,0,0,0
3708,1,0,24,0,-24
3709,1,1,1701,2163,462
3710,0,0,35,0,-35
3711,1,0,33,0,-33
3712,1,0,31,0,-31
3713,0,0,4,0,-4
3714,0,0,99,0,-99
3715,0,0,68,0,-68
3716,0,0,41,0,-41
3717,0,0,38,0,-38
3718,1,1,657,1350,693
3719,0,0,63,0,-63
3720,1,0,12,0,-12
3721,1,0,91,0,-91
3722,1,1,320,1408,1088
3723,0,0,0,0,0
3724,1,0,57,0,-57
3725,0,0,99,0,-99
3726,1,1,88,1274,1186
3727,0,0,7,0,-7
3728,1,1,1157,2371,1214
3729,1,1,297,2415,2118
3730,0,0,31,0,-31
3731,1,1,137,1699,1562
3732,1,0,68,0,-68
3733,1,1,150,1335,1185
3734,1,0,75,0,-75
3735,0,0,70,0,-70
3736,1,1,535,3909,3374
3737,1,0,25,0,-25
3738,0,0,35,0,-35
3739,1,1,684,1430,746
3740,1,1,236,1484,1248
3741,0,0,145,0,-145
3742,1,1,425,1301,876
3743,0,0,7,0,-7
3744,0,0,19,0,-19
3745,1,0,77,0,-77
3746,0,0,75,0,-75
3747,0,0,57,0,-57
3748,1,0,22,0,-22
3749,0,0,14,0,-14
3750,0,0,33,0,-33
3751,0,0,45,0,-45
3752,1,0,46,0,-46
3753,0,0,113,0,-113
3754,0,0,4,0,-4
3755,1,1,208,1594,1386
3756,1,0,44,0,-44
3757,0,0,13,0,-13
3758,0,0,9,0,-9
3759,1,0,9,0,-9
3760,1,0,28,0,-28
3761,1,1,1214,1347,133
3762,1,1,450,1251,801
3763,0,0,63,0,-63
3764,1,1,653,1808,1155
3765,1,1,213,3055,2842
3766,1,1,122,1494,1372
3767,1,1,386,1758,1372
3768,1,1,394,1450,1056
3769,0,0,26,0,-26
3770,1,0,40,0,-40
3771,1,1,1756,5534,3778
3772,0,0,5,0,-5
3773,1,0,104,0,-104
3774,1,1,1218,1314,96
3775,1,1,307,1288,981
3776,1,0,19,0,-19
3777,1,1,136,1239,1103
3778,1,0,104,0,-104
3779,0,0,80,0,-80
3780,1,0,30,0,-30
3781,1,1,469,1433,964
3782,0,0,52,0,-52
3783,0,0,34,0,-34
3784,0,0,59,0,-59
3785,1,1,659,1662,1003
3786,1,1,128,1245,1117
3787,1,0,30,0,-30
3788,0,0,7,0,-7
3789,1,1,85,2815,2730
3790,1,1,1017,1491,474
3791,1,1,1328,1310,-18
3792,1,0,42,0,-42
3793,0,0,5,0,-5
3794,0,0,74,0,-74
3795,1,0,61,0,-61
3796,0,0,8,0,-8
3797,0,0,223,0,-223
3798,1,0,32,0,-32
3799,0,0,59,0,-59
3800,0,0,52,0,-52
3801,1,1,127,1791,1664
3802,0,0,117,0,-117
3803,1,0,3,0,-3
3804,1,0,72,0,-72
3805,1,0,0,0,0
3806,1,0,23,0,-23
3807,0,0,138,0,-138
3808,1,1,114,1273,1159
3809,0,0,11,0,-11
3810,1,0,70,0,-70
3811,1,0,59,0,-59
3812,1,1,1393,1912,519
3813,0,0,57,0,-57
3814,1,1,91,1668,1577
3815,1,0,47,0,-47
3816,0,0,24,0,-24
3817,1,0,57,0,-57
3818,1,0,48,0,-48
3819,1,1,1072,1707,635
3820,1,1,1072,1412,340
3821,0,0,1,0,-1
3822,1,0,299,0,-299
3823,1,0,13,0,-13
3824,0,0,13,0,-13
3825,0,0,93,0,-93
3826,1,1,377,2137,1760
3827,0,0,13,0,-13
3828,0,0,15,0,-15
3829,0,0,215,0,-215
3830,1,0,83,0,-83
3831,1,0,64,0,-64
3832,0,0,37,0,-37
3833,1,1,620,1622,1002
3834,0,0,46,0,-46
3835,0,0,83,0,-83
3836,1,0,158,0,-158
3837,0,0,84,0,-84
3838,1,0,75,0,-75
3839,0,0,87,0,-87
3840,1,1,1240,1905,665
3841,1,0,2,0,-2
3842,0,0,88,0,-88
3843,1,0,49,0,-49
3844,1,1,611,1298,687
3845,0,0,48,0,-48
3846,1,1,138,1288,1150
3847,1,0,94,0,-94
3848,1,0,16,0,-16
3849,1,1,123,1260,1137
3850,1,0,14,0,-14
3851,1,0,9,0,-9
3852,1,1,694,1462,768
3853,1,0,10,0,-10
3854,1,0,159,0,-159
3855,1,0,0,0,0
3856,0,0,57,0,-57
3857,1,0,4,0,-4
3858,0,0,55,0,-55
3859,0,0,55,0,-55
3860,0,0,106,0,-106
3861,1,1,262,2323,2061
3862,0,0,114,0,-114
3863,0,0,45,0,-45
3864,1,0,79,0,-79
3865,0,0,26,0,-26
3866,1,1,206,2297,2091
3867,1,1,1052,1978,926
3868,1,0,0,0,0
3869,1,1,105,1463,1358
3870,1,1,282,1409,1127
3871,1,1,433,1237,804
3872,1,1,281,1526,1245
3873,0,0,37,0,-37
3874,1,1,786,1746,960
3875,1,1,1996,1493,-503
3876,0,0,9,0,-9
3877,1,1,113,1238,1125
3878,0,0,157,0,-157
3879,0,0,16,0,-16
3880,1,1,41,1602,1561
3881,0,0,90,0,-90
3882,1,1,1031,1301,270
3883,1,1,463,1423,960
3884,0,0,2,0,-2
3885,0,0,7,0,-7
3886,1,1,88,1602,1514
3887,1,0,8,0,-8
3888,0,0,30,0,-30
3889,1,0,38,0,-38
3890,0,0,65,0,-65
3891,1,1,446,3070,2624
3892,1,1,1158,1708,550
3893,1,0,54,0,-54
3894,0,0,20,0,-20
3895,1,0,24,0,-24
3896,1,0,103,0,-103
3897,1,0,26,0,-26
3898,1,0,80,0,-80
3899,1,0,73,0,-73
3900,0,0,55,0,-55
3901,1,1,559,2545,1986
3902,1,0,226,0,-226
3903,1,1,377,1321,944
3904,0,0,60,0,-60
3905,0,0,15,0,-15
3906,1,0,7,0,-7
3907,0,0,7,0,-7
3908,1,0,49,0,-49
3909,1,1,96,2242,2146
3910,0,0,3,0,-3
3911,1,1,519,1273,754
3912,1,1,850,1379,529
3913,0,0,11,0,-11
3914,1,0,58,0,-58
3915,1,1,147,1345,1198
3916,0,0,28,0,-28
3917,1,0,99,0,-99
3918,1,1,244,1357,1113
3919,0,0,0,0,0
3920,0,0,69,0,-69
3921,1,0,2,0,-2
3922,1,1,486,1335,849
3923,0,0,20,0,-20
3924,1,1,207,2757,2550
3925,1,1,252,1728,1476
3926,1,0,7,0,-7
3927,0,0,11,0,-11
3928,1,0,5,0,-5
3929,0,0,5,0,-5
3930,0,0,0,0,0
3931,1,1,428,1368,940
3932,1,1,354,2360,2006
3933,1,1,1009,1677,668
3934,1,0,26,0,-26
3935,1,0,20,0,-20
3936,0,0,58,0,-58
3937,1,1,364,1273,909
3938,1,1,82,1298,1216
3939,0,0,36,0,-36
3940,1,0,16,0,-16
3941,1,0,16,0,-16
3942,0,0,188,0,-188
3943,0,0,4,0,-4
3944,1,0,56,0,-56
3945,1,1,537,1539,1002
3946,1,1,437,1851,1414
3947,0,0,91,0,-91
3948,1,0,13,0,-13
3949,1,0,43,0,-43
3950,0,0,6,0,-6
3951,1,0,10,0,-10
3952,1,0,7,0,-7
3953,0,0,13,0,-13
3954,0,0,19,0,-19
3955,1,0,8,0,-8
3956,1,0,251,0,-251
3957,0,0,7,0,-7
3958,1,0,41,0,-41
3959,0,0,23,0,-23
3960,1,1,1133,1689,556
3961,1,0,35,0,-35
3962,1,0,35,0,-35
3963,0,0,102,0,-102
3964,1,1,67,1374,1307
3965,1,0,24,0,-24
3966,0,0,18,0,-18
3967,1,1,306,1303,997
3968,1,0,20,0,-20
3969,1,1,67,1524,1457
3970,1,1,571,1385,814
3971,0,0,52,0,-52
3972,1,1,206,1461,1255
3973,1,1,532,2034,1502
3974,1,1,2075,1430,-645
3975,1,0,81,0,-81
3976,1,0,57,0,-57
3977,0,0,76,0,-76
3978,1,0,83,0,-83
3979,1,1,248,2017,1769
3980,0,0,13,0,-13
3981,1,1,1232,2624,1392
3982,1,0,59,0,-59
3983,1,1,649,1662,1013
3984,1,0,124,0,-124
3985,0,0,7,0,-7
3986,0,0,2,0,-2
3987,0,0,127,0,-127
3988,0,0,140,0,-140
3989,0,0,53,0,-53
3990,0,0,18,0,-18
3991,1,0,31,0,-31
3992,0,0,46,0,-46
3993,1,1,272,2280,2008
3994,1,1,298,1305,1007
3995,1,0,77,0,-77
3996,0,0,92,0,-92
3997,1,0,66,0,-66
3998,0,0,30,0,-30
3999,0,0,54,0,-54
4000,1,1,1905,1311,-594
4001,1,1,928,1558,630
4002,1,0,101,0,-101
4003,0,0,72,0,-72
4004,1,0,35,0,-35
4005,1,1,514,2047,1533
4006,0,0,34,0,-34
4007,0,0,0,0,0
4008,1,0,17,0,-17
4009,0,0,43,0,-43
4010,0,0,78,0,-78
4011,0,0,86,0,-86
4012,0,0,54,0,-54
4013,0,0,36,0,-36
4014,1,1,159,1934,1775
4015,0,0,33,0,-33
4016,0,0,3,0,-3
4017,1,1,118,1342,1224
4018,1,1,141,1311,1170
4019,1,1,320,1436,1116
4020,1,0,12,0,-12
4021,1,1,583,1468,885
4022,1,1,211,1594,1383
4023,1,1,607,1368,761
4024,0,0,12,0,-12
4025,0,0,55,0,-55
4026,1,0,11,0,-11
4027,0,0,43,0,-43
4028,1,0,40,0,-40
4029,1,0,45,0,-45
4030,1,1,275,1295,1020
4031,1,1,273,1592,1319
4032,0,0,53,0,-53
4033,0,0,12,0,-12
4034,1,0,16,0,-16
4035,1,1,1338,1686,348
4036,1,1,3363,1353,-2010
4037,1,1,1367,1297,-70
4038,1,0,12,0,-12
4039,1,0,11,0,-11
4040,1,0,60,0,-60
4041,0,0,22,0,-22
4042,1,0,24,0,-24
4043,1,1,1420,1412,-8
4044,1,0,11,0,-11
4045,0,0,99,0,-99
4046,0,0,50,0,-50
4047,0,0,95,0,-95
4048,1,0,20,0,-20
4049,0,0,103,0,-103
4050,1,1,156,1327,1171
4051,0,0,65,0,-65
4052,1,1,2719,1335,-1384
4053,1,1,1006,1253,247
4054,0,0,5,0,-5
4055,1,1,275,1279,1004
4056,1,1,36,2836,2800
4057,0,0,46,0,-46
4058,1,1,498,2048,1550
4059,1,0,16,0,-16
4060,0,0,27,0,-27
4061,0,0,22,0,-22
4062,1,0,21,0,-21
4063,0,0,88,0,-88
4064,0,0,3,0,-3
4065,0,0,25,0,-25
4066,1,1,136,1415,1279
4067,1,1,583,1242,659
4068,1,0,22,0,-22
4069,0,0,80,0,-80
4070,1,1,254,1395,1141
4071,0,0,9,0,-9
4072,1,0,116,0,-116
4073,1,1,395,1368,973
4074,0,0,23,0,-23
4075,0,0,0,0,0
4076,1,0,89,0,-89
4077,1,0,86,0,-86
4078,0,0,9,0,-9
4079,1,0,27,0,-27
4080,1,1,130,1679,1549
4081,1,0,1,0,-1
4082,0,0,56,0,-56
4083,1,1,239,2034,1795
4084,0,0,56,0,-56
4085,0,0,101,0,-101
4086,0,0,66,0,-66
4087,1,1,438,1474,1036
4088,0,0,59,0,-59
4089,1,1,1001,1263,262
4090,0,0,26,0,-26
4091,0,0,22,0,-22
4092,0,0,25,0,-25
4093,1,1,79,1926,1847
4094,1,1,90,1243,1153
4095,1,0,56,0,-56
4096,1,1,893,1892,999
4097,0,0,44,0,-44
4098,0,0,10,0,-10
4099,0,0,65,0,-65
4100,1,1,298,1277,979
4101,1,1,809,1246,437
4102,1,1,654,1356,702
4103,0,0,30,0,-30
4104,1,0,53,0,-53
4105,1,1,1082,1272,190
4106,1,1,409,2736,2327
4107,1,0,32,0,-32
4108,1,1,515,1606,1091
4109,0,0,86,0,-86
4110,1,1,1051,1262,211
4111,1,0,86,0,-86
4112,1,1,350,1237,887
4113,1,0,23,0,-23
4114,1,1,654,1566,912
4115,1,1,544,1254,710
4116,0,0,21,0,-21
4117,1,1,258,1240,982
4118,0,0,47,0,-47
4119,1,0,86,0,-86
4120,1,1,142,1455,1313
4121,0,0,20,0,-20
4122,0,0,33,0,-33
4123,0,0,83,0,-83
4124,0,0,85,0,-85
4125,1,0,53,0,-53
4126,1,1,986,1255,269
4127,0,0,42,0,-42
4128,1,1,514,2132,1618
4129,1,0,225,0,-225
4130,1,0,23,0,-23
4131,1,0,11,0,-11
4132,0,0,76,0,-76
4133,1,0,126,0,-126
4134,1,1,594,1261,667
4135,0,0,5,0,-5
4136,0,0,111,0,-111
4137,0,0,0,0,0
4138,0,0,219,0,-219
4139,0,0,69,0,-69
4140,0,0,74,0,-74
4141,0,0,1,0,-1
4142,0,0,69,0,-69
4143,1,0,26,0,-26
4144,1,1,1498,1905,407
4145,0,0,261,0,-261
4146,1,0,17,0,-17
4147,1,1,2084,1501,-583
4148,0,0,6,0,-6
4149,0,0,52,0,-52
4150,1,1,317,1496,1179
4151,0,0,18,0,-18
4152,1,1,142,1536,1394
4153,1,1,319,2123,1804
4154,0,0,7,0,-7
4155,1,0,22,0,-22
4156,1,0,18,0,-18
4157,1,1,316,1327,1011
4158,1,0,35,0,-35
4159,1,0,37,0,-37
4160,0,0,19,0,-19
4161,1,1,236,1601,1365
4162,1,1,572,5959,5387
4163,1,1,269,1613,1344
4164,0,0,54,0,-54
4165,1,0,37,0,-37
4166,0,0,8,0,-8
4167,1,0,172,0,-172
4168,1,1,734,1639,905
4169,0,0,26,0,-26
4170,1,1,465,1678,1213
4171,1,0,20,0,-20
4172,1,1,52,1699,1647
4173,1,0,33,0,-33
4174,1,0,61,0,-61
4175,0,0,6,0,-6
4176,0,0,122,0,-122
4177,1,0,19,0,-19
4178,0,0,90,0,-90
4179,1,1,255,1762,1507
4180,1,0,50,0,-50
4181,1,1,626,1480,854
4182,1,1,479,1253,774
4183,1,0,74,0,-74
4184,1,0,81,0,-81
4185,1,1,545,1289,744
4186,1,0,99,0,-99
4187,1,1,86,1630,1544
4188,1,0,151,0,-151
4189,1,0,31,0,-31
4190,1,0,22,0,-22
4191,1,1,136,1607,1471
4192,1,1,1112,1521,409
4193,1,1,1019,2562,1543
4194,1,1,294,2344,2050
4195,1,0,57,0,-57
4196,1,1,777,1388,611
4197,1,0,17,0,-17
4198,1,1,920,3423,2503
4199,0,0,82,0,-82
4200,1,1,489,1608,1119
4201,0,0,13,0,-13
4202,0,0,73,0,-73
4203,0,0,5,0,-5
4204,0,0,17,0,-17
4205,1,1,32,1946,1914
4206,1,0,88,0,-88
4207,1,1,165,1438,1273
4208,0,0,1,0,-1
4209,1,0,27,0,-27
4210,1,1,490,1265,775
4211,0,0,14,0,-14
4212,0,0,37,0,-37
4213,0,0,10,0,-10
4214,1,0,16,0,-16
4215,1,0,51,0,-51
4216,1,1,311,1402,1091
4217,1,1,128,2224,2096
4218,0,0,58,0,-58
4219,0,0,66,0,-66
4220,0,0,29,0,-29
4221,1,1,182,1669,1487
4222,0,0,85,0,-85
4223,1,0,29,0,-29
4224,0,0,157,0,-157
4225,0,0,17,0,-17
4226,1,0,73,0,-73
4227,1,1,160,1417,1257
4228,0,0,48,0,-48
4229,0,0,169,0,-169
4230,0,0,52,0,-52
4231,0,0,64,0,-64
4232,0,0,45,0,-45
4233,1,0,95,0,-95
4234,1,0,5,0,-5
4235,1,1,1198,2256,1058
4236,1,1,627,1305,678
4237,1,0,92,0,-92
4238,0,0,9,0,-9
4239,0,0,43,0,-43
4240,1,0,19,0,-19
4241,1,0,43,0,-43
4242,1,1,858,1310,452
4243,1,1,373,2183,1810
4244,0,0,14,0,-14
4245,1,1,1453,1248,-205
4246,1,0,4,0,-4
4247,0,0,31,0,-31
4248,0,0,36,0,-36
4249,1,1,1817,1307,-510
4250,1,0,49,0,-49
4251,1,0,33,0,-33
4252,0,0,101,0,-101
4253,1,0,51,0,-51
4254,1,1,296,1353,1057
4255,0,0,102,0,-102
4256,1,1,338,1721,1383
4257,1,0,55,0,-55
4258,0,0,22,0,-22
4259,0,0,0,0,0
4260,1,0,314,0,-314
4261,0,0,11,0,-11
4262,0,0,15,0,-15
4263,0,0,25,0,-25
4264,1,1,1426,2806,1380
4265,1,0,128,0,-128
4266,0,0,43,0,-43
4267,1,0,11,0,-11
4268,1,1,610,1333,723
4269,0,0,5,0,-5
4270,1,0,13,0,-13
4271,1,0,5,0,-5
4272,1,0,137,0,-137
4273,1,0,5,0,-5
4274,0,0,112,0,-112
4275,1,0,10,0,-10
4276,1,1,1074,1347,273
4277,0,0,17,0,-17
4278,1,1,62,1498,1436
4279,1,1,132,1369,1237
4280,1,1,902,1374,472
4281,1,0,156,0,-156
4282,0,0,22,0,-22
4283,1,0,13,0,-13
4284,0,0,38,0,-38
4285,1,1,499,2535,2036
4286,0,0,8,0,-8
4287,1,1,1003,1657,654
4288,1,1,533,2668,2135
4289,1,0,71,0,-71
4290,1,1,929,1622,693
4291,1,0,66,0,-66
4292,0,0,10,0,-10
4293,0,0,293,0,-293
4294,0,0,58,0,-58
4295,0,0,16,0,-16
4296,1,0,63,0,-63
4297,1,1,1092,1859,767
4298,1,1,138,2034,1896
4299,0,0,1,0,-1
4300,1,0,25,0,-25
4301,0,0,44,0,-44
4302,0,0,85,0,-85
4303,0,0,5,0,-5
4304,1,1,291,1240,949
4305,0,0,25,0,-25
4306,0,0,233,0,-233
4307,0,0,33,0,-33
4308,1,1,235,3190,2955
4309,1,0,39,0,-39
4310,0,0,129,0,-129
4311,0,0,98,0,-98
4312,1,1,456,1705,1249
4313,1,0,80,0,-80
4314,1,1,345,1420,1075
4315,1,0,168,0,-168
4316,0,0,112,0,-112
4317,0,0,88,0,-88
4318,1,1,200,2138,1938
4319,0,0,74,0,-74
4320,0,0,74,0,-74
4321,1,1,240,1768,1528
4322,1,1,236,1284,1048
4323,1,0,8,0,-8
4324,1,0,4,0,-4
4325,1,0,140,0,-140
4326,1,0,33,0,-33
4327,0,0,4,0,-4
4328,1,0,14,0,-14
4329,1,1,85,1990,1905
4330,0,0,38,0,-38
4331,1,1,634,1241,607
4332,1,1,723,1793,1070
4333,0,0,6,0,-6
4334,1,1,528,2013,1485
4335,1,0,24,0,-24
4336,1,1,371,1321,950
4337,1,1,498,1368,870
4338,0,0,178,0,-178
4339,0,0,6,0,-6
4340,0,0,27,0,-27
4341,1,1,312,2631,2319
4342,0,0,79,0,-79
4343,1,1,463,1655,1192
4344,0,0,156,0,-156
4345,0,0,14,0,-14
4346,1,0,192,0,-192
4347,0,0,64,0,-64
4348,1,1,494,1386,892
4349,1,0,9,0,-9
4350,1,1,123,1663,1540
4351,1,0,63,0,-63
4352,1,1,244,1944,1700
4353,0,0,9,0,-9
4354,1,1,760,2129,1369
4355,1,0,152,0,-152
4356,1,0,58,0,-58
4357,0,0,65,0,-65
4358,1,0,31,0,-31
4359,1,0,41,0,-41
4360,0,0,7,0,-7
4361,0,0,8,0,-8
4362,1,1,22,2019,1997
4363,0,0,5,0,-5
4364,1,1,361,1771,1410
4365,0,0,29,0,-29
4366,1,1,103,1236,1133
4367,1,0,37,0,-37
4368,1,0,224,0,-224
4369,1,1,615,2556,1941
4370,0,0,4,0,-4
4371,1,1,212,1390,1178
4372,1,0,132,0,-132
4373,1,0,15,0,-15
4374,0,0,22,0,-22
4375,1,0,119,0,-119
4376,0,0,17,0,-17
4377,0,0,42,0,-42
4378,0,0,160,0,-160
4379,0,0,68,0,-68
4380,0,0,101,0,-101
4381,0,0,45,0,-45
4382,1,1,1111,1274,163
4383,1,1,750,1665,915
4384,0,0,4,0,-4
4385,1,1,1112,2081,969
4386,0,0,11,0,-11
4387,1,1,67,1399,1332
4388,1,0,256,0,-256
4389,0,0,3,0,-3
4390,1,1,1863,1327,-536
4391,0,0,62,0,-62
4392,1,1,1082,1282,200
4393,0,0,27,0,-27
4394,0,0,10,0,-10
4395,1,0,41,0,-41
4396,1,1,166,1436,1270
4397,1,0,8,0,-8
4398,1,0,43,0,-43
4399,0,0,106,0,-106
4400,0,0,16,0,-16
4401,1,1,563,1591,1028
4402,1,0,64,0,-64
4403,0,0,58,0,-58
4404,1,1,957,1336,379
4405,0,0,114,0,-114
4406,1,0,51,0,-51
4407,0,0,22,0,-22
4408,0,0,124,0,-124
4409,0,0,27,0,-27
4410,0,0,80,0,-80
4411,0,0,130,0,-130
4412,1,0,0,0,0
4413,1,1,140,1376,1236
4414,0,0,2,0,-2
4415,0,0,56,0,-56
4416,1,1,276,1310,1034
4417,1,1,113,1766,1653
4418,1,1,470,1317,847
4419,1,1,786,1303,517
4420,1,0,5,0,-5
4421,0,0,16,0,-16
4422,0,0,79,0,-79
4423,0,0,1,0,-1
4424,1,1,2609,2267,-342
4425,0,0,25,0,-25
4426,1,1,820,1544,724
4427,1,0,0,0,0
4428,0,0,37,0,-37
4429,1,1,218,1800,1582
4430,1,0,12,0,-12
4431,1,1,714,1606,892
4432,1,0,14,0,-14
4433,1,1,174,1633,1459
4434,1,0,53,0,-53
4435,1,1,64,2370,2306
4436,1,1,497,1243,746
4437,0,0,99,0,-99
4438,1,0,95,0,-95
4439,1,1,295,1287,992
4440,0,0,111,0,-111
4441,1,1,163,1298,1135
4442,1,1,701,1370,669
4443,0,0,83,0,-83
4444,1,1,164,1574,1410
4445,1,1,230,1391,1161
4446,1,0,45,0,-45
4447,0,0,133,0,-133
4448,0,0,65,0,-65
4449,1,0,13,0,-13
4450,1,1,236,1459,1223
4451,1,1,1227,1316,89
4452,0,0,111,0,-111
4453,1,1,466,1636,1170
4454,0,0,90,0,-90
4455,1,0,85,0,-85
4456,1,0,15,0,-15
4457,1,1,359,1746,1387
4458,0,0,2,0,-2
4459,0,0,12,0,-12
4460,1,0,39,0,-39
4461,1,1,231,1750,1519
4462,1,0,15,0,-15
4463,0,0,64,0,-64
4464,1,1,142,1650,1508
4465,0,0,10,0,-10
4466,1,1,682,1301,619
4467,0,0,102,0,-102
4468,1,0,46,0,-46
4469,0,0,5,0,-5
4470,1,1,405,1664,1259
4471,1,1,79,1300,1221
4472,1,0,23,0,-23
4473,0,0,263,0,-263
4474,1,0,27,0,-27
4475,0,0,29,0,-29
4476,1,0,46,0,-46
4477,1,1,398,1511,1113
4478,0,0,8,0,-8
4479,1,0,56,0,-56
4480,0,0,20,0,-20
4481,1,1,1200,1533,333
4482,1,1,123,1445,1322
4483,1,1,793,1344,551
4484,1,1,192,1317,1125
4485,1,1,44,1270,1226
4486,1,1,477,2952,2475
4487,0,0,48,0,-48
4488,1,0,29,0,-29
4489,0,0,62,0,-62
4490,1,1,131,1289,1158
4491,0,0,9,0,-9
4492,0,0,23,0,-23
4493,0,0,38,0,-38
4494,0,0,30,0,-30
4495,0,0,214,0,-214
4496,1,1,874,1235,361
4497,1,0,43,0,-43
4498,0,0,51,0,-51
4499,1,0,158,0,-158
4500,0,0,155,0,-155
4501,1,0,56,0,-56
4502,1,1,417,1409,992
4503,1,0,95,0,-95
4504,1,0,17,0,-17
4505,1,0,26,0,-26
4506,0,0,53,0,-53
4507,0,0,87,0,-87
4508,1,1,74,2054,1980
4509,1,0,41,0,-41
4510,1,0,27,0,-27
4511,1,1,18,1400,1382
4512,1,0,65,0,-65
4513,1,0,50,0,-50
4514,0,0,7,0,-7
4515,0,0,48,0,-48
4516,1,0,1,0,-1
4517,1,0,44,0,-44
4518,1,0,33,0,-33
4519,1,1,476,1801,1325
4520,1,1,384,1275,891
4521,1,0,136,0,-136
4522,1,1,553,1464,911
4523,1,1,415,1381,966
4524,1,1,283,1704,1421
4525,0,0,89,0,-89
4526,1,1,915,1312,397
4527,1,1,792,1267,475
4528,1,1,1175,1788,613
4529,1,0,24,0,-24
4530,1,1,103,1593,1490
4531,1,1,273,1981,1708
4532,1,1,158,1333,1175
4533,1,1,40,1333,1293
4534,0,0,10,0,-10
4535,1,0,115,0,-115
4536,1,0,5,0,-5
4537,0,0,188,0,-188
4538,0,0,9,0,-9
4539,1,0,17,0,-17
4540,0,0,152,0,-152
4541,0,0,24,0,-24
4542,1,1,856,2143,1287
4543,1,1,518,1455,937
4544,1,1,303,2153,1850
4545,1,0,18,0,-18
4546,0,0,96,0,-96
4547,1,0,10,0,-10
4548,1,1,352,1257,905
4549,1,1,41,1266,1225
4550,1,0,29,0,-29
4551,1,1,876,1268,392
4552,1,1,126,1336,1210
4553,0,0,60,0,-60
4554,1,0,94,0,-94
4555,1,1,562,1366,804
4556,1,0,35,0,-35
4557,1,0,42,0,-42
4558,0,0,59,0,-59
4559,0,0,37,0,-37
4560,1,1,1829,1336,-493
4561,1,1,674,1283,609
4562,1,0,88,0,-88
4563,1,0,66,0,-66
4564,0,0,96,0,-96
4565,1,1,506,1388,882
4566,1,0,35,0,-35
4567,1,0,1,0,-1
4568,1,1,441,1329,888
4569,0,0,8,0,-8
4570,1,1,1203,1684,481
4571,0,0,0,0,0
4572,1,0,8,0,-8
4573,1,0,27,0,-27
4574,1,1,136,1608,1472
4575,1,1,479,1385,906
4576,1,0,8,0,-8
4577,1,1,377,1647,1270
4578,1,0,51,0,-51
4579,0,0,19,0,-19
4580,1,0,34,0,-34
4581,1,1,2478,1909,-569
4582,1,0,29,0,-29
4583,1,0,101,0,-101
4584,1,1,71,1335,1264
4585,1,1,155,1658,1503
4586,0,0,232,0,-232
4587,1,0,30,0,-30
4588,1,0,8,0,-8
4589,0,0,153,0,-153
4590,0,0,101,0,-101
4591,1,0,21,0,-21
4592,1,1,175,1548,1373
4593,1,0,11,0,-11
4594,1,0,14,0,-14
4595,1,0,66,0,-66
4596,1,1,135,1454,1319
4597,1,1,337,1877,1540
4598,1,0,68,0,-68
4599,0,0,87,0,-87
4600,0,0,213,0,-213
4601,1,0,108,0,-108
4602,1,0,8,0,-8
4603,0,0,79,0,-79
4604,0,0,118,0,-118
4605,0,0,41,0,-41
4606,0,0,94,0,-94
4607,1,0,24,0,-24
4608,0,0,184,0,-184
4609,0,0,31,0,-31
4610,0,0,6,0,-6
4611,0,0,5,0,-5
4612,1,1,532,1981,1449
4613,0,0,21,0,-21
4614,0,0,26,0,-26
4615,1,1,510,1364,854
4616,1,0,24,0,-24
4617,1,0,27,0,-27
4618,0,0,9,0,-9
4619,1,1,187,4091,3904
4620,1,1,450,1762,1312
4621,1,0,13,0,-13
4622,1,1,214,1431,1217
4623,1,1,541,1773,1232
4624,0,0,162,0,-162
4625,0,0,35,0,-35
4626,1,1,93,1458,1365
4627,1,1,587,1294,707
4628,0,0,15,0,-15
4629,1,0,24,0,-24
4630,0,0,63,0,-63
4631,1,0,76,0,-76
4632,1,1,281,1720,1439
4633,0,0,0,0,0
4634,1,1,302,1653,1351
4635,0,0,34,0,-34
4636,1,1,401,1374,973
4637,0,0,58,0,-58
4638,0,0,114,0,-114
4639,1,0,70,0,-70
4640,1,0,207,0,-207
4641,1,1,905,1344,439
4642,1,1,123,1442,1319
4643,1,0,91,0,-91
4644,0,0,34,0,-34
4645,0,0,18,0,-18
4646,1,0,17,0,-17
4647,1,1,735,1871,1136
4648,0,0,116,0,-116
4649,1,0,32,0,-32
4650,0,0,71,0,-71
4651,1,0,13,0,-13
4652,1,1,119,1468,1349
4653,1,0,34,0,-34
4654,1,1,429,1250,821
4655,1,0,0,0,0
4656,1,1,273,1818,1545
4657,0,0,103,0,-103
4658,1,1,823,1242,419
4659,0,0,34,0,-34
4660,1,1,346,1261,915
4661,0,0,31,0,-31
4662,1,1,80,1358,1278
4663,1,0,1,0,-1
4664,0,0,6,0,-6
4665,1,0,110,0,-110
4666,1,0,82,0,-82
4667,0,0,79,0,-79
4668,1,0,44,0,-44
4669,1,1,432,1247,815
4670,0,0,30,0,-30
4671,1,1,409,1315,906
4672,0,0,54,0,-54
4673,1,0,5,0,-5
4674,1,0,37,0,-37
4675,0,0,1,0,-1
4676,1,0,27,0,-27
4677,1,0,132,0,-132
4678,1,0,11,0,-11
4679,1,0,60,0,-60
4680,1,1,133,1424,1291
4681,1,1,154,1296,1142
4682,1,0,13,0,-13
4683,1,0,277,0,-277
4684,1,0,13,0,-13
4685,1,0,75,0,-75
4686,1,1,280,1284,1004
4687,1,0,10,0,-10
4688,0,0,0,0,0
4689,1,0,1,0,-1
4690,0,0,66,0,-66
4691,1,0,2,0,-2
4692,1,1,1125,1239,114
4693,0,0,13,0,-13
4694,0,0,45,0,-45
4695,0,0,11,0,-11
4696,1,0,61,0,-61
4697,0,0,3,0,-3
4698,1,1,223,1317,1094
4699,1,0,50,0,-50
4700,1,0,71,0,-71
4701,1,0,58,0,-58
4702,1,1,316,2895,2579
4703,0,0,5,0,-5
4704,0,0,40,0,-40
4705,0,0,34,0,-34
4706,1,1,769,1338,569
4707,0,0,40,0,-40
4708,0,0,0,0,0
4709,1,0,144,0,-144
4710,0,0,47,0,-47
4711,1,1,639,1893,1254
4712,0,0,13,0,-13
4713,0,0,19,0,-19
4714,0,0,198,0,-198
4715,1,0,14,0,-14
4716,0,0,62,0,-62
4717,1,0,67,0,-67
4718,0,0,3,0,-3
4719,0,0,21,0,-21
4720,1,1,171,1239,1068
4721,0,0,284,0,-284
4722,1,0,92,0,-92
4723,0,0,72,0,-72
4724,1,1,684,1262,578
4725,1,1,1254,1419,165
4726,0,0,7,0,-7
4727,1,0,12,0,-12
4728,1,1,724,1566,842
4729,1,0,83,0,-83
4730,0,0,9,0,-9
4731,0,0,52,0,-52
4732,1,0,28,0,-28
4733,1,1,258,2587,2329
4734,0,0,78,0,-78
4735,0,0,53,0,-53
4736,0,0,20,0,-20
4737,1,1,664,1333,669
4738,1,1,152,1385,1233
4739,1,1,1093,1253,160
4740,0,0,30,0,-30
4741,1,0,23,0,-23
4742,1,1,823,1375,552
4743,1,0,14,0,-14
4744,1,0,22,0,-22
4745,0,0,15,0,-15
4746,1,1,172,2041,1869
4747,0,0,3,0,-3
4748,1,0,56,0,-56
4749,0,0,7,0,-7
4750,0,0,30,0,-30
4751,1,1,163,2467,2304
4752,1,1,679,1269,590
4753,1,0,32,0,-32
4754,1,1,397,1682,1285
4755,1,1,106,2816,2710
4756,1,0,61,0,-61
4757,1,0,0,0,0
4758,1,1,208,1385,1177
4759,0,0,55,0,-55
4760,1,0,168,0,-168
4761,1,0,216,0,-216
4762,0,0,6,0,-6
4763,1,1,142,1427,1285
4764,1,1,838,1931,1093
4765,1,1,128,1238,1110
4766,0,0,8,0,-8
4767,1,0,15,0,-15
4768,1,1,669,1264,595
4769,0,0,22,0,-22
4770,1,1,167,3154,2987
4771,1,0,23,0,-23
4772,1,1,376,1440,1064
4773,1,0,36,0,-36
4774,1,1,291,1423,1132
4775,1,1,270,1932,1662
4776,1,0,2,0,-2
4777,1,1,967,1436,469
4778,1,1,87,1483,1396
4779,1,0,40,0,-40
4780,1,1,1522,1381,-141
4781,0,0,25,0,-25
4782,0,0,57,0,-57
4783,0,0,100,0,-100
4784,0,0,37,0,-37
4785,1,1,538,2306,1768
4786,1,0,70,0,-70
4787,1,1,180,2491,2311
4788,0,0,3,0,-3
4789,0,0,15,0,-15
4790,1,1,137,1432,1295
4791,1,1,321,2317,1996
4792,0,0,4,0,-4
4793,1,1,304,1270,966
4794,0,0,162,0,-162
4795,0,0,39,0,-39
4796,1,0,24,0,-24
4797,1,0,1,0,-1
4798,1,1,304,1368,1064
4799,0,0,10,0,-10
4800,1,1,335,1919,1584
4801,1,0,96,0,-96
4802,1,0,104,0,-104
4803,0,0,31,0,-31
4804,1,0,11,0,-11
4805,1,1,1212,1832,620
4806,0,0,11,0,-11
4807,0,0,18,0,-18
4808,1,0,156,0,-156
4809,1,0,9,0,-9
4810,1,0,28,0,-28
4811,1,0,38,0,-38
4812,1,0,65,0,-65
4813,1,1,232,1754,1522
4814,1,0,22,0,-22
4815,1,0,69,0,-69
4816,0,0,47,0,-47
4817,0,0,8,0,-8
4818,1,1,853,2082,1229
4819,0,0,77,0,-77
4820,0,0,10,0,-10
4821,1,0,1,0,-1
4822,1,0,61,0,-61
4823,1,1,887,1484,597
4824,1,0,67,0,-67
4825,1,0,28,0,-28
4826,1,0,23,0,-23
4827,1,0,94,0,-94
4828,1,1,962,1306,344
4829,0,0,19,0,-19
4830,1,0,57,0,-57
4831,0,0,157,0,-157
4832,1,1,1021,1368,347
4833,0,0,102,0,-102
4834,0,0,3,0,-3
4835,1,1,148,1472,1324
4836,1,1,673,1317,644
4837,1,0,10,0,-10
4838,1,1,21,2040,2019
4839,1,0,58,0,-58
4840,0,0,56,0,-56
4841,1,0,7,0,-7
4842,1,0,5,0,-5
4843,1,1,262,1474,1212
4844,0,0,6,0,-6
4845,1,1,93,1263,1170
4846,1,1,337,1934,1597
4847,1,1,797,1802,1005
4848,0,0,9,0,-9
4849,1,1,68,1237,1169
4850,1,1,15,1466,1451
4851,1,1,99,1388,1289
4852,1,1,2160,3920,1760
4853,0,0,24,0,-24
4854,0,0,208,0,-208
4855,1,0,8,0,-8
4856,1,0,34,0,-34
4857,1,1,2594,1580,-1014
4858,0,0,46,0,-46
4859,1,0,68,0,-68
4860,1,1,258,1337,1079
4861,1,1,1763,1276,-487
4862,1,0,17,0,-17
4863,1,0,244,0,-244
4864,0,0,4,0,-4
4865,0,0,0,0,0
4866,1,0,162,0,-162
4867,1,0,29,0,-29
4868,0,0,74,0,-74
4869,1,1,709,1239,530
4870,0,0,36,0,-36
4871,1,0,105,0,-105
4872,1,0,4,0,-4
4873,0,0,35,0,-35
4874,0,0,24,0,-24
4875,1,1,727,1634,907
4876,1,1,1571,1357,-214
4877,0,0,5,0,-5
4878,1,1,378,1322,944
4879,1,0,6,0,-6
4880,1,0,75,0,-75
4881,1,0,54,0,-54
4882,1,1,196,2386,2190
4883,1,0,38,0,-38
4884,1,0,30,0,-30
4885,0,0,30,0,-30
4886,1,0,10,0,-10
4887,1,1,430,3852,3422
4888,1,0,2,0,-2
4889,1,0,3,0,-3
4890,1,0,6,0,-6
4891,1,0,27,0,-27
4892,1,1,471,1272,801
4893,0,0,77,0,-77
4894,1,0,82,0,-82
4895,0,0,10,0,-10
4896,0,0,20,0,-20
4897,0,0,79,0,-79
4898,1,1,911,1374,463
4899,1,0,32,0,-32
4900,1,1,429,1361,932
4901,0,0,74,0,-74
4902,0,0,75,0,-75
4903,1,0,53,0,-53
4904,1,1,1162,1340,178
4905,0,0,39,0,-39
4906,0,0,122,0,-122
4907,0,0,63,0,-63
4908,1,1,359,1439,1080
4909,1,0,33,0,-33
4910,0,0,70,0,-70
4911,0,0,29,0,-29
4912,0,0,4,0,-4
4913,1,1,180,2724,2544
4914,0,0,24,0,-24
4915,1,0,3,0,-3
4916,1,1,58,1381,1323
4917,1,0,4,0,-4
4918,0,0,0,0,0
4919,1,0,9,0,-9
4920,1,0,44,0,-44
4921,0,0,63,0,-63
4922,1,0,4,0,-4
4923,0,0,11,0,-11
4924,1,1,485,1326,841
4925,1,0,242,0,-242
4926,1,1,549,1362,813
4927,1,1,213,3000,2787
4928,0,0,6,0,-6
4929,1,0,0,0,0
4930,1,0,190,0,-190
4931,1,0,38,0,-38
4932,1,1,1104,1293,189
4933,1,0,19,0,-19
4934,1,1,460,1372,912
4935,1,1,687,1664,977
4936,0,0,38,0,-38
4937,1,1,229,1977,1748
4938,1,0,119,0,-119
4939,1,0,24,0,-24
4940,1,0,71,0,-71
4941,0,0,13,0,-13
4942,0,0,6,0,-6
4943,0,0,59,0,-59
4944,1,1,261,1700,1439
4945,1,1,1535,1689,154
4946,1,0,38,0,-38
4947,0,0,40,0,-40
4948,0,0,31,0,-31
4949,0,0,15,0,-15
4950,1,0,29,0,-29
4951,0,0,20,0,-20
4952,1,0,56,0,-56
4953,0,0,177,0,-177
4954,0,0,5,0,-5
4955,1,1,807,1473,666
4956,0,0,6,0,-6
4957,0,0,0,0,0
4958,1,1,665,1600,935
4959,1,1,420,1326,906
4960,1,1,108,1311,1203
4961,0,0,9,0,-9
4962,1,0,22,0,-22
4963,1,1,920,1598,678
4964,0,0,83,0,-83
4965,1,0,54,0,-54
4966,1,1,324,1393,1069
4967,0,0,116,0,-116
4968,1,1,766,1683,917
4969,0,0,22,0,-22
4970,1,1,510,1839,1329
4971,1,0,15,0,-15
4972,1,1,1839,1322,-517
4973,0,0,29,0,-29
4974,1,1,498,4707,4209
4975,0,0,37,0,-37
4976,0,0,9,0,-9
4977,0,0,25,0,-25
4978,0,0,15,0,-15
4979,1,1,143,1346,1203
4980,1,0,29,0,-29
4981,1,0,30,0,-30
4982,1,0,28,0,-28
4983,1,0,15,0,-15
4984,1,1,783,1246,463
4985,0,0,29,0,-29
4986,0,0,89,0,-89
4987,1,1,88,1507,1419
4988,1,0,49,0,-49
4989,0,0,45,0,-45
4990,1,0,81,0,-81
4991,1,1,536,2616,2080
4992,1,1,248,3094,2846
4993,1,1,90,2021,1931
4994,1,0,5,0,-5
4995,1,0,4,0,-4
4996,1,0,244,0,-244
4997,1,1,446,1251,805
4998,1,0,137,0,-137
4999,0,0,64,0,-64
5000,1,0,84,0,-84
5001,0,0,158,0,-158
5002,1,1,422,1567,1145
5003,1,0,15,0,-15
5004,0,0,94,0,-94
5005,0,0,31,0,-31
5006,1,1,296,1235,939
5007,0,0,160,0,-160
5008,1,0,57,0,-57
5009,0,0,54,0,-54
5010,1,0,24,0,-24
5011,1,0,5,0,-5
5012,1,0,106,0,-106
5013,1,0,36,0,-36
5014,0,0,17,0,-17
5015,0,0,39,0,-39
5016,1,1,931,2019,1088
5017,0,0,19,0,-19
5018,1,0,135,0,-135
5019,1,0,88,0,-88
5020,1,1,259,1643,1384
5021,1,0,19,0,-19
5022,0,0,18,0,-18
5023,1,0,29,0,-29
5024,0,0,162,0,-162
5025,0,0,36,0,-36
5026,0,0,72,0,-72
5027,0,0,152,0,-152
5028,1,0,55,0,-55
5029,0,0,41,0,-41
5030,0,0,44,0,-44
5031,1,0,201,0,-201
5032,0,0,78,0,-78
5033,1,0,34,0,-34
5034,0,0,18,0,-18
5035,0,0,61,0,-61
5036,0,0,68,0,-68
5037,1,0,14,0,-14
5038,1,0,45,0,-45
5039,0,0,8,0,-8
5040,1,1,299,1796,1497
5041,0,0,26,0,-26
5042,0,0,98,0,-98
5043,1,0,2,0,-2
5044,0,0,140,0,-140
5045,1,1,100,1244,1144
5046,0,0,1,0,-1
5047,1,1,1528,1538,10
5048,1,1,515,1646,1131
5049,0,0,98,0,-98
5050,1,0,41,0,-41
5051,1,1,54,1394,1340
5052,0,0,4,0,-4
5053,1,1,196,1247,1051
5054,0,0,58,0,-58
5055,0,0,5,0,-5
5056,0,0,2,0,-2
5057,1,0,58,0,-58
5058,1,1,63,1469,1406
5059,0,0,15,0,-15
5060,0,0,108,0,-108
5061,1,0,37,0,-37
5062,0,0,31,0,-31
5063,1,0,48,0,-48
5064,0,0,106,0,-106
5065,1,0,84,0,-84
5066,1,1,181,1835,1654
5067,1,1,38,1379,1341
5068,1,0,64,0,-64
5069,1,0,71,0,-71
5070,0,0,23,0,-23
5071,1,0,32,0,-32
5072,1,1,58,1815,1757
5073,0,0,12,0,-12
5074,1,0,71,0,-71
5075,0,0,89,0,-89
5076,1,0,5,0,-5
5077,0,0,17,0,-17
5078,1,0,264,0,-264
5079,0,0,27,0,-27
5080,0,0,10,0,-10
5081,1,0,88,0,-88
5082,1,0,52,0,-52
5083,0,0,130,0,-130
5084,0,0,67,0,-67
5085,1,0,31,0,-31
5086,1,0,100,0,-100
5087,1,1,374,1245,871
5088,0,0,22,0,-22
5089,1,0,18,0,-18
5090,1,0,17,0,-17
5091,1,0,51,0,-51
5092,0,0,39,0,-39
5093,1,1,260,1482,1222
5094,0,0,24,0,-24
5095,1,0,31,0,-31
5096,1,1,1243,1779,536
5097,0,0,49,0,-49
5098,1,1,351,1388,1037
5099,0,0,42,0,-42
5100,1,1,1476,1426,-50
5101,1,0,123,0,-123
5102,1,0,0,0,0
5103,1,0,2,0,-2
5104,1,1,991,1437,446
5105,1,0,19,0,-19
5106,1,0,20,0,-20
5107,1,1,99,1343,1244
5108,0,0,14,0,-14
5109,1,0,220,0,-220
5110,0,0,24,0,-24
5111,1,1,613,1619,1006
5112,1,0,25,0,-25
5113,1,1,1128,1486,358
5114,1,1,48,1439,1391
5115,1,0,0,0,0
5116,0,0,107,0,-107
5117,1,1,777,1377,600
5118,1,0,36,0,-36
5119,1,0,55,0,-55
5120,0,0,75,0,-75
5121,0,0,43,0,-43
5122,0,0,17,0,-17
5123,1,0,9,0,-9
5124,0,0,10,0,-10
5125,0,0,11,0,-11
5126,0,0,44,0,-44
5127,0,0,5,0,-5
5128,1,1,71,1609,1538
5129,0,0,128,0,-128
5130,0,0,13,0,-13
5131,0,0,42,0,-42
5132,1,1,93,1391,1298
5133,1,1,839,1244,405
5134,1,0,15,0,-15
5135,1,1,417,1444,1027
5136,1,1,394,1742,1348
5137,0,0,20,0,-20
5138,1,1,1194,2456,1262
5139,0,0,10,0,-10
5140,1,1,563,2256,1693
5141,1,1,204,1449,1245
5142,0,0,102,0,-102
5143,0,0,14,0,-14
5144,0,0,166,0,-166
5145,1,1,202,2320,2118
5146,1,0,29,0,-29
5147,0,0,66,0,-66
5148,1,1,778,1363,585
5149,1,1,579,2428,1849
5150,0,0,141,0,-141
5151,1,0,38,0,-38
5152,0,0,41,0,-41
5153,1,0,37,0,-37
5154,1,1,183,1303,1120
5155,1,0,7,0,-7
5156,0,0,32,0,-32
5157,1,1,1021,1460,439
5158,1,0,253,0,-253
5159,1,0,86,0,-86
5160,0,0,39,0,-39
5161,0,0,102,0,-102
5162,1,1,361,1279,918
5163,0,0,81,0,-81
5164,1,0,220,0,-220
5165,1,1,1272,1319,47
5166,1,1,315,1274,959
5167,0,0,4,0,-4
5168,0,0,29,0,-29
5169,1,0,22,0,-22
5170,0,0,22,0,-22
5171,1,0,27,0,-27
5172,0,0,28,0,-28
5173,1,1,208,1577,1369
5174,1,1,407,1923,1516
5175,0,0,44,0,-44
5176,0,0,18,0,-18
5177,1,1,621,1302,681
5178,0,0,44,0,-44
5179,1,0,26,0,-26
5180,1,1,144,2675,2531
5181,0,0,16,0,-16
5182,1,1,2311,1408,-903
5183,0,0,75,0,-75
5184,1,1,179,1541,1362
5185,1,0,17,0,-17
5186,1,1,903,1467,564
5187,1,1,742,1297,555
5188,1,0,69,0,-69
5189,1,0,11,0,-11
5190,0,0,64,0,-64
5191,0,0,122,0,-122
5192,1,0,22,0,-22
5193,1,0,7,0,-7
5194,1,0,44,0,-44
5195,1,0,26,0,-26
5196,1,0,19,0,-19
5197,0,0,5,0,-5
5198,0,0,1,0,-1
5199,1,0,71,0,-71
5200,1,1,80,1466,1386
5201,1,0,24,0,-24
5202,0,0,26,0,-26
5203,0,0,35,0,-35
5204,0,0,28,0,-28
5205,1,1,141,1279,1138
5206,1,0,46,0,-46
5207,1,1,327,2544,2217
5208,1,0,27,0,-27
5209,1,0,46,0,-46
5210,1,0,32,0,-32
5211,0,0,69,0,-69
5212,0,0,149,0,-149
5213,1,0,2,0,-2
5214,1,1,918,1264,346
5215,1,0,58,0,-58
5216,0,0,36,0,-36
5217,1,0,105,0,-105
5218,0,0,169,0,-169
5219,1,1,127,1418,1291
5220,1,1,2025,1550,-475
5221,0,0,6,0,-6
5222,1,1,222,1383,1161
5223,1,0,27,0,-27
5224,0,0,9,0,-9
5225,0,0,29,0,-29
5226,0,0,42,0,-42
5227,1,0,157,0,-157
5228,0,0,102,0,-102
5229,1,0,73,0,-73
5230,0,0,4,0,-4
5231,0,0,12,0,-12
5232,1,0,28,0,-28
5233,1,0,25,0,-25
5234,0,0,59,0,-59
5235,1,1,849,1401,552
5236,1,0,3,0,-3
5237,0,0,3,0,-3
5238,1,1,90,1427,1337
5239,0,0,34,0,-34
5240,1,1,1153,1370,217
5241,0,0,41,0,-41
5242,1,1,1521,1465,-56
5243,0,0,201,0,-201
5244,0,0,73,0,-73
5245,0,0,54,0,-54
5246,1,1,99,1372,1273
5247,1,1,147,1525,1378
5248,1,0,48,0,-48
5249,0,0,125,0,-125
5250,1,0,20,0,-20
5251,1,0,1,0,-1
5252,0,0,4,0,-4
5253,1,0,10,0,-10
5254,1,0,13,0,-13
5255,1,0,27,0,-27
5256,0,0,99,0,-99
5257,1,0,109,0,-109
5258,1,1,181,1449,1268
5259,0,0,10,0,-10
5260,0,0,11,0,-11
5261,1,0,104,0,-104
5262,1,1,1941,1278,-663
5263,1,1,478,1796,1318
5264,0,0,79,0,-79
5265,1,1,589,1240,651
5266,1,1,1019,2541,1522
5267,1,1,37,1451,1414
5268,1,0,55,0,-55
5269,1,1,279,1270,991
5270,0,0,37,0,-37
5271,0,0,94,0,-94
5272,1,1,212,1910,1698
5273,1,0,154,0,-154
5274,1,1,712,1288,576
5275,1,0,61,0,-61
5276,1,0,9,0,-9
5277,1,0,8,0,-8
5278,0,0,12,0,-12
5279,1,1,1566,1350,-216
5280,1,0,72,0,-72
5281,1,1,107,1510,1403
5282,0,0,96,0,-96
5283,0,0,108,0,-108
5284,0,0,73,0,-73
5285,0,0,138,0,-138
5286,0,0,0,0,0
5287,0,0,25,0,-25
5288,0,0,71,0,-71
5289,0,0,4,0,-4
5290,0,0,6,0,-6
5291,1,1,493,2417,1924
5292,0,0,63,0,-63
5293,1,0,33,0,-33
5294,1,1,52,1395,1343
5295,0,0,49,0,-49
5296,0,0,6,0,-6
5297,1,0,35,0,-35
5298,1,1,311,1459,1148
5299,1,1,370,1756,1386
5300,0,0,73,0,-73
5301,0,0,21,0,-21
5302,1,1,98,1276,1178
5303,1,0,31,0,-31
5304,1,1,347,2208,1861
5305,0,0,13,0,-13
5306,0,0,92,0,-92
5307,0,0,12,0,-12
5308,1,1,726,1735,1009
5309,1,1,416,1858,1442
5310,1,1,114,1492,1378
5311,1,1,3608,1246,-2362
5312,0,0,126,0,-126
5313,0,0,75,0,-75
5314,0,0,38,0,-38
5315,0,0,81,0,-81
5316,1,0,57,0,-57
5317,1,1,320,1417,1097
5318,1,0,14,0,-14
5319,0,0,9,0,-9
5320,0,0,134,0,-134
5321,1,0,25,0,-25
5322,0,0,9,0,-9
5323,1,0,36,0,-36
5324,0,0,47,0,-47
5325,0,0,35,0,-35
5326,1,0,185,0,-185
5327,1,1,1119,2268,1149
5328,0,0,13,0,-13
5329,1,0,35,0,-35
5330,1,1,743,1457,714
5331,1,1,1041,1327,286
5332,0,0,16,0,-16
5333,0,0,15,0,-15
5334,1,0,3,0,-3
5335,1,1,314,1466,1152
5336,1,0,2,0,-2
5337,1,1,162,1956,1794
5338,1,0,52,0,-52
5339,0,0,80,0,-80
5340,1,0,37,0,-37
5341,0,0,91,0,-91
5342,1,0,10,0,-10
5343,0,0,114,0,-114
5344,0,0,49,0,-49
5345,1,1,355,1330,975
5346,1,0,112,0,-112
5347,1,0,12,0,-12
5348,1,0,27,0,-27
5349,1,1,1673,1268,-405
5350,0,0,0,0,0
5351,0,0,33,0,-33
5352,1,1,1417,2035,618
5353,0,0,1,0,-1
5354,1,1,1090,1286,196
5355,1,0,5,0,-5
5356,0,0,117,0,-117
5357,0,0,50,0,-50
5358,0,0,99,0,-99
5359,1,1,517,1265,748
5360,1,1,566,1421,855
5361,0,0,63,0,-63
5362,1,0,61,0,-61
5363,1,1,130,1551,1421
5364,0,0,1,0,-1
5365,1,1,212,1239,1027
5366,1,0,86,0,-86
5367,1,0,65,0,-65
5368,1,1,1580,1920,340
5369,1,0,66,0,-66
5370,0,0,57,0,-57
5371,0,0,24,0,-24
5372,1,1,283,1300,1017
5373,1,0,17,0,-17
5374,1,1,94,1548,1454
5375,0,0,59,0,-59
5376,0,0,71,0,-71
5377,1,1,183,1286,1103
5378,0,0,109,0,-109
5379,1,0,1,0,-1
5380,1,0,52,0,-52
5381,1,0,96,0,-96
5382,1,1,459,3214,2755
5383,0,0,27,0,-27
5384,1,1,318,2194,1876
5385,0,0,51,0,-51
5386,1,1,457,1268,811
5387,1,1,849,1518,669
5388,1,0,18,0,-18
5389,0,0,229,0,-229
5390,1,0,196,0,-196
5391,0,0,57,0,-57
5392,1,1,139,1452,1313
5393,1,0,38,0,-38
5394,1,0,53,0,-53
5395,0,0,222,0,-222
5396,0,0,63,0,-63
5397,1,1,1392,2225,833
5398,0,0,45,0,-45
5399,1,1,582,1731,1149
5400,0,0,25,0,-25
5401,1,1,296,1362,1066
5402,0,0,34,0,-34
5403,1,1,89,1348,1259
5404,1,1,897,2021,1124
5405,0,0,8,0,-8
5406,1,0,183,0,-183
5407,1,0,65,0,-65
5408,1,1,352,1472,1120
5409,1,1,42,1268,1226
5410,0,0,137,0,-137
5411,1,0,63,0,-63
5412,1,0,16,0,-16
5413,1,0,9,0,-9
5414,1,1,214,1299,1085
5415,0,0,9,0,-9
5416,0,0,35,0,-35
5417,0,0,55,0,-55
5418,1,1,96,1284,1188
5419,0,0,37,0,-37
5420,0,0,15,0,-15
5421,1,0,44,0,-44
5422,1,1,245,1468,1223
5423,0,0,9,0,-9
5424,1,0,31,0,-31
5425,1,1,153,1268,1115
5426,1,0,96,0,-96
5427,0,0,273,0,-273
5428,0,0,5,0,-5
5429,0,0,73,0,-73
5430,1,0,35,0,-35
5431,1,1,1444,1468,24
5432,0,0,107,0,-107
5433,1,0,43,0,-43
5434,0,0,29,0,-29
5435,1,0,40,0,-40
5436,1,1,2905,1356,-1549
5437,1,1,193,1252,1059
5438,0,0,13,0,-13
5439,1,0,11,0,-11
5440,0,0,47,0,-47
5441,0,0,42,0,-42
5442,1,0,3,0,-3
5443,1,0,92,0,-92
5444,1,1,332,2151,1819
5445,0,0,42,0,-42
5446,1,1,316,1831,1515
5447,1,0,27,0,-27
5448,1,0,55,0,-55
5449,0,0,2,0,-2
5450,1,0,4,0,-4
5451,0,0,34,0,-34
5452,1,1,151,3268,3117
5453,0,0,9,0,-9
5454,1,1,896,1483,587
5455,0,0,49,0,-49
5456,0,0,1,0,-1
5457,1,1,328,1408,1080
5458,0,0,0,0,0
5459,0,0,33,0,-33
5460,1,1,208,1400,1192
5461,1,1,546,1392,846
5462,1,1,90,1238,1148
5463,0,0,55,0,-55
5464,1,1,183,1821,1638
5465,1,0,11,0,-11
5466,0,0,6,0,-6
5467,1,1,23,1304,1281
5468,1,1,220,1411,1191
5469,1,1,166,1275,1109
5470,0,0,13,0,-13
5471,1,0,257,0,-257
5472,1,1,1060,1975,915
5473,1,0,65,0,-65
5474,0,0,33,0,-33
5475,0,0,18,0,-18
5476,1,0,50,0,-50
5477,0,0,52,0,-52
5478,1,1,204,1953,1749
5479,1,0,10,0,-10
5480,1,0,10,0,-10
5481,1,1,7,1650,1643
5482,1,1,200,1272,1072
5483,1,0,50,0,-50
5484,1,0,39,0,-39
5485,1,0,17,0,-17
5486,1,1,176,1265,1089
5487,1,0,16,0,-16
5488,0,0,23,0,-23
5489,0,0,42,0,-42
5490,1,1,72,2258,2186
5491,1,0,86,0,-86
5492,1,1,494,1625,1131
5493,0,0,32,0,-32
5494,1,0,58,0,-58
5495,1,1,1297,2044,747
5496,1,1,172,1468,1296
5497,0,0,6,0,-6
5498,1,0,44,0,-44
5499,0,0,32,0,-32
5500,0,0,44,0,-44
5501,1,1,90,1386,1296
5502,0,0,10,0,-10
5503,1,1,239,1538,1299
5504,0,0,109,0,-109
5505,1,0,34,0,-34
5506,0,0,31,0,-31
5507,0,0,133,0,-133
5508,0,0,13,0,-13
5509,0,0,250,0,-250
5510,0,0,32,0,-32
5511,1,0,2,0,-2
5512,0,0,59,0,-59
5513,1,1,387,2043,1656
5514,1,0,33,0,-33
5515,1,1,206,1446,1240
5516,1,0,29,0,-29
5517,1,1,61,1414,1353
5518,0,0,9,0,-9
5519,0,0,43,0,-43
5520,1,1,923,1244,321
5521,1,0,19,0,-19
5522,0,0,15,0,-15
5523,0,0,33,0,-33
5524,1,1,856,1710,854
5525,1,1,371,1532,1161
5526,1,0,30,0,-30
5527,1,1,695,1496,801
5528,1,1,581,1334,753
5529,0,0,90,0,-90
5530,1,1,120,1332,1212
5531,0,0,68,0,-68
5532,1,1,204,1389,1185
5533,0,0,98,0,-98
5534,1,0,175,0,-175
5535,1,1,852,1745,893
5536,1,1,59,1273,1214
5537,1,0,39,0,-39
5538,0,0,78,0,-78
5539,0,0,6,0,-6
5540,1,1,1528,1261,-267
5541,1,1,61,1307,1246
5542,1,0,39,0,-39
5543,1,1,490,1432,942
5544,1,0,7,0,-7
5545,1,0,77,0,-77
5546,0,0,95,0,-95
5547,0,0,51,0,-51
5548,0,0,82,0,-82
5549,1,0,10,0,-10
5550,1,0,1,0,-1
5551,1,1,545,1601,1056
5552,1,1,228,1397,1169
5553,0,0,24,0,-24
5554,1,1,152,1404,1252
5555,1,0,85,0,-85
5556,1,1,625,1343,718
5557,0,0,22,0,-22
5558,1,1,544,2508,1964
5559,1,0,20,0,-20
5560,1,1,312,1269,957
5561,0,0,72,0,-72
5562,1,0,19,0,-19
5563,1,0,5,0,-5
5564,1,1,203,1323,1120
5565,0,0,24,0,-24
5566,0,0,51,0,-51
5567,1,1,383,1799,1416
5568,0,0,78,0,-78
5569,1,0,9,0,-9
5570,1,1,344,2214,1870
5571,1,1,296,1715,1419
5572,1,0,178,0,-178
5573,1,1,349,1670,1321
5574,1,1,296,1587,1291
5575,0,0,70,0,-70
5576,0,0,30,0,-30
5577,0,0,70,0,-70
5578,1,0,226,0,-226
5579,1,1,293,1501,1208
5580,1,0,160,0,-160
5581,0,0,65,0,-65
5582,1,1,152,1439,1287
5583,0,0,45,0,-45
5584,0,0,35,0,-35
5585,0,0,32,0,-32
5586,0,0,9,0,-9
5587,1,0,38,0,-38
5588,1,0,206,0,-206
5589,1,1,1165,1494,329
5590,1,1,376,1235,859
5591,1,0,102,0,-102
5592,0,0,1,0,-1
5593,1,1,49,2187,2138
5594,0,0,10,0,-10
5595,1,0,62,0,-62
5596,1,1,260,2000,1740
5597,0,0,13,0,-13
5598,0,0,48,0,-48
5599,0,0,255,0,-255
5600,0,0,12,0,-12
5601,1,0,81,0,-81
5602,1,1,126,1401,1275
5603,0,0,132,0,-132
5604,1,0,8,0,-8
5605,1,1,166,1512,1346
5606,0,0,81,0,-81
5607,1,0,16,0,-16
5608,1,1,142,1313,1171
5609,1,1,778,2201,1423
5610,1,0,96,0,-96
5611,1,1,337,2760,2423
5612,1,1,144,1583,1439
5613,0,0,8,0,-8
5614,0,0,80,0,-80
5615,0,0,39,0,-39
5616,0,0,15,0,-15
5617,1,0,166,0,-166
5618,1,0,132,0,-132
5619,0,0,82,0,-82
5620,0,0,126,0,-126
5621,0,0,1,0,-1
5622,1,1,152,3210,3058
5623,1,0,48,0,-48
5624,1,0,175,0,-175
5625,0,0,183,0,-183
5626,0,0,12,0,-12
5627,1,0,18,0,-18
5628,0,0,20,0,-20
5629,0,0,81,0,-81
5630,1,1,103,1337,1234
5631,0,0,47,0,-47
5632,0,0,90,0,-90
5633,1,0,47,0,-47
5634,1,0,27,0,-27
5635,1,0,179,0,-179
5636,1,1,1259,1236,-23
5637,1,0,11,0,-11
5638,1,0,31,0,-31
5639,0,0,28,0,-28
5640,1,1,617,1402,785
5641,1,0,200,0,-200
5642,1,1,221,1548,1327
5643,0,0,45,0,-45
5644,1,0,2,0,-2
5645,0,0,62,0,-62
5646,1,1,92,1271,1179
5647,1,0,23,0,-23
5648,1,0,13,0,-13
5649,1,0,46,0,-46
5650,1,1,1820,1360,-460
5651,1,0,36,0,-36
5652,1,1,254,1400,1146
5653,1,1,394,1516,1122
5654,1,1,1371,1382,11
5655,1,0,39,0,-39
5656,1,1,275,1513,1238
5657,0,0,10,0,-10
5658,1,0,133,0,-133
5659,1,1,714,1497,783
5660,1,0,118,0,-118
5661,1,0,81,0,-81
5662,1,1,210,1498,1288
5663,1,0,33,0,-33
5664,0,0,64,0,-64
5665,1,0,83,0,-83
5666,1,1,179,1696,1517
5667,0,0,8,0,-8
5668,1,0,46,0,-46
5669,1,0,0,0,0
5670,1,1,1168,1355,187
5671,0,0,32,0,-32
5672,1,1,470,1274,804
5673,0,0,54,0,-54
5674,0,0,1,0,-1
5675,1,1,882,1799,917
5676,1,0,100,0,-100
5677,0,0,20,0,-20
5678,1,0,2,0,-2
5679,1,1,32,4430,4398
5680,1,1,20,1426,1406
5681,0,0,111,0,-111
5682,0,0,18,0,-18
5683,1,1,410,1904,1494
5684,0,0,49,0,-49
5685,0,0,73,0,-73
5686,1,0,131,0,-131
5687,0,0,27,0,-27
5688,0,0,20,0,-20
5689,0,0,50,0,-50
5690,1,0,47,0,-47
5691,1,0,22,0,-22
5692,1,1,56,1339,1283
5693,1,1,93,1413,1320
5694,1,1,497,1244,747
5695,1,1,117,1566,1449
5696,1,0,10,0,-10
5697,1,1,203,1727,1524
5698,0,0,27,0,-27
5699,0,0,73,0,-73
5700,0,0,12,0,-12
5701,1,1,1784,1448,-336
5702,0,0,33,0,-33
5703,1,1,972,1893,921
5704,0,0,30,0,-30
5705,1,0,103,0,-103
5706,0,0,2,0,-2
5707,1,1,119,1373,1254
5708,1,1,608,1263,655
5709,1,1,198,1335,1137
5710,1,1,58,2446,2388
5711,0,0,30,0,-30
5712,1,1,407,1488,1081
5713,1,1,307,1294,987
5714,0,0,43,0,-43
5715,1,0,27,0,-27
5716,1,1,418,4466,4048
5717,1,1,235,1267,1032
5718,0,0,84,0,-84
5719,1,0,130,0,-130
5720,0,0,18,0,-18
5721,1,1,468,1370,902
5722,1,1,787,1877,1090
5723,1,0,27,0,-27
5724,0,0,15,0,-15
5725,1,1,249,1249,1000
5726,0,0,20,0,-20
5727,0,0,48,0,-48
5728,1,1,416,1247,831
5729,0,0,20,0,-20
5730,1,0,90,0,-90
5731,1,0,6,0,-6
5732,1,1,261,1736,1475
5733,1,1,1226,1347,121
5734,1,0,80,0,-80
5735,1,0,41,0,-41
5736,0,0,3,0,-3
5737,1,1,1979,1303,-676
5738,1,0,11,0,-11
5739,1,0,61,0,-61
5740,0,0,291,0,-291
5741,1,0,1,0,-1
5742,1,1,532,1284,752
5743,1,0,49,0,-49
5744,0,0,9,0,-9
5745,1,1,313,2157,1844
5746,1,1,314,1665,1351
5747,0,0,58,0,-58
5748,1,1,23,1356,1333
5749,1,0,62,0,-62
5750,1,1,922,1236,314
5751,1,0,2,0,-2
5752,1,0,64,0,-64
5753,1,1,745,1405,660
5754,1,1,603,2287,1684
5755,0,0,13,0,-13
5756,1,0,8,0,-8
5757,1,1,811,1350,539
5758,1,0,3,0,-3
5759,0,0,16,0,-16
5760,1,1,908,1438,530
5761,0,0,125,0,-125
5762,1,0,29,0,-29
5763,0,0,23,0,-23
5764,1,0,0,0,0
5765,0,0,4,0,-4
5766,1,0,15,0,-15
5767,1,1,189,1794,1605
5768,0,0,131,0,-131
5769,1,0,58,0,-58
5770,1,1,1029,1637,608
5771,1,0,75,0,-75
5772,1,1,423,1523,1100
5773,0,0,2,0,-2
5774,1,0,19,0,-19
5775,1,0,38,0,-38
5776,0,0,14,0,-14
5777,1,1,1091,1437,346
5778,0,0,8,0,-8
5779,1,1,196,1235,1039
5780,1,1,336,1480,1144
5781,1,0,77,0,-77
5782,1,1,15,1892,1877
5783,1,1,437,1955,1518
5784,1,0,23,0,-23
5785,1,0,1,0,-1
5786,1,0,64,0,-64
5787,1,1,800,1625,825
5788,1,1,775,1599,824
5789,0,0,76,0,-76
5790,0,0,175,0,-175
5791,1,0,12,0,-12
5792,0,0,64,0,-64
5793,0,0,8,0,-8
5794,0,0,12,0,-12
5795,1,0,88,0,-88
5796,0,0,39,0,-39
5797,1,0,29,0,-29
5798,1,0,108,0,-108
5799,0,0,57,0,-57
5800,1,0,12,0,-12
5801,1,0,2,0,-2
5802,1,0,81,0,-81
5803,0,0,106,0,-106
5804,1,1,194,1326,1132
5805,1,1,1108,1526,418
5806,1,0,30,0,-30
5807,0,0,26,0,-26
5808,0,0,119,0,-119
5809,1,0,59,0,-59
5810,0,0,30,0,-30
5811,1,1,1101,1602,501
5812,0,0,47,0,-47
5813,1,0,0,0,0
5814,1,0,3,0,-3
5815,1,1,1647,1678,31
5816,1,0,1,0,-1
5817,1,1,182,1478,1296
5818,0,0,14,0,-14
5819,0,0,3,0,-3
5820,0,0,21,0,-21
5821,1,1,24,1523,1499
5822,0,0,49,0,-49
5823,0,0,20,0,-20
5824,1,1,486,3450,2964
5825,1,0,33,0,-33
5826,0,0,49,0,-49
5827,1,0,27,0,-27
5828,0,0,18,0,-18
5829,1,0,8,0,-8
5830,0,0,24,0,-24
5831,0,0,28,0,-28
5832,0,0,7,0,-7
5833,1,0,3,0,-3
5834,1,1,139,1244,1105
5835,0,0,25,0,-25
5836,0,0,9,0,-9
5837,1,1,628,2117,1489
5838,1,0,42,0,-42
5839,1,0,62,0,-62
5840,1,0,46,0,-46
5841,0,0,99,0,-99
5842,0,0,28,0,-28
5843,0,0,2,0,-2
5844,0,0,13,0,-13
5845,0,0,30,0,-30
5846,1,1,148,1239,1091
5847,1,0,58,0,-58
5848,0,0,7,0,-7
5849,0,0,22,0,-22
5850,1,1,517,1817,1300
5851,1,0,32,0,-32
5852,1,0,31,0,-31
5853,0,0,51,0,-51
5854,0,0,30,0,-30
5855,1,0,51,0,-51
5856,1,1,851,1440,589
5857,1,1,648,3315,2667
5858,1,1,115,1271,1156
5859,1,1,269,1567,1298
5860,1,0,2,0,-2
5861,1,1,402,2043,1641
5862,1,0,10,0,-10
5863,0,0,22,0,-22
5864,1,1,733,1400,667
5865,0,0,42,0,-42
5866,1,1,240,1598,1358
5867,0,0,15,0,-15
5868,1,1,1665,1421,-244
5869,0,0,89,0,-89
5870,1,1,887,1589,702
5871,0,0,65,0,-65
5872,1,1,687,1919,1232
5873,1,0,29,0,-29
5874,1,1,73,2741,2668
5875,1,0,3,0,-3
5876,1,0,13,0,-13
5877,0,0,53,0,-53
5878,1,1,1017,1551,534
5879,1,1,42,1437,1395
5880,1,1,432,1297,865
5881,1,1,743,4151,3408
5882,0,0,14,0,-14
5883,1,1,671,1443,772
5884,1,1,174,1770,1596
5885,0,0,98,0,-98
5886,1,1,2417,1374,-1043
5887,0,0,109,0,-109
5888,0,0,6,0,-6
5889,1,1,141,1989,1848
5890,0,0,60,0,-60
5891,0,0,205,0,-205
5892,0,0,31,0,-31
5893,1,1,444,3676,3232
5894,1,1,228,1300,1072
5895,1,0,37,0,-37
5896,0,0,11,0,-11
5897,1,0,11,0,-11
5898,0,0,143,0,-143
5899,0,0,4,0,-4
5900,0,0,22,0,-22
5901,1,0,29,0,-29
5902,0,0,8,0,-8
5903,0,0,28,0,-28
5904,1,1,200,1247,1047
5905,1,1,621,1796,1175
5906,1,1,850,1277,427
5907,1,0,3,0,-3
5908,0,0,16,0,-16
5909,1,0,43,0,-43
5910,1,0,32,0,-32
5911,0,0,11,0,-11
5912,0,0,31,0,-31
5913,0,0,13,0,-13
5914,0,0,14,0,-14
5915,1,0,96,0,-96
5916,1,0,22,0,-22
5917,0,0,14,0,-14
5918,0,0,9,0,-9
5919,1,0,87,0,-87
5920,0,0,33,0,-33
5921,1,1,303,2204,1901
5922,1,1,469,1894,1425
5923,1,1,110,2140,2030
5924,1,1,508,1641,1133
5925,1,1,926,1620,694
5926,0,0,50,0,-50
5927,0,0,44,0,-44
5928,1,1,1825,1610,-215
5929,1,0,26,0,-26
5930,1,0,25,0,-25
5931,1,1,806,1783,977
5932,0,0,24,0,-24
5933,0,0,30,0,-30
5934,0,0,23,0,-23
5935,0,0,4,0,-4
5936,1,1,265,1503,1238
5937,0,0,2,0,-2
5938,1,1,111,1475,1364
5939,1,0,97,0,-97
5940,1,0,48,0,-48
5941,1,1,1346,1372,26
5942,0,0,13,0,-13
5943,0,0,3,0,-3
5944,0,0,38,0,-38
5945,0,0,14,0,-14
5946,0,0,11,0,-11
5947,1,0,43,0,-43
5948,1,1,1040,1257,217
5949,1,0,5,0,-5
5950,1,1,59,1672,1613
5951,1,1,1277,1266,-11
5952,1,0,82,0,-82
5953,0,0,67,0,-67
5954,0,0,77,0,-77
5955,1,0,18,0,-18
5956,1,0,30,0,-30
5957,0,0,21,0,-21
5958,0,0,111,0,-111
5959,1,0,41,0,-41
5960,0,0,2,0,-2
5961,1,1,940,1324,384
5962,1,1,127,1683,1556
5963,1,1,202,1403,1201
5964,1,1,573,1992,1419
5965,0,0,166,0,-166
5966,0,0,2,0,-2
5967,1,0,40,0,-40
5968,0,0,90,0,-90
5969,1,0,21,0,-21
5970,0,0,104,0,-104
5971,1,0,122,0,-122
5972,0,0,18,0,-18
5973,1,0,26,0,-26
5974,1,1,219,1824,1605
5975,0,0,10,0,-10
5976,0,0,47,0,-47
5977,0,0,114,0,-114
5978,0,0,18,0,-18
5979,0,0,37,0,-37
5980,0,0,16,0,-16
5981,1,0,58,0,-58
5982,0,0,20,0,-20
5983,1,1,951,1578,627
5984,1,0,37,0,-37
5985,1,0,9,0,-9
5986,1,0,15,0,-15
5987,1,1,3491,1920,-1571
5988,1,1,1221,1273,52
5989,0,0,15,0,-15
5990,1,0,10,0,-10
5991,0,0,56,0,-56
5992,1,1,577,1568,991
5993,1,1,1032,1598,566
5994,1,1,153,2558,2405
5995,0,0,9,0,-9
5996,0,0,35,0,-35
5997,1,0,28,0,-28
5998,1,0,78,0,-78
5999,0,0,18,0,-18
6000,1,0,131,0,-131
6001,1,1,253,1798,1545
6002,1,0,7,0,-7
6003,1,0,24,0,-24
6004,0,0,42,0,-42
6005,0,0,35,0,-35
6006,1,1,241,1433,1192
6007,0,0,8,0,-8
6008,0,0,13,0,-13
6009,0,0,70,0,-70
6010,0,0,24,0,-24
6011,0,0,99,0,-99
6012,1,1,420,1312,892
6013,1,0,77,0,-77
6014,0,0,21,0,-21
6015,1,1,486,2337,1851
6016,1,0,5,0,-5
6017,1,0,89,0,-89
6018,0,0,32,0,-32
6019,1,0,14,0,-14
6020,0,0,117,0,-117
6021,1,1,1386,1419,33
6022,0,0,19,0,-19
6023,0,0,37,0,-37
6024,1,0,137,0,-137
6025,0,0,73,0,-73
6026,1,0,35,0,-35
6027,1,0,15,0,-15
6028,0,0,202,0,-202
6029,0,0,25,0,-25
6030,1,0,78,0,-78
6031,0,0,47,0,-47
6032,0,0,8,0,-8
6033,1,1,459,1411,952
6034,1,0,28,0,-28
6035,1,0,41,0,-41
6036,1,1,1841,1354,-487
6037,1,1,582,1616,1034
6038,0,0,103,0,-103
6039,0,0,19,0,-19
6040,1,0,38,0,-38
6041,0,0,3,0,-3
6042,1,1,704,1929,1225
6043,1,0,56,0,-56
6044,1,0,32,0,-32
6045,1,0,36,0,-36
6046,1,0,49,0,-49
6047,1,1,489,1541,1052
6048,1,0,8,0,-8
6049,1,0,30,0,-30
6050,1,1,1280,1593,313
6051,1,1,295,1279,984
6052,1,0,45,0,-45
6053,1,1,390,1337,947
6054,1,1,202,1279,1077
6055,0,0,61,0,-61
6056,1,1,318,3219,2901
6057,1,0,20,0,-20
6058,1,0,6,0,-6
6059,1,1,806,4461,3655
6060,1,0,181,0,-181
6061,1,0,174,0,-174
6062,1,0,129,0,-129
6063,0,0,35,0,-35
6064,1,0,180,0,-180
6065,1,0,39,0,-39
6066,1,1,547,1277,730
6067,1,1,633,1391,758
6068,1,0,93,0,-93
6069,1,0,27,0,-27
6070,1,1,733,1679,946
6071,1,0,35,0,-35
6072,1,1,783,1345,562
6073,1,0,3,0,-3
6074,1,1,339,1331,992
6075,1,1,298,2186,1888
6076,0,0,42,0,-42
6077,0,0,85,0,-85
6078,0,0,101,0,-101
6079,1,0,7,0,-7
6080,0,0,100,0,-100
6081,0,0,353,0,-353
6082,1,0,26,0,-26
6083,1,0,15,0,-15
6084,0,0,30,0,-30
6085,1,1,452,1444,992
6086,0,0,34,0,-34
6087,0,0,16,0,-16
6088,0,0,102,0,-102
6089,0,0,63,0,-63
6090,1,1,173,1674,1501
6091,1,1,222,2108,1886
6092,1,1,400,1270,870
6093,0,0,137,0,-137
6094,0,0,42,0,-42
6095,1,1,1116,1357,241
6096,0,0,14,0,-14
6097,1,0,14,0,-14
6098,1,1,1022,1461,439
6099,0,0,129,0,-129
6100,0,0,97,0,-97
6101,1,0,3,0,-3
6102,1,0,9,0,-9
6103,1,0,34,0,-34
6104,1,0,99,0,-99
6105,1,0,4,0,-4
6106,1,0,15,0,-15
6107,1,0,6,0,-6
6108,1,1,147,1276,1129
6109,1,1,533,1440,907
6110,1,1,14,2123,2109
6111,0,0,79,0,-79
6112,1,1,758,2254,1496
6113,1,0,25,0,-25
6114,1,0,108,0,-108
6115,1,0,46,0,-46
6116,0,0,40,0,-40
6117,0,0,48,0,-48
6118,0,0,58,0,-58
6119,1,0,6,0,-6
6120,0,0,147,0,-147
6121,0,0,81,0,-81
6122,1,0,39,0,-39
6123,1,1,138,1854,1716
6124,1,0,90,0,-90
6125,0,0,2,0,-2
6126,1,1,472,1276,804
6127,0,0,15,0,-15
6128,0,0,25,0,-25
6129,1,0,37,0,-37
6130,0,0,6,0,-6
6131,0,0,4,0,-4
6132,1,0,164,0,-164
6133,1,0,246,0,-246
6134,1,0,29,0,-29
6135,1,1,132,1621,1489
6136,0,0,51,0,-51
6137,1,0,85,0,-85
6138,0,0,178,0,-178
6139,1,1,1407,1651,244
6140,1,0,39,0,-39
6141,1,1,464,1286,822
6142,0,0,12,0,-12
6143,1,0,76,0,-76
6144,0,0,37,0,-37
6145,0,0,48,0,-48
6146,1,0,38,0,-38
6147,0,0,10,0,-10
6148,1,1,42,1390,1348
6149,1,1,59,1241,1182
6150,1,0,19,0,-19
6151,1,1,457,1495,1038
6152,1,1,197,1833,1636
6153,0,0,99,0,-99
6154,1,0,17,0,-17
6155,0,0,27,0,-27
6156,0,0,57,0,-57
6157,1,0,21,0,-21
6158,1,0,24,0,-24
6159,0,0,42,0,-42
6160,1,1,788,1263,475
6161,0,0,5,0,-5
6162,0,0,74,0,-74
6163,1,0,33,0,-33
6164,1,0,47,0,-47
6165,0,0,143,0,-143
6166,0,0,40,0,-40
6167,0,0,12,0,-12
6168,1,1,83,1510,1427
6169,1,1,313,3763,3450
6170,1,0,11,0,-11
6171,0,0,36,0,-36
6172,1,0,4,0,-4
6173,1,0,3,0,-3
6174,0,0,41,0,-41
6175,0,0,49,0,-49
6176,0,0,1,0,-1
6177,0,0,19,0,-19
6178,0,0,19,0,-19
6179,1,0,207,0,-207
6180,1,0,57,0,-57
6181,1,0,110,0,-110
6182,1,1,1013,1448,435
6183,0,0,10,0,-10
6184,1,0,40,0,-40
6185,1,0,58,0,-58
6186,0,0,37,0,-37
6187,0,0,47,0,-47
6188,1,0,21,0,-21
6189,1,1,1560,1245,-315
6190,1,1,130,1563,1433
6191,0,0,63,0,-63
6192,0,0,24,0,-24
6193,1,0,55,0,-55
6194,1,0,189,0,-189
6195,1,0,24,0,-24
6196,0,0,15,0,-15
6197,1,1,1682,1384,-298
6198,0,0,19,0,-19
6199,1,1,556,1371,815
6200,1,0,61,0,-61
6201,0,0,35,0,-35
6202,0,0,8,0,-8
6203,1,0,10,0,-10
6204,1,1,198,1505,1307
6205,0,0,12,0,-12
6206,0,0,15,0,-15
6207,0,0,20,0,-20
6208,1,0,7,0,-7
6209,0,0,231,0,-231
6210,1,1,35,1255,1220
6211,0,0,17,0,-17
6212,1,1,392,1351,959
6213,1,1,236,1540,1304
6214,0,0,7,0,-7
6215,0,0,7,0,-7
6216,1,1,44,4150,4106
6217,0,0,60,0,-60
6218,1,0,35,0,-35
6219,1,0,59,0,-59
6220,1,0,35,0,-35
6221,0,0,59,0,-59
6222,0,0,16,0,-16
6223,0,0,167,0,-167
6224,1,0,44,0,-44
6225,1,0,30,0,-30
6226,1,0,8,0,-8
6227,1,1,498,1702,1204
6228,1,1,1874,1389,-485
6229,1,1,198,2167,1969
6230,0,0,23,0,-23
6231,0,0,76,0,-76
6232,1,1,189,1264,1075
6233,1,1,667,1568,901
6234,0,0,72,0,-72
6235,1,0,3,0,-3
6236,1,0,10,0,-10
6237,1,1,715,1499,784
6238,1,0,0,0,0
6239,0,0,150,0,-150
6240,1,1,523,2004,1481
6241,0,0,58,0,-58
6242,1,0,56,0,-56
6243,1,1,679,1262,583
6244,1,1,42,1596,1554
6245,1,1,154,1381,1227
6246,1,1,401,1752,1351
6247,0,0,173,0,-173
6248,0,0,27,0,-27
6249,1,1,502,2702,2200
6250,1,1,495,1474,979
6251,0,0,29,0,-29
6252,1,1,209,2196,1987
6253,1,0,14,0,-14
6254,1,0,32,0,-32
6255,0,0,37,0,-37
6256,1,1,211,1650,1439
6257,1,0,93,0,-93
6258,1,1,774,1380,606
6259,1,0,7,0,-7
6260,1,1,662,1491,829
6261,1,1,368,1645,1277
6262,1,0,101,0,-101
6263,1,1,508,1419,911
6264,1,0,31,0,-31
6265,0,0,47,0,-47
6266,0,0,13,0,-13
6267,0,0,9,0,-9
6268,1,0,66,0,-66
6269,0,0,18,0,-18
6270,1,1,496,2114,1618
6271,1,1,383,1323,940
6272,1,1,230,1629,1399
6273,1,1,427,1289,862
6274,1,0,39,0,-39
6275,1,0,36,0,-36
6276,1,0,24,0,-24
6277,1,0,73,0,-73
6278,0,0,1,0,-1
6279,1,1,222,1660,1438
6280,1,1,207,1293,1086
6281,1,0,9,0,-9
6282,1,1,199,2673,2474
6283,0,0,82,0,-82
6284,0,0,5,0,-5
6285,1,0,31,0,-31
6286,1,0,19,0,-19
6287,1,1,1388,1506,118
6288,1,1,375,4563,4188
6289,1,1,518,1585,1067
6290,1,1,73,1340,1267
6291,0,0,21,0,-21
6292,0,0,44,0,-44
6293,1,0,45,0,-45
6294,1,1,66,1270,1204
6295,1,0,6,0,-6
6296,1,1,558,1543,985
6297,0,0,145,0,-145
6298,1,1,216,1505,1289
6299,1,0,85,0,-85
6300,1,0,5,0,-5
6301,0,0,114,0,-114
6302,0,0,99,0,-99
6303,0,0,17,0,-17
6304,1,0,5,0,-5
6305,1,0,1,0,-1
6306,0,0,56,0,-56
6307,0,0,38,0,-38
6308,1,1,183,1312,1129
6309,1,0,42,0,-42
6310,1,0,63,0,-63
6311,0,0,35,0,-35
6312,1,0,2,0,-2
6313,1,1,106,1804,1698
6314,1,0,5,0,-5
6315,0,0,40,0,-40
6316,1,0,4,0,-4
6317,1,1,1211,1488,277
6318,1,1,216,2187,1971
6319,1,0,69,0,-69
6320,0,0,43,0,-43
6321,1,0,69,0,-69
6322,1,0,39,0,-39
6323,0,0,124,0,-124
6324,1,1,535,1701,1166
6325,1,0,73,0,-73
6326,1,1,121,2435,2314
6327,1,1,1675,1450,-225
6328,1,0,6,0,-6
6329,1,1,8,1462,1454
6330,1,1,164,1530,1366
6331,0,0,51,0,-51
6332,0,0,22,0,-22
6333,0,0,92,0,-92
6334,0,0,3,0,-3
6335,1,1,447,1382,935
6336,1,0,97,0,-97
6337,0,0,37,0,-37
6338,1,1,33,1892,1859
6339,0,0,20,0,-20
6340,1,1,336,2145,1809
6341,1,0,15,0,-15
6342,0,0,35,0,-35
6343,1,0,146,0,-146
6344,0,0,82,0,-82
6345,0,0,32,0,-32
6346,1,1,1798,1702,-96
6347,1,1,323,1292,969
6348,0,0,32,0,-32
6349,1,1,972,2343,1371
6350,0,0,13,0,-13
6351,0,0,50,0,-50
6352,1,1,123,1416,1293
6353,1,0,115,0,-115
6354,1,0,2,0,-2
6355,0,0,6,0,-6
6356,1,0,64,0,-64
6357,1,1,562,1697,1135
6358,1,0,18,0,-18
6359,1,1,861,1380,519
6360,1,1,363,2084,1721
6361,0,0,46,0,-46
6362,1,1,2409,1341,-1068
6363,1,1,171,2129,1958
6364,0,0,9,0,-9
6365,0,0,42,0,-42
6366,1,0,133,0,-133
6367,0,0,17,0,-17
6368,0,0,11,0,-11
6369,1,0,138,0,-138
6370,1,0,98,0,-98
6371,0,0,16,0,-16
6372,0,0,29,0,-29
6373,1,1,538,1748,1210
6374,1,0,37,0,-37
6375,1,1,897,2124,1227
6376,0,0,14,0,-14
6377,1,1,1225,1457,232
6378,0,0,88,0,-88
6379,0,0,2,0,-2
6380,0,0,9,0,-9
6381,1,1,329,1768,1439
6382,0,0,9,0,-9
6383,1,0,151,0,-151
6384,1,1,1053,2813,1760
6385,0,0,125,0,-125
6386,1,0,42,0,-42
6387,0,0,22,0,-22
6388,1,1,628,1261,633
6389,0,0,62,0,-62
6390,1,0,79,0,-79
6391,0,0,27,0,-27
6392,1,0,8,0,-8
6393,0,0,207,0,-207
6394,0,0,53,0,-53
6395,1,1,276,1621,1345
6396,1,1,340,1604,1264
6397,0,0,93,0,-93
6398,0,0,12,0,-12
6399,1,1,1216,2350,1134
6400,1,1,496,1867,1371
6401,0,0,70,0,-70
6402,1,1,392,1630,1238
6403,1,0,160,0,-160
6404,0,0,68,0,-68
6405,0,0,23,0,-23
6406,0,0,1,0,-1
6407,0,0,117,0,-117
6408,0,0,15,0,-15
6409,1,1,423,1767,1344
6410,0,0,10,0,-10
6411,1,1,790,1642,852
6412,1,1,55,1758,1703
6413,0,0,17,0,-17
6414,1,0,96,0,-96
6415,1,0,20,0,-20
6416,1,0,31,0,-31
6417,1,0,114,0,-114
6418,1,1,249,1327,1078
6419,1,1,59,1240,1181
6420,0,0,85,0,-85
6421,1,0,12,0,-12
6422,1,1,47,1490,1443
6423,1,1,150,1700,1550
6424,0,0,59,0,-59
6425,0,0,27,0,-27
6426,1,1,508,1649,1141
6427,0,0,21,0,-21
6428,0,0,100,0,-100
6429,1,0,64,0,-64
6430,0,0,45,0,-45
6431,1,1,1202,1619,417
6432,1,1,302,1918,1616
6433,1,0,53,0,-53
6434,0,0,23,0,-23
6435,1,1,854,1367,513
6436,1,0,24,0,-24
6437,1,1,705,1528,823
6438,1,1,148,4030,3882
6439,0,0,65,0,-65
6440,0,0,15,0,-15
6441,0,0,153,0,-153
6442,1,0,88,0,-88
6443,1,1,270,1251,981
6444,1,0,12,0,-12
6445,1,1,95,1428,1333
6446,0,0,37,0,-37
6447,1,0,67,0,-67
6448,0,0,44,0,-44
6449,1,0,53,0,-53
6450,0,0,23,0,-23
6451,0,0,138,0,-138
6452,1,0,289,0,-289
6453,0,0,75,0,-75
6454,1,1,923,1580,657
6455,0,0,148,0,-148
6456,0,0,74,0,-74
6457,0,0,21,0,-21
6458,0,0,10,0,-10
6459,0,0,21,0,-21
6460,1,1,1537,1282,-255
6461,1,0,110,0,-110
6462,1,0,11,0,-11
6463,1,0,233,0,-233
6464,1,1,576,1258,682
6465,0,0,3,0,-3
6466,0,0,41,0,-41
6467,1,1,84,1323,1239
6468,1,1,416,1369,953
6469,1,1,635,1243,608
6470,1,1,828,1297,469
6471,1,1,90,5397,5307
6472,0,0,3,0,-3
6473,1,0,30,0,-30
6474,1,1,128,1375,1247
6475,1,1,1506,1250,-256
6476,0,0,43,0,-43
6477,1,1,231,2140,1909
6478,0,0,30,0,-30
6479,1,0,78,0,-78
6480,0,0,34,0,-34
6481,0,0,39,0,-39
6482,1,0,21,0,-21
6483,0,0,194,0,-194
6484,1,0,28,0,-28
6485,1,0,27,0,-27
6486,1,0,82,0,-82
6487,0,0,40,0,-40
6488,1,0,0,0,0
6489,1,1,739,1595,856
6490,0,0,48,0,-48
6491,1,0,71,0,-71
6492,1,0,67,0,-67
6493,0,0,21,0,-21
6494,1,0,194,0,-194
6495,0,0,111,0,-111
6496,1,0,151,0,-151
6497,0,0,101,0,-101
6498,1,0,44,0,-44
6499,0,0,38,0,-38
6500,1,1,831,1656,825
6501,1,0,41,0,-41
6502,1,1,248,1333,1085
6503,1,1,277,2156,1879
6504,1,1,486,1920,1434
6505,1,1,75,1408,1333
6506,0,0,21,0,-21
6507,0,0,133,0,-133
6508,0,0,32,0,-32
6509,0,0,2,0,-2
6510,0,0,14,0,-14
6511,1,1,700,1272,572
6512,0,0,17,0,-17
6513,1,0,22,0,-22
6514,1,0,4,0,-4
6515,0,0,20,0,-20
6516,0,0,83,0,-83
6517,1,1,897,1585,688
6518,1,0,60,0,-60
6519,0,0,27,0,-27
6520,0,0,46,0,-46
6521,1,0,21,0,-21
6522,1,1,309,1473,1164
6523,0,0,0,0,0
6524,1,0,1,0,-1
6525,1,0,5,0,-5
6526,0,0,50,0,-50
6527,1,1,595,1334,739
6528,1,1,501,1469,968
6529,0,0,31,0,-31
6530,0,0,45,0,-45
6531,0,0,80,0,-80
6532,0,0,78,0,-78
6533,1,0,100,0,-100
6534,1,1,1333,1434,101
6535,0,0,18,0,-18
6536,1,0,3,0,-3
6537,1,1,90,1648,1558
6538,0,0,70,0,-70
6539,1,0,14,0,-14
6540,0,0,37,0,-37
6541,0,0,57,0,-57
6542,0,0,29,0,-29
6543,0,0,84,0,-84
6544,1,0,11,0,-11
6545,1,1,786,1703,917
6546,1,1,371,1330,959
6547,0,0,4,0,-4
6548,1,0,26,0,-26
6549,1,0,5,0,-5
6550,1,0,1,0,-1
6551,1,1,377,1299,922
6552,0,0,36,0,-36
6553,1,0,26,0,-26
6554,0,0,10,0,-10
6555,0,0,75,0,-75
6556,0,0,23,0,-23
6557,0,0,56,0,-56
6558,1,1,212,1247,1035
6559,1,1,81,1578,1497
6560,0,0,58,0,-58
6561,1,1,1696,1640,-56
6562,0,0,70,0,-70
6563,0,0,17,0,-17
6564,1,1,114,1435,1321
6565,1,0,4,0,-4
6566,0,0,8,0,-8
6567,1,1,138,1266,1128
6568,1,1,343,3630,3287
6569,1,1,251,1377,1126
6570,0,0,3,0,-3
6571,1,0,36,0,-36
6572,1,0,47,0,-47
6573,1,1,1539,2224,685
6574,1,1,380,1997,1617
6575,1,1,43,1281,1238
6576,1,0,27,0,-27
6577,0,0,84,0,-84
6578,1,1,215,1887,1672
6579,1,1,648,1740,1092
6580,0,0,43,0,-43
6581,1,1,694,1418,724
6582,0,0,133,0,-133
6583,1,0,133,0,-133
6584,1,0,4,0,-4
6585,1,0,7,0,-7
6586,1,0,82,0,-82
6587,0,0,183,0,-183
6588,1,0,92,0,-92
6589,1,1,169,1514,1345
6590,1,1,352,1610,1258
6591,1,0,50,0,-50
6592,0,0,5,0,-5
6593,0,0,137,0,-137
6594,1,1,1153,1584,431
6595,1,1,302,1373,1071
6596,1,1,746,1695,949
6597,0,0,23,0,-23
6598,1,0,49,0,-49
6599,0,0,3,0,-3
6600,1,1,360,1792,1432
6601,1,0,73,0,-73
6602,1,0,46,0,-46
6603,1,1,365,1249,884
6604,0,0,6,0,-6
6605,0,0,16,0,-16
6606,0,0,4,0,-4
6607,1,0,180,0,-180
6608,0,0,329,0,-329
6609,1,1,103,1939,1836
6610,1,1,95,1276,1181
6611,1,0,61,0,-61
6612,0,0,27,0,-27
6613,1,1,168,1496,1328
6614,1,0,19,0,-19
6615,0,0,42,0,-42
6616,0,0,35,0,-35
6617,0,0,18,0,-18
6618,0,0,85,0,-85
6619,1,1,61,1658,1597
6620,1,1,111,1764,1653
6621,1,1,459,1303,844
6622,1,1,741,1771,1030
6623,1,0,37,0,-37
6624,0,0,264,0,-264
6625,1,1,282,1539,1257
6626,0,0,11,0,-11
6627,0,0,37,0,-37
6628,0,0,20,0,-20
6629,1,0,17,0,-17
6630,0,0,5,0,-5
6631,0,0,4,0,-4
6632,1,0,13,0,-13
6633,0,0,40,0,-40
6634,1,1,258,1371,1113
6635,1,1,1959,1495,-464
6636,0,0,54,0,-54
6637,1,0,192,0,-192
6638,0,0,8,0,-8
6639,1,1,290,1308,1018
6640,1,1,1124,1277,153
6641,0,0,4,0,-4
6642,1,0,170,0,-170
6643,1,1,230,1274,1044
6644,1,1,132,1248,1116
6645,1,0,16,0,-16
6646,0,0,44,0,-44
6647,1,1,374,1400,1026
6648,0,0,47,0,-47
6649,0,0,117,0,-117
6650,0,0,45,0,-45
6651,1,1,397,1367,970
6652,1,1,122,1565,1443
6653,0,0,19,0,-19
6654,1,1,666,1649,983
6655,1,0,34,0,-34
6656,0,0,16,0,-16
6657,1,0,49,0,-49
6658,1,1,323,1434,1111
6659,1,1,107,3798,3691
6660,1,0,3,0,-3
6661,1,1,465,2321,1856
6662,1,1,452,1831,1379
6663,0,0,52,0,-52
6664,0,0,127,0,-127
6665,1,0,81,0,-81
6666,1,1,433,1529,1096
6667,1,0,19,0,-19
6668,0,0,138,0,-138
6669,1,1,137,1291,1154
6670,0,0,55,0,-55
6671,0,0,39,0,-39
6672,1,0,2,0,-2
6673,0,0,18,0,-18
6674,1,1,687,1287,600
6675,0,0,24,0,-24
6676,1,1,905,2216,1311
6677,0,0,159,0,-159
6678,1,1,266,4865,4599
6679,1,1,229,1255,1026
6680,1,0,15,0,-15
6681,0,0,91,0,-91
6682,0,0,12,0,-12
6683,1,1,714,1251,537
6684,0,0,11,0,-11
6685,1,0,114,0,-114
6686,0,0,6,0,-6
6687,1,0,40,0,-40
6688,1,1,1465,1316,-149
6689,0,0,85,0,-85
6690,1,0,57,0,-57
6691,0,0,13,0,-13
6692,0,0,82,0,-82
6693,0,0,72,0,-72
6694,0,0,32,0,-32
6695,0,0,88,0,-88
6696,0,0,7,0,-7
6697,1,1,361,4199,3838
6698,1,0,56,0,-56
6699,0,0,76,0,-76
6700,1,0,12,0,-12
6701,1,1,299,1923,1624
6702,0,0,41,0,-41
6703,0,0,93,0,-93
6704,0,0,12,0,-12
6705,1,0,77,0,-77
6706,1,0,7,0,-7
6707,1,1,2226,3193,967
6708,1,0,21,0,-21
6709,1,0,19,0,-19
6710,0,0,17,0,-17
6711,0,0,51,0,-51
6712,1,0,74,0,-74
6713,1,0,10,0,-10
6714,1,0,134,0,-134
6715,0,0,15,0,-15
6716,1,0,2,0,-2
6717,1,1,570,1469,899
6718,1,1,373,1860,1487
6719,1,0,161,0,-161
6720,0,0,99,0,-99
6721,1,0,37,0,-37
6722,1,0,26,0,-26
6723,1,0,8,0,-8
6724,1,0,2,0,-2
6725,1,0,64,0,-64
6726,1,1,706,1616,910
6727,0,0,44,0,-44
6728,0,0,36,0,-36
6729,0,0,66,0,-66
6730,1,1,123,1305,1182
6731,1,1,370,1323,953
6732,0,0,14,0,-14
6733,0,0,33,0,-33
6734,1,1,83,2452,2369
6735,1,0,32,0,-32
6736,1,1,1032,2384,1352
6737,1,0,1,0,-1
6738,0,0,16,0,-16
6739,0,0,97,0,-97
6740,0,0,6,0,-6
6741,1,0,20,0,-20
6742,1,1,508,1636,1128
6743,0,0,72,0,-72
6744,1,0,122,0,-122
6745,1,1,598,1404,806
6746,1,1,52,1268,1216
6747,0,0,18,0,-18
6748,0,0,29,0,-29
6749,1,0,29,0,-29
6750,1,0,11,0,-11
6751,0,0,61,0,-61
6752,1,0,37,0,-37
6753,1,1,9,1525,1516
6754,0,0,31,0,-31
6755,1,0,22,0,-22
6756,1,1,580,1879,1299
6757,1,0,13,0,-13
6758,1,1,1253,1661,408
6759,1,1,451,1761,1310
6760,1,1,823,1730,907
6761,1,1,634,1274,640
6762,1,1,452,1638,1186
6763,0,0,70,0,-70
6764,1,1,784,1636,852
6765,1,1,1230,1703,473
6766,0,0,9,0,-9
6767,0,0,40,0,-40
6768,1,0,23,0,-23
6769,1,0,9,0,-9
6770,1,1,949,1417,468
6771,1,0,122,0,-122
6772,0,0,22,0,-22
6773,1,0,30,0,-30
6774,1,0,174,0,-174
6775,0,0,85,0,-85
6776,1,1,1036,1264,228
6777,0,0,80,0,-80
6778,1,1,907,1446,539
6779,1,0,30,0,-30
6780,1,1,710,1519,809
6781,0,0,72,0,-72
6782,0,0,61,0,-61
6783,1,0,32,0,-32
6784,1,0,46,0,-46
6785,0,0,45,0,-45
6786,0,0,121,0,-121
6787,0,0,19,0,-19
6788,0,0,24,0,-24
6789,1,0,48,0,-48
6790,0,0,50,0,-50
6791,0,0,3,0,-3
6792,0,0,2,0,-2
6793,0,0,96,0,-96
6794,1,0,112,0,-112
6795,0,0,58,0,-58
6796,1,0,23,0,-23
6797,1,0,33,0,-33
6798,1,0,85,0,-85
6799,1,0,170,0,-170
6800,0,0,25,0,-25
6801,1,1,350,1499,1149
6802,0,0,78,0,-78
6803,1,1,1639,1432,-207
6804,0,0,93,0,-93
6805,1,0,2,0,-2
6806,1,1,161,1679,1518
6807,1,1,553,1725,1172
6808,0,0,2,0,-2
6809,0,0,30,0,-30
6810,1,0,22,0,-22
6811,1,0,57,0,-57
6812,1,1,577,1740,1163
6813,0,0,149,0,-149
6814,1,0,30,0,-30
6815,1,1,986,1641,655
6816,0,0,138,0,-138
6817,1,1,847,1550,703
6818,0,0,23,0,-23
6819,0,0,24,0,-24
6820,1,0,112,0,-112
6821,1,0,54,0,-54
6822,1,1,1809,1770,-39
6823,1,1,2803,1967,-836
6824,1,0,19,0,-19
6825,1,0,60,0,-60
6826,1,0,28,0,-28
6827,1,1,256,1405,1149
6828,0,0,1,0,-1
6829,1,1,1203,1278,75
6830,1,1,605,1331,726
6831,0,0,12,0,-12
6832,0,0,8,0,-8
6833,1,1,51,1603,1552
6834,0,0,27,0,-27
6835,1,0,8,0,-8
6836,0,0,128,0,-128
6837,1,1,829,1749,920
6838,1,0,44,0,-44
6839,1,0,5,0,-5
6840,1,1,297,1380,1083
6841,1,0,2,0,-2
6842,0,0,11,0,-11
6843,1,0,14,0,-14
6844,1,0,21,0,-21
6845,1,0,23,0,-23
6846,1,1,501,1562,1061
6847,0,0,4,0,-4
6848,1,1,226,1626,1400
6849,1,0,66,0,-66
6850,1,1,411,1326,915
6851,0,0,130,0,-130
6852,1,1,451,1524,1073
6853,0,0,73,0,-73
6854,1,0,11,0,-11
6855,0,0,47,0,-47
6856,1,0,28,0,-28
6857,1,1,300,2809,2509
6858,1,0,21,0,-21
6859,1,1,262,1359,1097
6860,0,0,32,0,-32
6861,0,0,119,0,-119
6862,1,1,192,1471,1279
6863,0,0,49,0,-49
6864,0,0,164,0,-164
6865,0,0,0,0,0
6866,1,0,14,0,-14
6867,0,0,178,0,-178
6868,0,0,1,0,-1
6869,0,0,68,0,-68
6870,1,0,29,0,-29
6871,1,0,74,0,-74
6872,1,0,5,0,-5
6873,1,0,97,0,-97
6874,0,0,96,0,-96
6875,1,1,52,1476,1424
6876,1,1,636,1520,884
6877,0,0,39,0,-39
6878,1,1,409,2118,1709
6879,1,0,73,0,-73
6880,1,1,248,2153,1905
6881,1,1,169,1238,1069
6882,1,0,5,0,-5
6883,1,0,125,0,-125
6884,1,0,43,0,-43
6885,0,0,21,0,-21
6886,1,1,45,2221,2176
6887,1,1,206,1378,1172
6888,0,0,12,0,-12
6889,1,0,57,0,-57
6890,0,0,4,0,-4
6891,1,0,12,0,-12
6892,1,1,9,1528,1519
6893,1,0,66,0,-66
6894,1,0,50,0,-50
6895,1,1,61,1288,1227
6896,0,0,62,0,-62
6897,0,0,147,0,-147
6898,1,1,302,1574,1272
6899,1,0,18,0,-18
6900,0,0,229,0,-229
6901,0,0,7,0,-7
6902,0,0,50,0,-50
6903,1,1,34,1384,1350
6904,1,0,27,0,-27
6905,0,0,47,0,-47
6906,0,0,22,0,-22
6907,1,1,218,2442,2224
6908,0,0,18,0,-18
6909,1,1,229,1420,1191
6910,1,0,12,0,-12
6911,0,0,52,0,-52
6912,0,0,90,0,-90
6913,0,0,60,0,-60
6914,0,0,8,0,-8
6915,0,0,63,0,-63
6916,0,0,155,0,-155
6917,1,0,102,0,-102
6918,1,1,233,1542,1309
6919,1,1,371,3166,2795
6920,1,1,872,1244,372
6921,1,1,566,1333,767
6922,0,0,3,0,-3
6923,1,0,35,0,-35
6924,1,1,1362,1279,-83
6925,0,0,74,0,-74
6926,0,0,182,0,-182
6927,1,0,43,0,-43
6928,0,0,70,0,-70
6929,0,0,90,0,-90
6930,0,0,54,0,-54
6931,1,1,190,1377,1187
6932,0,0,146,0,-146
6933,1,1,629,1412,783
6934,1,0,23,0,-23
6935,1,1,96,2222,2126
6936,0,0,31,0,-31
6937,0,0,53,0,-53
6938,1,0,10,0,-10
6939,0,0,1,0,-1
6940,1,0,22,0,-22
6941,0,0,62,0,-62
6942,1,0,124,0,-124
6943,1,0,10,0,-10
6944,0,0,54,0,-54
6945,1,0,26,0,-26
6946,0,0,3,0,-3
6947,0,0,2,0,-2
6948,0,0,7,0,-7
6949,1,0,27,0,-27
6950,0,0,28,0,-28
6951,1,0,29,0,-29
6952,1,0,12,0,-12
6953,0,0,7,0,-7
6954,0,0,23,0,-23
6955,0,0,2,0,-2
6956,0,0,72,0,-72
6957,1,1,465,1548,1083
6958,1,0,3,0,-3
6959,1,1,787,1637,850
6960,1,1,87,1402,1315
6961,1,0,29,0,-29
6962,1,1,423,1249,826
6963,1,1,107,1375,1268
6964,0,0,50,0,-50
6965,0,0,18,0,-18
6966,1,0,56,0,-56
6967,0,0,101,0,-101
6968,1,1,222,1339,1117
6969,1,1,245,1303,1058
6970,1,0,31,0,-31
6971,1,0,22,0,-22
6972,0,0,6,0,-6
6973,0,0,130,0,-130
6974,1,1,377,1338,961
6975,0,0,191,0,-191
6976,1,1,358,1411,1053
6977,0,0,138,0,-138
6978,1,1,745,1490,745
6979,0,0,108,0,-108
6980,0,0,21,0,-21
6981,1,1,85,1627,1542
6982,0,0,17,0,-17
6983,0,0,95,0,-95
6984,0,0,54,0,-54
6985,1,0,62,0,-62
6986,1,1,501,1580,1079
6987,1,1,553,1269,716
6988,1,1,374,1615,1241
6989,1,1,110,1623,1513
6990,1,1,198,1356,1158
6991,1,1,225,1321,1096
6992,0,0,16,0,-16
6993,1,0,29,0,-29
6994,0,0,282,0,-282
6995,0,0,7,0,-7
6996,1,0,23,0,-23
6997,0,0,25,0,-25
6998,1,1,258,3091,2833
6999,1,1,1003,1837,834
7000,0,0,46,0,-46
7001,1,1,160,1277,1117
7002,0,0,12,0,-12
7003,1,0,2,0,-2
7004,1,0,16,0,-16
7005,0,0,126,0,-126
7006,1,1,402,2871,2469
7007,1,0,69,0,-69
7008,0,0,43,0,-43
7009,0,0,36,0,-36
7010,1,1,264,1617,1353
7011,1,0,50,0,-50
7012,1,0,16,0,-16
7013,1,0,75,0,-75
7014,1,0,55,0,-55
7015,0,0,3,0,-3
7016,1,0,63,0,-63
7017,0,0,107,0,-107
7018,1,1,474,1687,1213
7019,1,0,4,0,-4
7020,1,0,15,0,-15
7021,1,0,21,0,-21
7022,1,1,153,1863,1710
7023,1,0,103,0,-103
7024,0,0,90,0,-90
7025,1,0,50,0,-50
7026,0,0,15,0,-15
7027,0,0,49,0,-49
7028,1,0,63,0,-63
7029,0,0,52,0,-52
7030,0,0,56,0,-56
7031,1,1,212,1449,1237
7032,1,0,82,0,-82
7033,0,0,4,0,-4
7034,1,1,850,1239,389
7035,0,0,41,0,-41
7036,0,0,19,0,-19
7037,0,0,18,0,-18
7038,0,0,1,0,-1
7039,1,0,38,0,-38
7040,1,0,30,0,-30
7041,0,0,7,0,-7
7042,1,1,322,1615,1293
7043,0,0,9,0,-9
7044,0,0,6,0,-6
7045,1,1,1069,1899,830
7046,1,1,719,1396,677
7047,1,0,0,0,0
7048,1,0,63,0,-63
7049,0,0,15,0,-15
7050,0,0,50,0,-50
7051,0,0,1,0,-1
7052,1,0,157,0,-157
7053,1,1,106,1589,1483
7054,0,0,10,0,-10
7055,0,0,73,0,-73
7056,1,0,19,0,-19
7057,1,1,111,1887,1776
7058,0,0,19,0,-19
7059,1,0,9,0,-9
7060,1,1,128,1468,1340
7061,0,0,227,0,-227
7062,1,1,475,1714,1239
7063,1,1,940,1381,441
7064,1,0,27,0,-27
7065,1,1,330,1867,1537
7066,0,0,278,0,-278
7067,1,1,111,1282,1171
7068,1,0,31,0,-31
7069,0,0,32,0,-32
7070,1,1,201,1408,1207
7071,1,1,183,1310,1127
7072,0,0,69,0,-69
7073,1,0,0,0,0
7074,1,1,703,1387,684
7075,0,0,5,0,-5
7076,1,0,2,0,-2
7077,1,0,37,0,-37
7078,0,0,88,0,-88
7079,1,0,46,0,-46
7080,0,0,3,0,-3
7081,1,0,22,0,-22
7082,1,0,5,0,-5
7083,1,0,19,0,-19
7084,1,1,181,1633,1452
7085,0,0,78,0,-78
7086,1,1,144,2524,2380
7087,1,1,966,2948,1982
7088,1,0,14,0,-14
7089,1,1,593,1768,1175
7090,1,1,495,1297,802
7091,1,0,24,0,-24
7092,1,1,146,1328,1182
7093,1,1,343,2268,1925
7094,0,0,78,0,-78
7095,1,0,53,0,-53
7096,1,1,295,3578,3283
7097,0,0,21,0,-21
7098,0,0,39,0,-39
7099,0,0,146,0,-146
7100,0,0,67,0,-67
7101,1,0,64,0,-64
7102,1,0,116,0,-116
7103,0,0,12,0,-12
7104,0,0,30,0,-30
7105,1,0,153,0,-153
7106,1,0,178,0,-178
7107,1,1,403,1404,1001
7108,0,0,36,0,-36
7109,1,1,536,1614,1078
7110,1,1,617,1955,1338
7111,0,0,22,0,-22
7112,0,0,91,0,-91
7113,0,0,2,0,-2
7114,0,0,4,0,-4
7115,1,0,88,0,-88
7116,1,0,8,0,-8
7117,1,1,109,1267,1158
7118,1,1,184,1769,1585
7119,1,0,3,0,-3
7120,0,0,61,0,-61
7121,0,0,209,0,-209
7122,0,0,7,0,-7
7123,1,0,24,0,-24
7124,1,1,149,1241,1092
7125,0,0,24,0,-24
7126,1,1,217,1297,1080
7127,1,1,236,1351,1115
7128,0,0,0,0,0
7129,0,0,171,0,-171
7130,0,0,39,0,-39
7131,1,1,112,1677,1565
7132,1,1,270,1267,997
7133,1,0,130,0,-130
7134,1,1,1594,1523,-71
7135,1,1,758,1430,672
7136,1,1,93,1412,1319
7137,1,1,297,1603,1306
7138,0,0,1,0,-1
7139,1,1,318,1300,982
7140,1,0,23,0,-23
7141,0,0,56,0,-56
7142,1,1,733,2186,1453
7143,1,1,915,1409,494
7144,0,0,22,0,-22
7145,1,0,3,0,-3
7146,1,1,284,1805,1521
7147,1,1,276,2017,1741
7148,1,1,62,1260,1198
7149,0,0,81,0,-81
7150,1,1,100,2249,2149
7151,1,0,70,0,-70
7152,0,0,72,0,-72
7153,1,1,1357,1436,79
7154,0,0,49,0,-49
7155,1,1,973,1453,480
7156,1,1,955,1289,334
7157,0,0,40,0,-40
7158,1,1,280,1558,1278
7159,1,1,337,1261,924
7160,1,1,343,1604,1261
7161,1,1,1108,1889,781
7162,1,1,1105,1630,525
7163,1,1,1280,1304,24
7164,0,0,20,0,-20
7165,1,0,58,0,-58
7166,0,0,20,0,-20
7167,1,1,135,1945,1810
7168,1,0,74,0,-74
7169,1,0,56,0,-56
7170,0,0,49,0,-49
7171,1,0,100,0,-100
7172,1,0,117,0,-117
7173,1,0,45,0,-45
7174,0,0,32,0,-32
7175,0,0,60,0,-60
7176,0,0,3,0,-3
7177,0,0,0,0,0
7178,1,1,70,4307,4237
7179,0,0,76,0,-76
7180,1,1,490,1428,938
7181,0,0,15,0,-15
7182,1,1,867,1269,402
7183,1,1,15,1701,1686
7184,1,0,84,0,-84
7185,0,0,8,0,-8
7186,0,0,14,0,-14
7187,0,0,37,0,-37
7188,0,0,53,0,-53
7189,1,0,38,0,-38
7190,0,0,2,0,-2
7191,0,0,56,0,-56
7192,1,1,755,1857,1102
7193,0,0,9,0,-9
7194,1,1,122,1854,1732
7195,0,0,33,0,-33
7196,1,0,9,0,-9
7197,1,1,102,1562,1460
7198,1,1,235,1297,1062
7199,0,0,49,0,-49
7200,0,0,26,0,-26
7201,1,1,114,1480,1366
7202,0,0,145,0,-145
7203,1,1,237,1572,1335
7204,1,0,12,0,-12
7205,0,0,0,0,0
7206,0,0,4,0,-4
7207,0,0,114,0,-114
7208,1,0,39,0,-39
7209,0,0,84,0,-84
7210,1,0,22,0,-22
7211,1,0,11,0,-11
7212,1,1,635,1292,657
7213,1,0,1,0,-1
7214,1,0,4,0,-4
7215,1,1,921,1258,337
7216,0,0,75,0,-75
7217,1,0,34,0,-34
7218,1,0,4,0,-4
7219,0,0,37,0,-37
7220,1,1,1580,1271,-309
7221,0,0,22,0,-22
7222,0,0,208,0,-208
7223,0,0,1,0,-1
7224,1,0,11,0,-11
7225,1,0,70,0,-70
7226,1,1,384,1329,945
7227,1,0,30,0,-30
7228,0,0,30,0,-30
7229,1,1,206,1689,1483
7230,1,1,390,1402,1012
7231,1,0,24,0,-24
7232,1,0,130,0,-130
7233,1,1,332,1690,1358
7234,1,1,302,1670,1368
7235,0,0,25,0,-25
7236,1,1,331,1350,1019
7237,1,1,235,1569,1334
7238,1,1,756,1910,1154
7239,0,0,39,0,-39
7240,0,0,1,0,-1
7241,1,0,110,0,-110
7242,1,0,34,0,-34
7243,1,0,6,0,-6
7244,0,0,50,0,-50
7245,0,0,64,0,-64
7246,0,0,26,0,-26
7247,0,0,12,0,-12
7248,0,0,71,0,-71
7249,1,0,31,0,-31
7250,1,0,97,0,-97
7251,1,0,2,0,-2
7252,0,0,7,0,-7
7253,1,0,10,0,-10
7254,0,0,42,0,-42
7255,0,0,55,0,-55
7256,1,0,40,0,-40
7257,1,0,24,0,-24
7258,1,0,39,0,-39
7259,1,0,20,0,-20
7260,0,0,125,0,-125
7261,1,1,487,2197,1710
7262,1,1,907,1242,335
7263,1,1,328,1293,965
7264,0,0,71,0,-71
7265,1,0,105,0,-105
7266,0,0,5,0,-5
7267,1,0,17,0,-17
7268,0,0,7,0,-7
7269,1,0,52,0,-52
7270,1,1,337,1396,1059
7271,0,0,52,0,-52
7272,0,0,29,0,-29
7273,1,1,118,1569,1451
7274,0,0,34,0,-34
7275,1,1,1523,1432,-91
7276,1,1,556,2702,2146
7277,1,1,258,1295,1037
7278,1,1,119,1622,1503
7279,1,1,1849,1554,-295
7280,1,1,146,1629,1483
7281,0,0,14,0,-14
7282,0,0,34,0,-34
7283,1,0,62,0,-62
7284,0,0,37,0,-37
7285,1,1,101,1537,1436
7286,0,0,20,0,-20
7287,0,0,14,0,-14
7288,1,0,6,0,-6
7289,1,1,339,1240,901
7290,1,0,26,0,-26
7291,1,1,180,1254,1074
7292,1,1,52,1251,1199
7293,1,0,1,0,-1
7294,1,0,26,0,-26
7295,1,0,13,0,-13
7296,1,0,88,0,-88
7297,1,1,102,1269,1167
7298,0,0,25,0,-25
7299,1,1,88,1766,1678
7300,0,0,23,0,-23
7301,1,1,262,1348,1086
7302,1,0,8,0,-8
7303,0,0,19,0,-19
7304,1,0,232,0,-232
7305,0,0,10,0,-10
7306,1,1,869,1511,642
7307,0,0,44,0,-44
7308,1,0,112,0,-112
7309,0,0,96,0,-96
7310,1,0,38,0,-38
7311,0,0,3,0,-3
7312,0,0,37,0,-37
7313,0,0,68,0,-68
7314,1,0,5,0,-5
7315,1,0,30,0,-30
7316,1,0,70,0,-70
7317,1,0,76,0,-76
7318,0,0,30,0,-30
7319,0,0,35,0,-35
7320,1,0,45,0,-45
7321,1,0,69,0,-69
7322,1,1,816,1875,1059
7323,1,1,797,2389,1592
7324,0,0,60,0,-60
7325,1,0,91,0,-91
7326,0,0,195,0,-195
7327,1,0,13,0,-13
7328,0,0,123,0,-123
7329,1,1,324,1403,1079
7330,0,0,19,0,-19
7331,1,0,69,0,-69
7332,1,1,161,1386,1225
7333,0,0,49,0,-49
7334,1,0,6,0,-6
7335,1,0,19,0,-19
7336,1,0,27,0,-27
7337,1,0,94,0,-94
7338,1,1,521,1341,820
7339,1,1,200,1523,1323
7340,0,0,17,0,-17
7341,1,1,1734,1990,256
7342,1,0,17,0,-17
7343,0,0,31,0,-31
7344,0,0,54,0,-54
7345,1,0,114,0,-114
7346,1,0,18,0,-18
7347,1,1,183,1295,1112
7348,0,0,19,0,-19
7349,1,0,29,0,-29
7350,1,1,238,1494,1256
7351,0,0,98,0,-98
7352,1,1,333,2061,1728
7353,0,0,6,0,-6
7354,1,0,22,0,-22
7355,1,1,704,1574,870
7356,0,0,8,0,-8
7357,1,1,394,1651,1257
7358,1,0,46,0,-46
7359,0,0,113,0,-113
7360,0,0,52,0,-52
7361,0,0,114,0,-114
7362,1,0,27,0,-27
7363,0,0,14,0,-14
7364,1,1,554,1370,816
7365,1,1,567,1337,770
7366,1,1,547,1869,1322
7367,1,0,15,0,-15
7368,0,0,8,0,-8
7369,1,0,27,0,-27
7370,1,0,152,0,-152
7371,1,1,384,1302,918
7372,1,1,875,1260,385
7373,1,1,646,1287,641
7374,1,1,406,1935,1529
7375,0,0,93,0,-93
7376,1,0,24,0,-24
7377,1,0,0,0,0
7378,0,0,21,0,-21
7379,0,0,117,0,-117
7380,0,0,44,0,-44
7381,0,0,9,0,-9
7382,0,0,5,0,-5
7383,0,0,36,0,-36
7384,0,0,77,0,-77
7385,1,0,41,0,-41
7386,1,1,556,1601,1045
7387,0,0,17,0,-17
7388,1,1,228,1440,1212
7389,0,0,1,0,-1
7390,1,0,11,0,-11
7391,1,0,7,0,-7
7392,1,1,250,1683,1433
7393,1,0,7,0,-7
7394,1,0,297,0,-297
7395,0,0,86,0,-86
7396,0,0,8,0,-8
7397,1,1,132,1745,1613
7398,0,0,157,0,-157
7399,0,0,0,0,0
7400,0,0,54,0,-54
7401,1,0,31,0,-31
7402,0,0,0,0,0
7403,0,0,61,0,-61
7404,0,0,342,0,-342
7405,1,1,249,2118,1869
7406,0,0,87,0,-87
7407,1,0,54,0,-54
7408,1,0,5,0,-5
7409,0,0,174,0,-174
7410,1,0,7,0,-7
7411,0,0,166,0,-166
7412,1,0,40,0,-40
7413,1,0,41,0,-41
7414,1,1,819,1261,442
7415,1,1,298,1254,956
7416,1,0,147,0,-147
7417,1,0,54,0,-54
7418,1,1,227,1370,1143
7419,0,0,55,0,-55
7420,1,0,9,0,-9
7421,1,0,17,0,-17
7422,1,1,221,1620,1399
7423,1,0,15,0,-15
7424,0,0,140,0,-140
7425,0,0,122,0,-122
7426,1,1,346,3077,2731
7427,1,0,184,0,-184
7428,1,0,13,0,-13
7429,1,0,16,0,-16
7430,0,0,39,0,-39
7431,1,0,58,0,-58
7432,1,0,34,0,-34
7433,0,0,108,0,-108
7434,1,1,97,1377,1280
7435,1,0,104,0,-104
7436,1,0,11,0,-11
7437,0,0,56,0,-56
7438,1,0,4,0,-4
7439,1,1,167,1602,1435
7440,1,0,12,0,-12
7441,0,0,29,0,-29
7442,0,0,24,0,-24
7443,1,0,22,0,-22
7444,0,0,64,0,-64
7445,0,0,162,0,-162
7446,1,0,1,0,-1
7447,1,0,42,0,-42
7448,0,0,0,0,0
7449,1,1,282,1590,1308
7450,1,1,906,1270,364
7451,1,0,22,0,-22
7452,0,0,3,0,-3
7453,1,0,115,0,-115
7454,1,0,123,0,-123
7455,1,0,59,0,-59
7456,0,0,66,0,-66
7457,1,1,305,1454,1149
7458,0,0,27,0,-27
7459,0,0,64,0,-64
7460,0,0,12,0,-12
7461,0,0,87,0,-87
7462,0,0,56,0,-56
7463,0,0,94,0,-94
7464,0,0,3,0,-3
7465,1,0,55,0,-55
7466,1,1,1443,1564,121
7467,0,0,118,0,-118
7468,1,1,287,1368,1081
7469,1,1,813,1427,614
7470,1,0,19,0,-19
7471,1,0,83,0,-83
7472,1,0,1,0,-1
7473,1,1,147,1267,1120
7474,0,0,13,0,-13
7475,0,0,26,0,-26
7476,1,1,208,1282,1074
7477,0,0,45,0,-45
7478,1,1,373,1517,1144
7479,0,0,29,0,-29
7480,1,1,946,1380,434
7481,1,0,40,0,-40
7482,0,0,27,0,-27
7483,1,1,414,1914,1500
7484,1,1,1270,1910,640
7485,1,0,16,0,-16
7486,0,0,45,0,-45
7487,1,1,939,1927,988
7488,0,0,48,0,-48
7489,0,0,10,0,-10
7490,1,1,1003,3417,2414
7491,0,0,6,0,-6
7492,0,0,11,0,-11
7493,1,1,479,1397,918
7494,1,0,21,0,-21
7495,0,0,20,0,-20
7496,0,0,73,0,-73
7497,0,0,0,0,0
7498,0,0,60,0,-60
7499,1,1,337,1321,984
7500,1,0,70,0,-70
7501,1,0,26,0,-26
7502,1,1,52,1591,1539
7503,1,1,2168,1295,-873
7504,1,1,422,1266,844
7505,1,0,39,0,-39
7506,0,0,69,0,-69
7507,1,1,635,2711,2076
7508,0,0,183,0,-183
7509,0,0,111,0,-111
7510,1,1,106,1912,1806
7511,1,0,44,0,-44
7512,0,0,83,0,-83
7513,1,1,203,1481,1278
7514,0,0,3,0,-3
7515,1,0,20,0,-20
7516,0,0,29,0,-29
7517,1,1,189,3402,3213
7518,1,1,235,1372,1137
7519,1,1,312,1688,1376
7520,1,0,15,0,-15
7521,1,1,47,1658,1611
7522,0,0,4,0,-4
7523,0,0,46,0,-46
7524,0,0,9,0,-9
7525,0,0,29,0,-29
7526,1,1,25,1678,1653
7527,1,0,38,0,-38
7528,1,0,50,0,-50
7529,1,1,475,1705,1230
7530,1,1,144,1510,1366
7531,1,0,15,0,-15
7532,1,1,641,1294,653
7533,1,0,15,0,-15
7534,1,1,652,1291,639
7535,1,1,582,1335,753
7536,1,1,1339,1241,-98
7537,0,0,23,0,-23
7538,1,1,299,1607,1308
7539,0,0,33,0,-33
7540,0,0,90,0,-90
7541,1,1,149,1569,1420
7542,0,0,12,0,-12
7543,0,0,13,0,-13
7544,1,0,49,0,-49
7545,0,0,63,0,-63
7546,1,0,103,0,-103
7547,1,0,70,0,-70
7548,0,0,18,0,-18
7549,1,0,50,0,-50
7550,1,0,84,0,-84
7551,1,1,491,1364,873
7552,0,0,17,0,-17
7553,0,0,2,0,-2
7554,0,0,86,0,-86
7555,0,0,56,0,-56
7556,0,0,10,0,-10
7557,0,0,94,0,-94
7558,0,0,141,0,-141
7559,1,0,100,0,-100
7560,0,0,36,0,-36
7561,0,0,23,0,-23
7562,1,1,33,1798,1765
7563,1,1,363,1657,1294
7564,1,0,16,0,-16
7565,0,0,30,0,-30
7566,1,1,272,1522,1250
7567,0,0,50,0,-50
7568,0,0,2,0,-2
7569,1,1,2342,1526,-816
7570,0,0,118,0,-118
7571,1,0,78,0,-78
7572,0,0,12,0,-12
7573,0,0,0,0,0
7574,0,0,52,0,-52
7575,0,0,7,0,-7
7576,1,1,737,1250,513
7577,0,0,71,0,-71
7578,1,1,1192,1698,506
7579,1,1,77,1961,1884
7580,0,0,109,0,-109
7581,0,0,49,0,-49
7582,0,0,5,0,-5
7583,0,0,47,0,-47
7584,0,0,13,0,-13
7585,1,0,81,0,-81
7586,0,0,33,0,-33
7587,0,0,7,0,-7
7588,0,0,137,0,-137
7589,1,0,49,0,-49
7590,1,0,22,0,-22
7591,1,1,350,2166,1816
7592,0,0,32,0,-32
7593,1,0,19,0,-19
7594,0,0,8,0,-8
7595,0,0,9,0,-9
7596,0,0,146,0,-146
7597,1,1,54,1753,1699
7598,1,1,465,1706,1241
7599,0,0,5,0,-5
7600,0,0,45,0,-45
7601,1,0,6,0,-6
7602,1,0,29,0,-29
7603,0,0,10,0,-10
7604,1,1,1603,1275,-328
7605,1,1,2868,1374,-1494
7606,1,0,223,0,-223
7607,0,0,80,0,-80
7608,1,1,708,2414,1706
7609,0,0,97,0,-97
7610,1,0,62,0,-62
7611,1,1,279,1322,1043
7612,0,0,144,0,-144
7613,1,1,99,1305,1206
7614,1,0,8,0,-8
7615,1,0,80,0,-80
7616,0,0,14,0,-14
7617,1,1,498,1328,830
7618,1,1,1070,1539,469
7619,1,1,372,1543,1171
7620,0,0,21,0,-21
7621,1,1,164,2317,2153
7622,0,0,98,0,-98
7623,0,0,5,0,-5
7624,0,0,7,0,-7
7625,1,0,146,0,-146
7626,0,0,17,0,-17
7627,1,0,172,0,-172
7628,0,0,68,0,-68
7629,0,0,6,0,-6
7630,1,0,40,0,-40
7631,1,1,375,1466,1091
7632,1,1,861,3400,2539
7633,1,0,17,0,-17
7634,1,1,2079,1453,-626
7635,1,0,32,0,-32
7636,1,0,111,0,-111
7637,0,0,195,0,-195
7638,0,0,58,0,-58
7639,1,0,4,0,-4
7640,0,0,65,0,-65
7641,0,0,128,0,-128
7642,0,0,30,0,-30
7643,1,0,44,0,-44
7644,1,0,15,0,-15
7645,1,0,17,0,-17
7646,0,0,38,0,-38
7647,1,0,3,0,-3
7648,1,0,102,0,-102
7649,1,1,564,1478,914
7650,1,1,72,1321,1249
7651,1,1,813,1418,605
7652,1,0,75,0,-75
7653,0,0,43,0,-43
7654,1,1,87,1824,1737
7655,1,0,206,0,-206
7656,0,0,3,0,-3
7657,1,0,1,0,-1
7658,0,0,2,0,-2
7659,0,0,31,0,-31
7660,1,1,448,1273,825
7661,0,0,28,0,-28
7662,1,0,126,0,-126
7663,1,0,24,0,-24
7664,0,0,117,0,-117
7665,1,1,33,1384,1351
7666,0,0,1,0,-1
7667,1,0,164,0,-164
7668,1,1,457,1542,1085
7669,1,0,28,0,-28
7670,0,0,28,0,-28
7671,1,1,44,1437,1393
7672,1,0,156,0,-156
7673,1,0,74,0,-74
7674,1,1,162,1245,1083
7675,0,0,15,0,-15
7676,0,0,26,0,-26
7677,1,1,1556,1560,4
7678,1,0,44,0,-44
7679,0,0,46,0,-46
7680,1,0,59,0,-59
7681,1,0,14,0,-14
7682,0,0,25,0,-25
7683,0,0,31,0,-31
7684,0,0,39,0,-39
7685,1,1,456,1292,836
7686,0,0,27,0,-27
7687,1,0,9,0,-9
7688,1,1,1299,1886,587
7689,0,0,27,0,-27
7690,1,1,1368,2120,752
7691,1,1,166,1839,1673
7692,1,1,412,1253,841
7693,1,0,28,0,-28
7694,1,0,23,0,-23
7695,1,1,93,1235,1142
7696,1,1,245,1274,1029
7697,1,0,75,0,-75
7698,1,0,3,0,-3
7699,1,1,837,3657,2820
7700,1,1,630,1312,682
7701,1,0,141,0,-141
7702,1,0,134,0,-134
7703,1,1,560,1734,1174
7704,0,0,8,0,-8
7705,1,1,189,1292,1103
7706,1,1,95,1252,1157
7707,1,0,139,0,-139
7708,1,0,85,0,-85
7709,1,0,31,0,-31
7710,1,0,46,0,-46
7711,0,0,92,0,-92
7712,1,0,2,0,-2
7713,1,0,14,0,-14
7714,1,1,104,1557,1453
7715,1,1,309,1338,1029
7716,1,0,114,0,-114
7717,0,0,101,0,-101
7718,1,0,211,0,-211
7719,0,0,166,0,-166
7720,0,0,34,0,-34
7721,0,0,37,0,-37
7722,1,0,80,0,-80
7723,1,0,28,0,-28
7724,1,1,761,1540,779
7725,1,0,39,0,-39
7726,1,1,659,1241,582
7727,1,1,121,1408,1287
7728,0,0,13,0,-13
7729,1,1,1091,1560,469
7730,0,0,46,0,-46
7731,0,0,43,0,-43
7732,1,1,72,2034,1962
7733,1,1,136,1634,1498
7734,0,0,246,0,-246
7735,1,1,293,1480,1187
7736,1,0,59,0,-59
7737,0,0,16,0,-16
7738,1,0,18,0,-18
7739,0,0,36,0,-36
7740,1,0,109,0,-109
7741,0,0,163,0,-163
7742,0,0,158,0,-158
7743,1,0,54,0,-54
7744,1,0,166,0,-166
7745,1,1,1237,1568,331
7746,0,0,96,0,-96
7747,0,0,58,0,-58
7748,0,0,15,0,-15
7749,0,0,7,0,-7
7750,1,1,1052,2354,1302
7751,0,0,42,0,-42
7752,1,1,287,1343,1056
7753,0,0,179,0,-179
7754,0,0,96,0,-96
7755,0,0,66,0,-66
7756,1,0,74,0,-74
7757,1,1,671,1257,586
7758,0,0,135,0,-135
7759,0,0,43,0,-43
7760,1,1,324,2821,2497
7761,1,1,2308,1425,-883
7762,0,0,88,0,-88
7763,1,0,118,0,-118
7764,1,0,93,0,-93
7765,1,1,548,4850,4302
7766,1,0,181,0,-181
7767,0,0,32,0,-32
7768,0,0,216,0,-216
7769,1,1,144,1259,1115
7770,0,0,50,0,-50
7771,0,0,48,0,-48
7772,1,0,132,0,-132
7773,1,0,21,0,-21
7774,1,1,306,8231,7925
7775,0,0,7,0,-7
7776,1,1,122,1708,1586
7777,1,0,9,0,-9
7778,1,0,7,0,-7
7779,1,1,984,1349,365
7780,1,0,1,0,-1
7781,0,0,56,0,-56
7782,1,1,227,1370,1143
7783,0,0,48,0,-48
7784,1,0,11,0,-11
7785,1,1,863,1343,480
7786,1,0,77,0,-77
7787,1,1,190,1695,1505
7788,0,0,5,0,-5
7789,1,1,39,1246,1207
7790,1,1,335,1400,1065
7791,0,0,85,0,-85
7792,0,0,2,0,-2
7793,1,1,213,3013,2800
7794,1,0,57,0,-57
7795,1,1,112,1305,1193
7796,1,1,258,1246,988
7797,0,0,4,0,-4
7798,0,0,1,0,-1
7799,1,0,118,0,-118
7800,0,0,53,0,-53
7801,1,1,74,1281,1207
7802,1,1,143,1261,1118
7803,1,1,330,1369,1039
7804,1,0,0,0,0
7805,1,0,108,0,-108
7806,0,0,30,0,-30
7807,0,0,36,0,-36
7808,0,0,159,0,-159
7809,1,0,47,0,-47
7810,0,0,8,0,-8
7811,0,0,31,0,-31
7812,1,0,37,0,-37
7813,1,0,31,0,-31
7814,1,1,143,1255,1112
7815,1,1,744,1613,869
7816,0,0,49,0,-49
7817,0,0,41,0,-41
7818,0,0,135,0,-135
7819,0,0,12,0,-12
7820,1,0,11,0,-11
7821,1,0,88,0,-88
7822,1,0,9,0,-9
7823,1,0,19,0,-19
7824,1,0,78,0,-78
7825,1,0,2,0,-2
7826,1,1,591,1558,967
7827,0,0,10,0,-10
7828,0,0,53,0,-53
7829,0,0,38,0,-38
7830,1,0,126,0,-126
7831,1,0,23,0,-23
7832,1,0,7,0,-7
7833,0,0,35,0,-35
7834,1,0,8,0,-8
7835,1,1,452,1357,905
7836,1,0,15,0,-15
7837,0,0,34,0,-34
7838,1,0,29,0,-29
7839,1,1,826,1485,659
7840,0,0,56,0,-56
7841,1,1,269,1267,998
7842,0,0,36,0,-36
7843,0,0,43,0,-43
7844,0,0,51,0,-51
7845,1,1,75,1750,1675
7846,1,1,189,1253,1064
7847,0,0,5,0,-5
7848,0,0,3,0,-3
7849,1,0,40,0,-40
7850,1,0,142,0,-142
7851,0,0,95,0,-95
7852,0,0,84,0,-84
7853,0,0,30,0,-30
7854,0,0,27,0,-27
7855,0,0,100,0,-100
7856,1,1,412,1962,1550
7857,1,0,46,0,-46
7858,0,0,6,0,-6
7859,1,1,770,1286,516
7860,0,0,122,0,-122
7861,1,1,709,1420,711
7862,1,1,477,1294,817
7863,0,0,2,0,-2
7864,0,0,76,0,-76
7865,0,0,15,0,-15
7866,1,1,696,1350,654
7867,0,0,45,0,-45
7868,0,0,3,0,-3
7869,1,1,508,1272,764
7870,1,1,775,1317,542
7871,0,0,57,0,-57
7872,1,1,833,1760,927
7873,1,0,14,0,-14
7874,1,0,77,0,-77
7875,1,0,108,0,-108
7876,1,0,38,0,-38
7877,1,1,487,1421,934
7878,1,0,17,0,-17
7879,0,0,1,0,-1
7880,0,0,166,0,-166
7881,1,0,37,0,-37
7882,0,0,2,0,-2
7883,1,1,738,1285,547
7884,1,1,351,1399,1048
7885,1,1,224,1382,1158
7886,0,0,102,0,-102
7887,1,0,7,0,-7
7888,0,0,47,0,-47
7889,0,0,19,0,-19
7890,1,1,238,2079,1841
7891,1,0,3,0,-3
7892,1,1,414,1442,1028
7893,1,0,21,0,-21
7894,0,0,36,0,-36
7895,1,1,626,1391,765
7896,0,0,64,0,-64
7897,1,0,52,0,-52
7898,1,0,18,0,-18
7899,1,0,36,0,-36
7900,1,1,507,1730,1223
7901,0,0,43,0,-43
7902,1,1,70,1239,1169
7903,1,1,471,1787,1316
7904,1,1,2160,1255,-905
7905,1,0,116,0,-116
7906,1,0,5,0,-5
7907,1,0,13,0,-13
7908,0,0,11,0,-11
7909,0,0,39,0,-39
7910,0,0,59,0,-59
7911,0,0,7,0,-7
7912,1,0,9,0,-9
7913,1,0,51,0,-51
7914,0,0,88,0,-88
7915,1,0,9,0,-9
7916,1,0,54,0,-54
7917,1,1,200,1303,1103
7918,0,0,43,0,-43
7919,1,1,1553,1373,-180
7920,1,1,910,1404,494
7921,0,0,3,0,-3
7922,1,0,23,0,-23
7923,0,0,1,0,-1
7924,1,0,10,0,-10
7925,0,0,8,0,-8
7926,1,1,785,1580,795
7927,0,0,38,0,-38
7928,0,0,203,0,-203
7929,0,0,82,0,-82
7930,1,1,223,1343,1120
7931,1,0,25,0,-25
7932,1,1,1028,1305,277
7933,1,0,17,0,-17
7934,1,1,850,1461,611
7935,0,0,5,0,-5
7936,0,0,22,0,-22
7937,1,1,1374,1636,262
7938,1,1,690,1357,667
7939,0,0,38,0,-38
7940,1,1,404,1331,927
7941,1,1,496,1507,1011
7942,1,0,49,0,-49
7943,1,0,97,0,-97
7944,0,0,71,0,-71
7945,1,1,570,1638,1068
7946,0,0,60,0,-60
7947,0,0,2,0,-2
7948,0,0,80,0,-80
7949,1,1,1094,3597,2503
7950,0,0,80,0,-80
7951,1,1,84,1331,1247
7952,1,1,260,1772,1512
7953,1,1,299,1373,1074
7954,1,0,77,0,-77
7955,1,0,44,0,-44
7956,1,0,31,0,-31
7957,1,0,48,0,-48
7958,1,0,145,0,-145
7959,0,0,24,0,-24
7960,1,0,53,0,-53
7961,1,1,111,1340,1229
7962,1,0,131,0,-131
7963,0,0,10,0,-10
7964,1,1,455,1240,785
7965,0,0,47,0,-47
7966,1,0,20,0,-20
7967,1,1,31,3217,3186
7968,0,0,7,0,-7
7969,1,0,126,0,-126
7970,1,0,24,0,-24
7971,0,0,3,0,-3
7972,1,0,12,0,-12
7973,1,1,1521,1311,-210
7974,1,0,17,0,-17
7975,1,0,0,0,0
7976,1,0,35,0,-35
7977,0,0,31,0,-31
7978,1,0,244,0,-244
7979,0,0,2,0,-2
7980,1,1,381,2094,1713
7981,1,0,1,0,-1
7982,1,0,21,0,-21
7983,0,0,7,0,-7
7984,1,1,591,1523,932
7985,1,1,734,1619,885
7986,1,1,620,1577,957
7987,1,1,231,1517,1286
7988,1,0,77,0,-77
7989,1,1,162,1717,1555
7990,0,0,31,0,-31
7991,0,0,4,0,-4
7992,0,0,22,0,-22
7993,0,0,12,0,-12
7994,0,0,20,0,-20
7995,1,0,94,0,-94
7996,1,1,359,2713,2354
7997,0,0,111,0,-111
7998,1,1,332,1325,993
7999,0,0,23,0,-23
8000,0,0,15,0,-15
8001,1,0,42,0,-42
8002,1,0,54,0,-54
8003,1,0,34,0,-34
8004,1,0,62,0,-62
8005,1,1,1455,1341,-114
8006,1,1,239,1272,1033
8007,1,0,11,0,-11
8008,1,0,194,0,-194
8009,1,0,64,0,-64
8010,0,0,47,0,-47
8011,1,0,3,0,-3
8012,1,1,110,1236,1126
8013,1,1,596,1238,642
8014,0,0,30,0,-30
8015,0,0,30,0,-30
8016,1,1,559,1384,825
8017,1,1,49,1519,1470
8018,1,0,74,0,-74
8019,1,1,44,1422,1378
8020,0,0,90,0,-90
8021,1,0,134,0,-134
8022,1,0,48,0,-48
8023,0,0,67,0,-67
8024,0,0,49,0,-49
8025,0,0,37,0,-37
8026,0,0,64,0,-64
8027,1,1,1576,1560,-16
8028,1,1,1103,1475,372
8029,1,0,92,0,-92
8030,0,0,26,0,-26
8031,0,0,92,0,-92
8032,1,0,19,0,-19
8033,0,0,100,0,-100
8034,0,0,6,0,-6
8035,1,1,905,1536,631
8036,0,0,96,0,-96
8037,1,0,15,0,-15
8038,1,0,16,0,-16
8039,1,1,234,2164,1930
8040,1,1,1414,1275,-139
8041,1,1,240,1830,1590
8042,0,0,11,0,-11
8043,0,0,11,0,-11
8044,1,0,4,0,-4
8045,1,1,1558,1627,69
8046,0,0,27,0,-27
8047,1,1,155,2918,2763
8048,0,0,35,0,-35
8049,0,0,171,0,-171
8050,1,1,1838,3093,1255
8051,1,1,51,1368,1317
8052,0,0,23,0,-23
8053,0,0,106,0,-106
8054,1,1,416,1502,1086
8055,0,0,30,0,-30
8056,0,0,23,0,-23
8057,0,0,39,0,-39
8058,0,0,15,0,-15
8059,1,1,12,1667,1655
8060,0,0,45,0,-45
8061,1,0,67,0,-67
8062,1,0,95,0,-95
8063,0,0,3,0,-3
8064,1,0,23,0,-23
8065,1,0,43,0,-43
8066,1,0,8,0,-8
8067,1,1,772,1541,769
8068,1,1,500,2376,1876
8069,1,0,3,0,-3
8070,1,0,44,0,-44
8071,1,0,138,0,-138
8072,0,0,35,0,-35
8073,0,0,4,0,-4
8074,1,0,8,0,-8
8075,1,1,58,1533,1475
8076,1,0,7,0,-7
8077,1,1,82,1460,1378
8078,0,0,11,0,-11
8079,0,0,36,0,-36
8080,1,1,364,1805,1441
8081,1,0,34,0,-34
8082,0,0,115,0,-115
8083,0,0,55,0,-55
8084,1,1,152,1284,1132
8085,1,0,32,0,-32
8086,1,1,569,1428,859
8087,0,0,8,0,-8
8088,0,0,24,0,-24
8089,1,1,193,2310,2117
8090,1,1,566,1777,1211
8091,1,1,869,1311,442
8092,1,1,1048,1414,366
8093,0,0,107,0,-107
8094,0,0,45,0,-45
8095,1,1,419,2345,1926
8096,1,0,16,0,-16
8097,1,0,36,0,-36
8098,1,1,222,2474,2252
8099,1,0,44,0,-44
8100,1,0,132,0,-132
8101,1,1,221,2027,1806
8102,1,0,22,0,-22
8103,1,0,9,0,-9
8104,0,0,18,0,-18
8105,0,0,95,0,-95
8106,0,0,102,0,-102
8107,1,0,37,0,-37
8108,1,0,3,0,-3
8109,1,0,31,0,-31
8110,0,0,39,0,-39
8111,1,0,39,0,-39
8112,0,0,21,0,-21
8113,1,0,29,0,-29
8114,0,0,103,0,-103
8115,0,0,34,0,-34
8116,0,0,5,0,-5
8117,0,0,93,0,-93
8118,1,1,215,1442,1227
8119,1,0,0,0,0
8120,1,0,62,0,-62
8121,1,0,68,0,-68
8122,0,0,36,0,-36
8123,1,1,311,1295,984
8124,1,1,284,1404,1120
8125,0,0,7,0,-7
8126,1,0,4,0,-4
8127,1,1,1081,1236,155
8128,1,1,1079,1684,605
8129,1,1,818,1246,428
8130,0,0,68,0,-68
8131,1,1,294,1517,1223
8132,1,1,319,1597,1278
8133,0,0,30,0,-30
8134,0,0,58,0,-58
8135,1,1,482,1506,1024
8136,1,1,847,1471,624
8137,0,0,7,0,-7
8138,0,0,19,0,-19
8139,1,1,74,1737,1663
8140,1,0,143,0,-143
8141,1,0,64,0,-64
8142,1,0,13,0,-13
8143,1,1,704,1449,745
8144,0,0,28,0,-28
8145,1,1,928,1303,375
8146,1,1,860,2131,1271
8147,0,0,14,0,-14
8148,0,0,30,0,-30
8149,1,0,8,0,-8
8150,1,1,760,1249,489
8151,1,0,88,0,-88
8152,1,0,4,0,-4
8153,1,1,247,1243,996
8154,0,0,100,0,-100
8155,1,1,274,1410,1136
8156,0,0,11,0,-11
8157,1,1,2287,1263,-1024
8158,1,0,31,0,-31
8159,0,0,6,0,-6
8160,0,0,112,0,-112
8161,0,0,166,0,-166
8162,1,0,74,0,-74
8163,0,0,13,0,-13
8164,1,0,20,0,-20
8165,0,0,10,0,-10
8166,0,0,17,0,-17
8167,1,1,2403,1250,-1153
8168,1,0,49,0,-49
8169,0,0,38,0,-38
8170,0,0,32,0,-32
8171,1,1,968,1355,387
8172,1,0,56,0,-56
8173,0,0,30,0,-30
8174,0,0,106,0,-106
8175,1,0,49,0,-49
8176,1,1,535,1630,1095
8177,0,0,30,0,-30
8178,0,0,20,0,-20
8179,1,1,659,1460,801
8180,1,1,632,1339,707
8181,1,1,3703,1343,-2360
8182,1,0,2,0,-2
8183,1,0,30,0,-30
8184,0,0,21,0,-21
8185,1,0,18,0,-18
8186,1,0,89,0,-89
8187,0,0,39,0,-39
8188,0,0,48,0,-48
8189,1,0,35,0,-35
8190,0,0,12,0,-12
8191,0,0,56,0,-56
8192,1,1,114,1660,1546
8193,1,0,27,0,-27
8194,1,0,18,0,-18
8195,0,0,43,0,-43
8196,1,1,489,1702,1213
8197,1,1,378,1358,980
8198,1,0,114,0,-114
8199,1,0,32,0,-32
8200,1,0,2,0,-2
8201,1,1,199,2647,2448
8202,1,1,591,1466,875
8203,1,1,3680,1570,-2110
8204,1,1,473,1976,1503
8205,0,0,14,0,-14
8206,1,0,4,0,-4
8207,1,1,1210,1271,61
8208,0,0,17,0,-17
8209,0,0,3,0,-3
8210,1,1,343,3249,2906
8211,0,0,12,0,-12
8212,1,1,220,2366,2146
8213,1,0,19,0,-19
8214,1,1,475,1282,807
8215,1,1,189,2152,1963
8216,1,1,588,1448,860
8217,1,0,15,0,-15
8218,0,0,123,0,-123
8219,1,0,112,0,-112
8220,1,1,372,1267,895
8221,1,0,21,0,-21
8222,1,1,379,2094,1715
8223,1,0,20,0,-20
8224,0,0,52,0,-52
8225,1,1,275,1350,1075
8226,1,0,39,0,-39
8227,0,0,73,0,-73
8228,1,1,649,2320,1671
8229,1,1,232,1294,1062
8230,1,0,26,0,-26
8231,0,0,57,0,-57
8232,1,1,68,1640,1572
8233,0,0,33,0,-33
8234,1,1,140,1338,1198
8235,0,0,72,0,-72
8236,1,0,42,0,-42
8237,1,0,6,0,-6
8238,0,0,12,0,-12
8239,0,0,4,0,-4
8240,1,1,357,1925,1568
8241,1,1,1262,1254,-8
8242,0,0,194,0,-194
8243,0,0,55,0,-55
8244,1,1,991,1360,369
8245,1,1,462,1325,863
8246,0,0,97,0,-97
8247,1,1,134,2308,2174
8248,0,0,113,0,-113
8249,1,1,1388,1662,274
8250,0,0,2,0,-2
8251,0,0,105,0,-105
8252,1,1,2720,1261,-1459
8253,0,0,133,0,-133
8254,1,0,3,0,-3
8255,0,0,38,0,-38
8256,0,0,47,0,-47
8257,1,1,892,1456,564
8258,0,0,42,0,-42
8259,1,1,1511,1710,199
8260,1,0,5,0,-5
8261,1,0,83,0,-83
8262,0,0,18,0,-18
8263,0,0,10,0,-10
8264,0,0,143,0,-143
8265,0,0,61,0,-61
8266,0,0,36,0,-36
8267,0,0,0,0,0
8268,1,1,372,2854,2482
8269,0,0,13,0,-13
8270,1,1,290,1527,1237
8271,0,0,6,0,-6
8272,0,0,48,0,-48
8273,0,0,58,0,-58
8274,1,1,911,1397,486
8275,1,1,249,1858,1609
8276,1,1,197,1238,1041
8277,0,0,72,0,-72
8278,1,0,90,0,-90
8279,0,0,87,0,-87
8280,0,0,43,0,-43
8281,1,0,21,0,-21
8282,1,0,1,0,-1
8283,0,0,28,0,-28
8284,1,0,103,0,-103
8285,1,1,109,1260,1151
8286,0,0,321,0,-321
8287,1,1,75,1522,1447
8288,0,0,128,0,-128
8289,1,1,59,1362,1303
8290,1,1,750,1311,561
8291,1,0,26,0,-26
8292,1,0,15,0,-15
8293,1,0,12,0,-12
8294,1,1,175,1374,1199
8295,1,0,105,0,-105
8296,0,0,12,0,-12
8297,1,0,86,0,-86
8298,0,0,38,0,-38
8299,1,0,13,0,-13
8300,1,1,26,2165,2139
8301,1,1,1009,2031,1022
8302,1,1,881,1353,472
8303,0,0,21,0,-21
8304,1,0,24,0,-24
8305,0,0,75,0,-75
8306,1,0,8,0,-8
8307,0,0,20,0,-20
8308,0,0,87,0,-87
8309,1,0,57,0,-57
8310,0,0,75,0,-75
8311,1,0,16,0,-16
8312,1,1,229,1381,1152
8313,1,0,205,0,-205
8314,1,0,71,0,-71
8315,0,0,17,0,-17
8316,1,0,110,0,-110
8317,1,0,95,0,-95
8318,0,0,7,0,-7
8319,0,0,70,0,-70
8320,0,0,97,0,-97
8321,1,1,849,1398,549
8322,1,0,45,0,-45
8323,0,0,26,0,-26
8324,0,0,33,0,-33
8325,0,0,6,0,-6
8326,1,0,108,0,-108
8327,1,1,308,1469,1161
8328,1,0,14,0,-14
8329,1,0,28,0,-28
8330,0,0,50,0,-50
8331,1,0,49,0,-49
8332,0,0,11,0,-11
8333,1,1,432,1387,955
8334,1,0,8,0,-8
8335,0,0,9,0,-9
8336,0,0,14,0,-14
8337,1,1,808,1314,506
8338,0,0,41,0,-41
8339,1,1,32,1282,1250
8340,1,1,386,1438,1052
8341,1,1,927,2186,1259
8342,1,1,434,2266,1832
8343,0,0,13,0,-13
8344,1,0,140,0,-140
8345,1,1,1240,2376,1136
8346,0,0,42,0,-42
8347,0,0,58,0,-58
8348,1,0,11,0,-11
8349,1,1,156,1316,1160
8350,1,1,66,1381,1315
8351,0,0,42,0,-42
8352,0,0,17,0,-17
8353,0,0,58,0,-58
8354,0,0,25,0,-25
8355,1,1,226,1562,1336
8356,1,1,445,1634,1189
8357,0,0,16,0,-16
8358,0,0,4,0,-4
8359,1,1,111,1504,1393
8360,1,1,209,1326,1117
8361,0,0,9,0,-9
8362,0,0,24,0,-24
8363,0,0,164,0,-164
8364,0,0,12,0,-12
8365,1,1,24,1414,1390
8366,0,0,122,0,-122
8367,1,0,36,0,-36
8368,1,0,55,0,-55
8369,0,0,52,0,-52
8370,0,0,17,0,-17
8371,1,0,1,0,-1
8372,0,0,87,0,-87
8373,1,1,585,1462,877
8374,1,1,412,1573,1161
8375,0,0,12,0,-12
8376,1,0,15,0,-15
8377,0,0,86,0,-86
8378,1,1,964,1780,816
8379,0,0,66,0,-66
8380,0,0,12,0,-12
8381,0,0,55,0,-55
8382,1,0,8,0,-8
8383,0,0,64,0,-64
8384,1,1,136,1441,1305
8385,1,1,242,1377,1135
8386,1,1,63,1347,1284
8387,1,1,430,1273,843
8388,1,1,987,1855,868
8389,0,0,106,0,-106
8390,0,0,101,0,-101
8391,1,1,204,2230,2026
8392,1,0,1,0,-1
8393,1,0,23,0,-23
8394,1,1,151,1265,1114
8395,0,0,80,0,-80
8396,1,0,45,0,-45
8397,0,0,57,0,-57
8398,1,1,166,1244,1078
8399,1,1,334,1264,930
8400,1,0,40,0,-40
8401,0,0,10,0,-10
8402,1,1,39,1372,1333
8403,1,0,56,0,-56
8404,0,0,3,0,-3
8405,0,0,25,0,-25
8406,1,1,153,1608,1455
8407,0,0,48,0,-48
8408,1,0,30,0,-30
8409,1,1,687,1512,825
8410,0,0,5,0,-5
8411,1,1,855,1370,515
8412,0,0,34,0,-34
8413,1,1,459,1235,776
8414,0,0,82,0,-82
8415,1,0,31,0,-31
8416,0,0,33,0,-33
8417,0,0,19,0,-19
8418,1,1,578,1401,823
8419,1,0,22,0,-22
8420,0,0,3,0,-3
8421,1,1,561,1429,868
8422,0,0,11,0,-11
8423,1,1,585,1361,776
8424,1,1,121,1292,1171
8425,1,1,800,1281,481
8426,0,0,29,0,-29
8427,1,0,43,0,-43
8428,0,0,8,0,-8
8429,0,0,29,0,-29
8430,1,1,547,1239,692
8431,1,1,269,1268,999
8432,1,1,1217,1291,74
8433,1,0,9,0,-9
8434,1,0,179,0,-179
8435,1,1,1592,1703,111
8436,1,0,38,0,-38
8437,1,0,8,0,-8
8438,1,1,669,1627,958
8439,1,0,58,0,-58
8440,1,1,765,1256,491
8441,0,0,4,0,-4
8442,0,0,16,0,-16
8443,1,0,19,0,-19
8444,0,0,6,0,-6
8445,0,0,31,0,-31
8446,1,0,15,0,-15
8447,1,0,78,0,-78
8448,0,0,77,0,-77
8449,0,0,4,0,-4
8450,1,1,125,3205,3080
8451,1,0,13,0,-13
8452,1,1,853,1261,408
8453,1,1,711,1507,796
8454,0,0,46,0,-46
8455,1,0,7,0,-7
8456,0,0,6,0,-6
8457,1,1,1202,2239,1037
8458,0,0,22,0,-22
8459,1,0,7,0,-7
8460,1,0,47,0,-47
8461,0,0,39,0,-39
8462,0,0,173,0,-173
8463,1,1,466,1333,867
8464,0,0,93,0,-93
8465,0,0,12,0,-12
8466,0,0,95,0,-95
8467,1,0,126,0,-126
8468,1,0,29,0,-29
8469,1,0,38,0,-38
8470,0,0,4,0,-4
8471,1,0,43,0,-43
8472,0,0,3,0,-3
8473,0,0,47,0,-47
8474,1,1,261,1302,1041
8475,1,1,201,1406,1205
8476,1,1,197,1369,1172
8477,0,0,120,0,-120
8478,1,1,133,1393,1260
8479,1,1,118,1437,1319
8480,0,0,15,0,-15
8481,0,0,120,0,-120
8482,1,1,375,1540,1165
8483,0,0,47,0,-47
8484,0,0,55,0,-55
8485,1,0,33,0,-33
8486,1,0,62,0,-62
8487,1,1,248,1890,1642
8488,0,0,129,0,-129
8489,1,0,22,0,-22
8490,1,1,353,1898,1545
8491,1,0,15,0,-15
8492,1,0,28,0,-28
8493,1,1,1782,1291,-491
8494,1,0,2,0,-2
8495,1,1,689,1748,1059
8496,0,0,108,0,-108
8497,1,1,517,1515,998
8498,1,0,3,0,-3
8499,1,1,101,1326,1225
8500,0,0,1,0,-1
8501,1,0,11,0,-11
8502,1,0,76,0,-76
8503,0,0,4,0,-4
8504,0,0,31,0,-31
8505,1,1,728,2260,1532
8506,0,0,12,0,-12
8507,1,1,465,1350,885
8508,1,1,100,1344,1244
8509,1,1,289,1683,1394
8510,1,0,79,0,-79
8511,1,1,825,1348,523
8512,0,0,20,0,-20
8513,1,0,26,0,-26
8514,1,1,161,1299,1138
8515,0,0,3,0,-3
8516,1,1,276,1517,1241
8517,0,0,43,0,-43
8518,0,0,145,0,-145
8519,1,0,33,0,-33
8520,0,0,29,0,-29
8521,1,1,146,1702,1556
8522,1,1,149,1635,1486
8523,1,0,28,0,-28
8524,1,1,290,1452,1162
8525,0,0,0,0,0
8526,1,1,1172,1568,396
8527,1,0,17,0,-17
8528,0,0,80,0,-80
8529,1,1,419,1619,1200
8530,1,1,986,1380,394
8531,1,0,17,0,-17
8532,1,0,0,0,0
8533,1,1,1801,1235,-566
8534,0,0,133,0,-133
8535,1,1,821,1256,435
8536,1,1,372,1911,1539
8537,0,0,65,0,-65
8538,0,0,94,0,-94
8539,1,0,19,0,-19
8540,1,0,12,0,-12
8541,0,0,17,0,-17
8542,1,0,12,0,-12
8543,1,0,14,0,-14
8544,0,0,16,0,-16
8545,1,1,202,1316,1114
8546,1,0,0,0,0
8547,0,0,53,0,-53
8548,0,0,13,0,-13
8549,0,0,22,0,-22
8550,1,0,65,0,-65
8551,0,0,46,0,-46
8552,0,0,105,0,-105
8553,1,0,31,0,-31
8554,1,0,12,0,-12
8555,1,0,42,0,-42
8556,0,0,40,0,-40
8557,1,0,8,0,-8
8558,0,0,38,0,-38
8559,1,0,44,0,-44
8560,0,0,28,0,-28
8561,0,0,20,0,-20
8562,1,1,553,1522,969
8563,1,1,197,1412,1215
8564,0,0,24,0,-24
8565,0,0,5,0,-5
8566,1,1,419,1652,1233
8567,1,1,1214,1444,230
8568,0,0,3,0,-3
8569,1,0,1,0,-1
8570,1,1,1480,2855,1375
8571,1,0,0,0,0
8572,0,0,33,0,-33
8573,1,1,343,1430,1087
8574,1,0,13,0,-13
8575,1,0,29,0,-29
8576,0,0,183,0,-183
8577,1,0,47,0,-47
8578,0,0,7,0,-7
8579,0,0,62,0,-62
8580,1,0,0,0,0
8581,1,0,57,0,-57
8582,1,1,325,2510,2185
8583,1,0,27,0,-27
8584,0,0,35,0,-35
8585,0,0,71,0,-71
8586,0,0,6,0,-6
8587,0,0,0,0,0
8588,0,0,18,0,-18
8589,0,0,84,0,-84
8590,0,0,8,0,-8
8591,0,0,5,0,-5
8592,1,1,168,1327,1159
8593,1,1,42,1339,1297
8594,1,0,10,0,-10
8595,0,0,82,0,-82
8596,1,1,567,1542,975
8597,0,0,5,0,-5
8598,0,0,17,0,-17
8599,1,1,504,1488,984
8600,1,1,174,1255,1081
8601,1,1,117,1593,1476
8602,1,1,570,1269,699
8603,0,0,16,0,-16
8604,1,1,178,1271,1093
8605,1,0,4,0,-4
8606,1,0,51,0,-51
8607,0,0,89,0,-89
8608,0,0,11,0,-11
8609,1,1,488,1647,1159
8610,1,1,192,1507,1315
8611,0,0,28,0,-28
8612,0,0,243,0,-243
8613,1,0,22,0,-22
8614,1,1,712,1840,1128
8615,0,0,62,0,-62
8616,1,1,1060,1328,268
8617,0,0,106,0,-106
8618,0,0,14,0,-14
8619,0,0,33,0,-33
8620,1,1,141,1249,1108
8621,1,0,304,0,-304
8622,0,0,46,0,-46
8623,1,0,10,0,-10
8624,1,1,488,1634,1146
8625,1,1,154,1589,1435
8626,1,0,74,0,-74
8627,1,0,28,0,-28
8628,0,0,23,0,-23
8629,0,0,25,0,-25
8630,1,1,165,2067,1902
8631,0,0,22,0,-22
8632,0,0,0,0,0
8633,0,0,13,0,-13
8634,1,0,111,0,-111
8635,0,0,54,0,-54
8636,1,0,77,0,-77
8637,0,0,6,0,-6
8638,1,0,9,0,-9
8639,1,0,33,0,-33
8640,0,0,41,0,-41
8641,1,0,92,0,-92
8642,1,0,21,0,-21
8643,0,0,26,0,-26
8644,1,1,115,1303,1188
8645,1,0,45,0,-45
8646,0,0,123,0,-123
8647,1,0,157,0,-157
8648,1,0,84,0,-84
8649,1,1,15,1258,1243
8650,1,0,94,0,-94
8651,0,0,33,0,-33
8652,1,0,20,0,-20
8653,1,0,34,0,-34
8654,1,1,952,1421,469
8655,1,0,36,0,-36
8656,1,0,39,0,-39
8657,1,0,43,0,-43
8658,1,1,461,1308,847
8659,0,0,20,0,-20
8660,1,0,7,0,-7
8661,1,1,451,1354,903
8662,0,0,108,0,-108
8663,1,0,12,0,-12
8664,0,0,61,0,-61
8665,0,0,4,0,-4
8666,0,0,19,0,-19
8667,1,0,11,0,-11
8668,0,0,10,0,-10
8669,1,0,118,0,-118
8670,1,1,302,3026,2724
8671,1,1,107,1311,1204
8672,0,0,2,0,-2
8673,1,1,542,2110,1568
8674,1,1,683,2745,2062
8675,1,1,803,1845,1042
8676,1,0,35,0,-35
8677,1,0,23,0,-23
8678,1,1,182,1555,1373
8679,1,0,53,0,-53
8680,1,1,431,1407,976
8681,1,0,246,0,-246
8682,1,0,67,0,-67
8683,1,1,151,1368,1217
8684,0,0,42,0,-42
8685,1,0,96,0,-96
8686,0,0,115,0,-115
8687,1,1,643,1684,1041
8688,1,0,9,0,-9
8689,1,0,3,0,-3
8690,1,0,52,0,-52
8691,1,0,77,0,-77
8692,1,1,616,1523,907
8693,1,0,15,0,-15
8694,0,0,22,0,-22
8695,0,0,32,0,-32
8696,0,0,35,0,-35
8697,0,0,26,0,-26
8698,0,0,188,0,-188
8699,0,0,28,0,-28
8700,1,0,164,0,-164
8701,1,1,178,1530,1352
8702,1,0,2,0,-2
8703,1,0,25,0,-25
8704,0,0,54,0,-54
8705,0,0,19,0,-19
8706,1,0,33,0,-33
8707,0,0,5,0,-5
8708,1,0,13,0,-13
8709,1,0,48,0,-48
8710,1,0,31,0,-31
8711,0,0,62,0,-62
8712,1,0,45,0,-45
8713,1,1,467,2228,1761
8714,1,1,648,1448,800
8715,0,0,7,0,-7
8716,0,0,12,0,-12
8717,0,0,57,0,-57
8718,1,1,522,1435,913
8719,1,0,48,0,-48
8720,1,1,121,1874,1753
8721,1,0,44,0,-44
8722,1,1,324,1262,938
8723,0,0,44,0,-44
8724,0,0,26,0,-26
8725,1,1,2578,2284,-294
8726,1,0,36,0,-36
8727,1,0,142,0,-142
8728,1,1,670,1264,594
8729,1,1,626,1282,656
8730,1,0,142,0,-142
8731,0,0,26,0,-26
8732,1,0,31,0,-31
8733,1,1,38,1489,1451
8734,1,0,87,0,-87
8735,1,0,4,0,-4
8736,1,0,62,0,-62
8737,1,0,6,0,-6
8738,1,0,97,0,-97
8739,1,1,150,1261,1111
8740,0,0,1,0,-1
8741,1,1,439,2389,1950
8742,0,0,78,0,-78
8743,1,1,282,1630,1348
8744,1,0,22,0,-22
8745,1,1,246,1656,1410
8746,1,1,452,1591,1139
8747,0,0,32,0,-32
8748,1,1,1136,1686,550
8749,0,0,41,0,-41
8750,0,0,18,0,-18
8751,0,0,53,0,-53
8752,1,0,41,0,-41
8753,1,0,71,0,-71
8754,0,0,70,0,-70
8755,1,1,41,1470,1429
8756,1,1,996,1548,552
8757,0,0,31,0,-31
8758,0,0,53,0,-53
8759,1,0,21,0,-21
8760,1,1,95,1240,1145
8761,0,0,55,0,-55
8762,0,0,85,0,-85
8763,1,1,73,3447,3374
8764,1,1,326,2708,2382
8765,0,0,36,0,-36
8766,1,1,994,1973,979
8767,1,0,0,0,0
8768,0,0,182,0,-182
8769,0,0,47,0,-47
8770,1,1,362,1575,1213
8771,1,1,350,1236,886
8772,1,0,5,0,-5
8773,1,1,435,1254,819
8774,0,0,63,0,-63
8775,0,0,84,0,-84
8776,1,1,104,1245,1141
8777,1,0,54,0,-54
8778,0,0,36,0,-36
8779,1,1,737,2562,1825
8780,0,0,15,0,-15
8781,1,1,225,1256,1031
8782,1,1,61,1359,1298
8783,0,0,11,0,-11
8784,0,0,135,0,-135
8785,0,0,1,0,-1
8786,0,0,4,0,-4
8787,0,0,25,0,-25
8788,0,0,52,0,-52
8789,0,0,60,0,-60
8790,0,0,22,0,-22
8791,1,1,307,1947,1640
8792,0,0,67,0,-67
8793,1,0,4,0,-4
8794,1,1,468,4416,3948
8795,0,0,27,0,-27
8796,0,0,22,0,-22
8797,0,0,89,0,-89
8798,0,0,28,0,-28
8799,1,0,1,0,-1
8800,1,0,12,0,-12
8801,1,1,747,1641,894
8802,1,0,0,0,0
8803,1,0,45,0,-45
8804,1,0,2,0,-2
8805,1,0,60,0,-60
8806,1,1,1552,1248,-304
8807,1,1,381,1484,1103
8808,1,0,5,0,-5
8809,1,1,161,1444,1283
8810,1,1,238,2150,1912
8811,1,0,37,0,-37
8812,0,0,22,0,-22
8813,1,1,360,1806,1446
8814,1,0,111,0,-111
8815,0,0,31,0,-31
8816,1,0,114,0,-114
8817,1,0,40,0,-40
8818,0,0,10,0,-10
8819,0,0,56,0,-56
8820,0,0,22,0,-22
8821,1,0,49,0,-49
8822,0,0,0,0,0
8823,1,0,18,0,-18
8824,1,1,254,1363,1109
8825,1,1,111,1904,1793
8826,1,1,345,1662,1317
8827,0,0,17,0,-17
8828,0,0,3,0,-3
8829,0,0,58,0,-58
8830,0,0,41,0,-41
8831,1,0,40,0,-40
8832,0,0,49,0,-49
8833,0,0,26,0,-26
8834,0,0,125,0,-125
8835,1,1,1302,1332,30
8836,1,0,51,0,-51
8837,0,0,35,0,-35
8838,1,0,8,0,-8
8839,1,0,49,0,-49
8840,1,0,29,0,-29
8841,1,1,670,1469,799
8842,0,0,27,0,-27
8843,0,0,1,0,-1
8844,1,1,59,2030,1971
8845,0,0,109,0,-109
8846,1,1,272,2056,1784
8847,0,0,42,0,-42
8848,1,0,84,0,-84
8849,0,0,54,0,-54
8850,1,0,60,0,-60
8851,1,1,386,1772,1386
8852,0,0,21,0,-21
8853,0,0,20,0,-20
8854,1,0,11,0,-11
8855,1,1,35,1251,1216
8856,1,1,330,2079,1749
8857,0,0,61,0,-61
8858,1,0,72,0,-72
8859,0,0,11,0,-11
8860,0,0,1,0,-1
8861,1,0,33,0,-33
8862,1,0,114,0,-114
8863,1,1,502,1493,991
8864,0,0,9,0,-9
8865,1,1,1909,1379,-530
8866,1,1,914,1378,464
8867,1,1,471,1586,1115
8868,1,1,8,5741,5733
8869,1,1,351,1278,927
8870,1,1,635,1656,1021
8871,1,1,497,1487,990
8872,0,0,31,0,-31
8873,1,1,480,1275,795
8874,0,0,26,0,-26
8875,1,1,436,1813,1377
8876,1,1,359,1816,1457
8877,1,0,62,0,-62
8878,1,1,971,1282,311
8879,1,1,521,1272,751
8880,0,0,41,0,-41
8881,1,1,1311,1353,42
8882,1,1,521,1252,731
8883,1,1,923,1350,427
8884,0,0,2,0,-2
8885,1,0,52,0,-52
8886,1,0,72,0,-72
8887,0,0,8,0,-8
8888,0,0,154,0,-154
8889,0,0,30,0,-30
8890,0,0,36,0,-36
8891,0,0,45,0,-45
8892,1,1,1308,1619,311
8893,1,0,80,0,-80
8894,1,1,1216,2370,1154
8895,0,0,24,0,-24
8896,1,1,251,3579,3328
8897,0,0,55,0,-55
8898,1,0,21,0,-21
8899,0,0,47,0,-47
8900,1,0,37,0,-37
8901,1,1,1334,1350,16
8902,1,0,65,0,-65
8903,1,0,65,0,-65
8904,0,0,20,0,-20
8905,1,1,335,1838,1503
8906,1,0,17,0,-17
8907,1,1,963,1301,338
8908,1,1,157,1388,1231
8909,1,1,897,1347,450
8910,1,0,0,0,0
8911,0,0,8,0,-8
8912,0,0,45,0,-45
8913,1,1,1671,1442,-229
8914,0,0,145,0,-145
8915,1,1,193,1271,1078
8916,1,1,305,1513,1208
8917,1,0,5,0,-5
8918,0,0,19,0,-19
8919,0,0,106,0,-106
8920,1,1,543,1430,887
8921,1,0,134,0,-134
8922,1,0,2,0,-2
8923,0,0,85,0,-85
8924,1,1,1253,1888,635
8925,0,0,37,0,-37
8926,1,0,50,0,-50
8927,0,0,86,0,-86
8928,0,0,68,0,-68
8929,1,1,301,2178,1877
8930,1,1,93,1308,1215
8931,1,1,104,1442,1338
8932,1,1,55,1563,1508
8933,1,1,139,1485,1346
8934,0,0,64,0,-64
8935,0,0,10,0,-10
8936,1,1,282,2676,2394
8937,1,0,27,0,-27
8938,0,0,49,0,-49
8939,1,1,866,2064,1198
8940,0,0,100,0,-100
8941,0,0,25,0,-25
8942,0,0,0,0,0
8943,1,0,5,0,-5
8944,0,0,0,0,0
8945,1,0,122,0,-122
8946,1,0,31,0,-31
8947,1,1,111,1504,1393
8948,1,1,925,1255,330
8949,0,0,33,0,-33
8950,0,0,4,0,-4
8951,1,0,3,0,-3
8952,0,0,15,0,-15
8953,1,1,492,1245,753
8954,1,1,568,1599,1031
8955,1,1,187,1491,1304
8956,0,0,17,0,-17
8957,0,0,41,0,-41
8958,0,0,9,0,-9
8959,1,0,6,0,-6
8960,0,0,20,0,-20
8961,1,0,35,0,-35
8962,0,0,46,0,-46
8963,1,0,1,0,-1
8964,0,0,37,0,-37
8965,1,0,23,0,-23
8966,0,0,109,0,-109
8967,1,0,30,0,-30
8968,0,0,84,0,-84
8969,1,1,730,1430,700
8970,1,0,0,0,0
8971,1,1,155,1272,1117
8972,1,1,420,1316,896
8973,1,1,976,1236,260
8974,1,1,224,1570,1346
8975,1,1,1947,1264,-683
8976,1,0,186,0,-186
8977,0,0,33,0,-33
8978,0,0,106,0,-106
8979,1,0,56,0,-56
8980,0,0,0,0,0
8981,1,0,289,0,-289
8982,0,0,32,0,-32
8983,1,1,1279,1351,72
8984,0,0,2,0,-2
8985,0,0,23,0,-23
8986,0,0,78,0,-78
8987,0,0,10,0,-10
8988,1,0,23,0,-23
8989,0,0,24,0,-24
8990,1,1,207,1899,1692
8991,1,1,223,1696,1473
8992,1,0,20,0,-20
8993,1,1,945,1476,531
8994,0,0,21,0,-21
8995,1,0,101,0,-101
8996,1,0,11,0,-11
8997,1,1,295,3507,3212
8998,1,0,25,0,-25
8999,1,1,230,3203,2973
9000,1,0,21,0,-21
9001,1,1,470,1982,1512
9002,0,0,198,0,-198
9003,0,0,73,0,-73
9004,1,0,2,0,-2
9005,1,0,86,0,-86
9006,1,1,123,1245,1122
9007,1,1,570,1404,834
9008,1,1,84,1333,1249
9009,0,0,34,0,-34
9010,1,1,1125,1390,265
9011,1,0,67,0,-67
9012,0,0,75,0,-75
9013,1,0,164,0,-164
9014,0,0,83,0,-83
9015,0,0,102,0,-102
9016,0,0,1,0,-1
9017,0,0,25,0,-25
9018,0,0,24,0,-24
9019,1,0,62,0,-62
9020,1,1,1927,1745,-182
9021,0,0,8,0,-8
9022,0,0,95,0,-95
9023,1,0,104,0,-104
9024,0,0,20,0,-20
9025,0,0,35,0,-35
9026,1,1,38,1402,1364
9027,0,0,22,0,-22
9028,1,1,326,1291,965
9029,1,0,43,0,-43
9030,1,1,1233,1470,237
9031,0,0,62,0,-62
9032,1,0,33,0,-33
9033,1,1,511,2526,2015
9034,1,1,384,1268,884
9035,0,0,188,0,-188
9036,0,0,11,0,-11
9037,1,0,111,0,-111
9038,0,0,17,0,-17
9039,1,1,134,1418,1284
9040,1,0,98,0,-98
9041,0,0,87,0,-87
9042,0,0,77,0,-77
9043,1,0,5,0,-5
9044,1,0,64,0,-64
9045,0,0,38,0,-38
9046,1,0,41,0,-41
9047,1,1,1037,2247,1210
9048,1,0,85,0,-85
9049,0,0,48,0,-48
9050,1,0,56,0,-56
9051,1,1,76,1344,1268
9052,1,1,391,1634,1243
9053,0,0,40,0,-40
9054,1,1,464,1497,1033
9055,1,0,36,0,-36
9056,0,0,22,0,-22
9057,1,1,261,2198,1937
9058,1,1,772,1267,495
9059,1,1,193,1829,1636
9060,0,0,1,0,-1
9061,1,0,83,0,-83
9062,0,0,65,0,-65
9063,0,0,82,0,-82
9064,0,0,114,0,-114
9065,1,1,672,1499,827
9066,0,0,1,0,-1
9067,0,0,71,0,-71
9068,1,1,218,1385,1167
9069,0,0,38,0,-38
9070,0,0,158,0,-158
9071,0,0,208,0,-208
9072,1,1,603,1881,1278
9073,1,1,54,1240,1186
9074,0,0,1,0,-1
9075,1,0,46,0,-46
9076,1,1,799,2762,1963
9077,0,0,56,0,-56
9078,1,1,649,1481,832
9079,1,0,51,0,-51
9080,1,0,127,0,-127
9081,1,0,105,0,-105
9082,0,0,35,0,-35
9083,0,0,149,0,-149
9084,0,0,18,0,-18
9085,0,0,89,0,-89
9086,0,0,112,0,-112
9087,0,0,15,0,-15
9088,1,0,15,0,-15
9089,0,0,34,0,-34
9090,0,0,21,0,-21
9091,0,0,6,0,-6
9092,1,0,36,0,-36
9093,1,0,142,0,-142
9094,1,1,61,1248,1187
9095,0,0,132,0,-132
9096,1,0,16,0,-16
9097,0,0,16,0,-16
9098,1,0,37,0,-37
9099,1,0,34,0,-34
9100,1,0,15,0,-15
9101,1,1,630,1435,805
9102,0,0,13,0,-13
9103,1,0,34,0,-34
9104,0,0,63,0,-63
9105,1,0,24,0,-24
9106,0,0,121,0,-121
9107,0,0,21,0,-21
9108,0,0,54,0,-54
9109,1,0,71,0,-71
9110,0,0,19,0,-19
9111,1,0,27,0,-27
9112,1,0,110,0,-110
9113,1,0,75,0,-75
9114,0,0,33,0,-33
9115,0,0,2,0,-2
9116,1,0,48,0,-48
9117,1,0,11,0,-11
9118,1,0,8,0,-8
9119,0,0,11,0,-11
9120,0,0,78,0,-78
9121,1,1,34,2020,1986
9122,1,0,6,0,-6
9123,1,1,255,1803,1548
9124,1,0,32,0,-32
9125,1,1,490,1995,1505
9126,1,0,199,0,-199
9127,1,0,96,0,-96
9128,1,0,1,0,-1
9129,0,0,28,0,-28
9130,1,1,174,1698,1524
9131,1,1,955,1359,404
9132,1,0,0,0,0
9133,1,0,1,0,-1
9134,1,1,147,1243,1096
9135,0,0,43,0,-43
9136,0,0,82,0,-82
9137,1,1,564,1787,1223
9138,1,1,865,1295,430
9139,0,0,4,0,-4
9140,1,1,956,1329,373
9141,0,0,21,0,-21
9142,1,0,31,0,-31
9143,1,1,209,1973,1764
9144,1,0,7,0,-7
9145,1,0,58,0,-58
9146,0,0,16,0,-16
9147,0,0,15,0,-15
9148,0,0,41,0,-41
9149,1,0,3,0,-3
9150,1,1,239,1868,1629
9151,1,0,20,0,-20
9152,1,1,158,1293,1135
9153,0,0,0,0,0
9154,1,0,111,0,-111
9155,1,0,3,0,-3
9156,0,0,10,0,-10
9157,0,0,4,0,-4
9158,0,0,8,0,-8
9159,1,0,7,0,-7
9160,1,1,1740,1458,-282
9161,0,0,94,0,-94
9162,1,0,31,0,-31
9163,0,0,126,0,-126
9164,0,0,77,0,-77
9165,0,0,55,0,-55
9166,0,0,19,0,-19
9167,0,0,59,0,-59
9168,0,0,31,0,-31
9169,1,1,693,1364,671
9170,1,0,114,0,-114
9171,1,0,27,0,-27
9172,0,0,85,0,-85
9173,1,1,155,1371,1216
9174,0,0,31,0,-31
9175,0,0,48,0,-48
9176,1,1,275,1395,1120
9177,0,0,81,0,-81
9178,1,0,14,0,-14
9179,1,0,9,0,-9
9180,0,0,17,0,-17
9181,1,1,336,1524,1188
9182,1,0,33,0,-33
9183,1,1,244,1450,1206
9184,1,1,302,2062,1760
9185,1,0,21,0,-21
9186,0,0,19,0,-19
9187,1,0,1,0,-1
9188,0,0,87,0,-87
9189,1,0,32,0,-32
9190,0,0,72,0,-72
9191,0,0,86,0,-86
9192,1,0,196,0,-196
9193,0,0,7,0,-7
9194,0,0,2,0,-2
9195,0,0,42,0,-42
9196,0,0,42,0,-42
9197,0,0,27,0,-27
9198,1,0,2,0,-2
9199,1,0,59,0,-59
9200,1,1,254,1278,1024
9201,1,1,191,1401,1210
9202,1,0,61,0,-61
9203,0,0,25,0,-25
9204,1,0,6,0,-6
9205,1,1,223,1512,1289
9206,0,0,18,0,-18
9207,1,0,15,0,-15
9208,1,1,377,1737,1360
9209,0,0,7,0,-7
9210,1,0,32,0,-32
9211,1,0,28,0,-28
9212,0,0,43,0,-43
9213,1,0,52,0,-52
9214,0,0,8,0,-8
9215,1,1,547,1331,784
9216,1,0,13,0,-13
9217,0,0,40,0,-40
9218,1,1,628,1760,1132
9219,0,0,97,0,-97
9220,1,1,666,1322,656
9221,1,0,42,0,-42
9222,0,0,24,0,-24
9223,0,0,34,0,-34
9224,1,0,23,0,-23
9225,1,1,166,1954,1788
9226,0,0,15,0,-15
9227,0,0,86,0,-86
9228,1,1,1292,1396,104
9229,1,0,53,0,-53
9230,1,0,31,0,-31
9231,1,0,22,0,-22
9232,0,0,27,0,-27
9233,1,0,63,0,-63
9234,1,1,602,1958,1356
9235,1,1,666,1475,809
9236,1,0,90,0,-90
9237,1,0,86,0,-86
9238,0,0,94,0,-94
9239,0,0,13,0,-13
9240,0,0,17,0,-17
9241,0,0,27,0,-27
9242,0,0,40,0,-40
9243,1,0,50,0,-50
9244,0,0,10,0,-10
9245,0,0,19,0,-19
9246,1,0,1,0,-1
9247,1,1,174,1292,1118
9248,1,0,7,0,-7
9249,0,0,1,0,-1
9250,1,0,35,0,-35
9251,1,1,60,1700,1640
9252,0,0,81,0,-81
9253,0,0,10,0,-10
9254,0,0,46,0,-46
9255,1,0,10,0,-10
9256,1,0,67,0,-67
9257,0,0,18,0,-18
9258,0,0,61,0,-61
9259,1,0,6,0,-6
9260,1,0,171,0,-171
9261,1,0,42,0,-42
9262,1,0,94,0,-94
9263,1,1,893,2224,1331
9264,1,1,315,2306,1991
9265,1,0,32,0,-32
9266,1,0,51,0,-51
9267,1,1,1170,2057,887
9268,0,0,4,0,-4
9269,1,1,477,1275,798
9270,1,1,54,2057,2003
9271,1,0,12,0,-12
9272,0,0,1,0,-1
9273,1,0,28,0,-28
9274,1,1,445,1263,818
9275,0,0,83,0,-83
9276,1,1,40,2081,2041
9277,0,0,24,0,-24
9278,1,1,97,1421,1324
9279,0,0,0,0,0
9280,0,0,113,0,-113
9281,0,0,69,0,-69
9282,0,0,146,0,-146
9283,1,1,1058,1396,338
9284,1,0,31,0,-31
9285,0,0,40,0,-40
9286,1,0,93,0,-93
9287,0,0,63,0,-63
9288,1,1,83,1347,1264
9289,1,0,52,0,-52
9290,0,0,19,0,-19
9291,0,0,0,0,0
9292,1,0,10,0,-10
9293,0,0,42,0,-42
9294,0,0,14,0,-14
9295,1,1,92,2327,2235
9296,1,1,285,1721,1436
9297,0,0,46,0,-46
9298,0,0,72,0,-72
9299,0,0,36,0,-36
9300,1,1,253,1387,1134
9301,1,0,44,0,-44
9302,1,0,11,0,-11
9303,1,1,274,1514,1240
9304,1,1,2362,1381,-981
9305,0,0,27,0,-27
9306,1,1,89,1336,1247
9307,0,0,159,0,-159
9308,1,1,123,1263,1140
9309,1,1,2100,1331,-769
9310,1,0,34,0,-34
9311,1,0,37,0,-37
9312,1,0,1,0,-1
9313,1,1,186,2551,2365
9314,1,0,2,0,-2
9315,1,0,2,0,-2
9316,1,1,79,1541,1462
9317,1,0,15,0,-15
9318,0,0,39,0,-39
9319,1,1,2925,1468,-1457
9320,0,0,31,0,-31
9321,1,1,250,1470,1220
9322,1,1,389,1750,1361
9323,0,0,64,0,-64
9324,1,0,42,0,-42
9325,1,1,717,2201,1484
9326,0,0,29,0,-29
9327,0,0,43,0,-43
9328,0,0,78,0,-78
9329,1,1,432,1273,841
9330,0,0,7,0,-7
9331,1,1,364,1928,1564
9332,0,0,175,0,-175
9333,0,0,1,0,-1
9334,1,1,245,1426,1181
9335,0,0,24,0,-24
9336,0,0,16,0,-16
9337,1,0,33,0,-33
9338,0,0,16,0,-16
9339,1,0,51,0,-51
9340,0,0,9,0,-9
9341,1,0,29,0,-29
9342,1,1,567,1376,809
9343,1,1,652,1324,672
9344,0,0,11,0,-11
9345,0,0,21,0,-21
9346,1,1,555,1253,698
9347,1,1,487,2694,2207
9348,1,0,103,0,-103
9349,0,0,51,0,-51
9350,0,0,89,0,-89
9351,0,0,273,0,-273
9352,0,0,26,0,-26
9353,0,0,27,0,-27
9354,1,0,23,0,-23
9355,1,0,235,0,-235
9356,1,0,107,0,-107
9357,0,0,29,0,-29
9358,1,0,95,0,-95
9359,1,1,121,1761,1640
9360,0,0,105,0,-105
9361,0,0,3,0,-3
9362,0,0,36,0,-36
9363,0,0,27,0,-27
9364,0,0,29,0,-29
9365,0,0,15,0,-15
9366,0,0,18,0,-18
9367,1,0,29,0,-29
9368,1,1,164,1304,1140
9369,1,1,577,1971,1394
9370,1,1,171,1438,1267
9371,0,0,236,0,-236
9372,0,0,101,0,-101
9373,1,0,206,0,-206
9374,1,1,751,1306,555
9375,0,0,5,0,-5
9376,0,0,12,0,-12
9377,0,0,5,0,-5
9378,1,0,8,0,-8
9379,1,0,86,0,-86
9380,1,0,208,0,-208
9381,0,0,41,0,-41
9382,1,0,25,0,-25
9383,1,1,166,1403,1237
9384,0,0,11,0,-11
9385,1,0,3,0,-3
9386,1,1,504,2098,1594
9387,0,0,19,0,-19
9388,1,0,56,0,-56
9389,1,1,456,1261,805
9390,1,0,50,0,-50
9391,1,1,710,1236,526
9392,1,1,1266,1335,69
9393,0,0,21,0,-21
9394,1,0,68,0,-68
9395,0,0,38,0,-38
9396,0,0,179,0,-179
9397,0,0,42,0,-42
9398,1,1,1299,1755,456
9399,0,0,29,0,-29
9400,1,1,973,1620,647
9401,1,1,139,1394,1255
9402,1,0,6,0,-6
9403,0,0,9,0,-9
9404,1,0,25,0,-25
9405,1,1,420,1300,880
9406,1,0,32,0,-32
9407,0,0,5,0,-5
9408,1,0,29,0,-29
9409,0,0,10,0,-10
9410,0,0,45,0,-45
9411,1,0,111,0,-111
9412,1,1,1711,1627,-84
9413,1,0,52,0,-52
9414,0,0,34,0,-34
9415,1,0,5,0,-5
9416,0,0,22,0,-22
9417,1,0,17,0,-17
9418,1,0,171,0,-171
9419,0,0,46,0,-46
9420,0,0,34,0,-34
9421,1,1,950,1315,365
9422,0,0,11,0,-11
9423,0,0,179,0,-179
9424,0,0,19,0,-19
9425,0,0,49,0,-49
9426,1,1,339,3922,3583
9427,1,1,186,1286,1100
9428,1,0,44,0,-44
9429,1,0,182,0,-182
9430,1,0,41,0,-41
9431,0,0,47,0,-47
9432,0,0,27,0,-27
9433,0,0,23,0,-23
9434,1,1,831,2126,1295
9435,0,0,0,0,0
9436,0,0,20,0,-20
9437,0,0,1,0,-1
9438,1,0,22,0,-22
9439,0,0,12,0,-12
9440,0,0,16,0,-16
9441,1,0,11,0,-11
9442,1,0,3,0,-3
9443,1,0,42,0,-42
9444,1,1,247,1996,1749
9445,0,0,28,0,-28
9446,1,0,1,0,-1
9447,0,0,46,0,-46
9448,0,0,109,0,-109
9449,1,0,31,0,-31
9450,1,0,46,0,-46
9451,1,1,1709,1676,-33
9452,1,1,1610,2585,975
9453,1,1,215,1292,1077
9454,0,0,16,0,-16
9455,1,1,345,1669,1324
9456,0,0,11,0,-11
9457,1,1,25,1392,1367
9458,1,0,83,0,-83
9459,0,0,12,0,-12
9460,0,0,221,0,-221
9461,1,1,142,1405,1263
9462,0,0,14,0,-14
9463,0,0,75,0,-75
9464,0,0,1,0,-1
9465,1,0,53,0,-53
9466,1,0,0,0,0
9467,0,0,67,0,-67
9468,1,0,92,0,-92
9469,0,0,18,0,-18
9470,1,0,23,0,-23
9471,1,0,8,0,-8
9472,0,0,43,0,-43
9473,0,0,33,0,-33
9474,0,0,149,0,-149
9475,0,0,4,0,-4
9476,0,0,4,0,-4
9477,1,1,719,1738,1019
9478,1,0,37,0,-37
9479,1,1,364,1355,991
9480,1,0,34,0,-34
9481,0,0,100,0,-100
9482,1,1,300,1314,1014
9483,0,0,0,0,0
9484,1,0,39,0,-39
9485,1,0,77,0,-77
9486,0,0,71,0,-71
9487,1,1,88,1341,1253
9488,0,0,53,0,-53
9489,0,0,27,0,-27
9490,0,0,32,0,-32
9491,0,0,91,0,-91
9492,1,0,26,0,-26
9493,0,0,23,0,-23
9494,1,0,139,0,-139
9495,1,1,952,1274,322
9496,1,1,481,1267,786
9497,0,0,16,0,-16
9498,1,0,43,0,-43
9499,1,0,26,0,-26
9500,1,0,4,0,-4
9501,0,0,12,0,-12
9502,0,0,152,0,-152
9503,1,1,1141,1656,515
9504,1,0,83,0,-83
9505,1,0,87,0,-87
9506,1,1,1226,1388,162
9507,0,0,94,0,-94
9508,1,0,34,0,-34
9509,0,0,51,0,-51
9510,1,0,42,0,-42
9511,1,1,353,1246,893
9512,1,1,441,1294,853
9513,1,1,1562,1397,-165
9514,0,0,49,0,-49
9515,1,1,454,1702,1248
9516,0,0,31,0,-31
9517,0,0,10,0,-10
9518,1,0,26,0,-26
9519,1,1,607,2968,2361
9520,1,0,178,0,-178
9521,1,0,79,0,-79
9522,1,1,88,1575,1487
9523,0,0,27,0,-27
9524,1,1,63,1644,1581
9525,0,0,46,0,-46
9526,0,0,5,0,-5
9527,1,1,1642,1449,-193
9528,1,1,567,1316,749
9529,0,0,41,0,-41
9530,0,0,9,0,-9
9531,1,0,10,0,-10
9532,1,0,44,0,-44
9533,0,0,80,0,-80
9534,0,0,25,0,-25
9535,1,1,819,3478,2659
9536,1,1,164,1394,1230
9537,0,0,44,0,-44
9538,1,0,4,0,-4
9539,0,0,158,0,-158
9540,0,0,112,0,-112
9541,0,0,19,0,-19
9542,1,0,34,0,-34
9543,0,0,20,0,-20
9544,1,1,300,1246,946
9545,0,0,36,0,-36
9546,0,0,18,0,-18
9547,0,0,0,0,0
9548,1,1,921,1414,493
9549,1,0,92,0,-92
9550,1,1,37,1655,1618
9551,0,0,50,0,-50
9552,0,0,27,0,-27
9553,1,0,1,0,-1
9554,1,0,123,0,-123
9555,1,1,135,1339,1204
9556,1,1,61,1279,1218
9557,1,1,140,1270,1130
9558,1,1,957,1450,493
9559,1,0,11,0,-11
9560,0,0,47,0,-47
9561,1,1,99,1388,1289
9562,0,0,17,0,-17
9563,0,0,17,0,-17
9564,0,0,9,0,-9
9565,0,0,74,0,-74
9566,1,0,79,0,-79
9567,1,1,1452,1690,238
9568,1,1,1084,1913,829
9569,1,1,360,1300,940
9570,0,0,50,0,-50
9571,1,0,21,0,-21
9572,1,1,475,1282,807
9573,1,0,37,0,-37
9574,1,0,141,0,-141
9575,1,1,56,1621,1565
9576,1,1,122,1264,1142
9577,0,0,16,0,-16
9578,1,0,12,0,-12
9579,0,0,85,0,-85
9580,0,0,33,0,-33
9581,1,1,731,4063,3332
9582,0,0,172,0,-172
9583,0,0,4,0,-4
9584,0,0,45,0,-45
9585,0,0,3,0,-3
9586,1,0,35,0,-35
9587,0,0,2,0,-2
9588,1,0,3,0,-3
9589,1,0,330,0,-330
9590,1,0,55,0,-55
9591,1,0,39,0,-39
9592,1,1,248,1296,1048
9593,0,0,176,0,-176
9594,1,1,329,1596,1267
9595,0,0,19,0,-19
9596,1,1,56,1280,1224
9597,0,0,167,0,-167
9598,0,0,10,0,-10
9599,0,0,63,0,-63
9600,1,0,21,0,-21
9601,1,0,27,0,-27
9602,1,1,7,2110,2103
9603,1,0,37,0,-37
9604,1,0,11,0,-11
9605,0,0,16,0,-16
9606,1,1,45,1371,1326
9607,0,0,32,0,-32
9608,1,1,111,2256,2145
9609,0,0,58,0,-58
9610,0,0,0,0,0
9611,0,0,11,0,-11
9612,1,1,365,1328,963
9613,1,0,63,0,-63
9614,0,0,2,0,-2
9615,1,0,0,0,0
9616,1,0,50,0,-50
9617,1,1,3180,1413,-1767
9618,0,0,4,0,-4
9619,1,1,722,1781,1059
9620,1,0,41,0,-41
9621,0,0,36,0,-36
9622,0,0,149,0,-149
9623,0,0,62,0,-62
9624,1,1,1199,1709,510
9625,0,0,116,0,-116
9626,1,0,0,0,0
9627,0,0,31,0,-31
9628,0,0,102,0,-102
9629,1,0,39,0,-39
9630,1,1,703,1365,662
9631,1,1,407,2623,2216
9632,0,0,7,0,-7
9633,0,0,10,0,-10
9634,1,1,795,1477,682
9635,1,0,35,0,-35
9636,0,0,10,0,-10
9637,0,0,1,0,-1
9638,1,1,2427,1254,-1173
9639,1,0,41,0,-41
9640,0,0,124,0,-124
9641,1,1,1744,1346,-398
9642,1,0,34,0,-34
9643,1,1,829,1332,503
9644,1,1,583,1247,664
9645,1,1,38,1829,1791
9646,0,0,54,0,-54
9647,1,1,289,1583,1294
9648,1,1,464,1776,1312
9649,1,1,89,1477,1388
9650,1,0,51,0,-51
9651,0,0,118,0,-118
9652,1,1,326,1477,1151
9653,0,0,62,0,-62
9654,1,1,227,1363,1136
9655,1,1,72,1610,1538
9656,1,1,336,2286,1950
9657,1,1,1670,1420,-250
9658,1,1,48,1495,1447
9659,1,1,1588,1241,-347
9660,1,0,11,0,-11
9661,1,1,724,1539,815
9662,0,0,66,0,-66
9663,0,0,44,0,-44
9664,1,0,41,0,-41
9665,1,0,99,0,-99
9666,1,0,47,0,-47
9667,1,0,53,0,-53
9668,1,1,802,1420,618
9669,1,1,108,1453,1345
9670,1,0,85,0,-85
9671,0,0,14,0,-14
9672,1,0,18,0,-18
9673,1,0,6,0,-6
9674,1,0,23,0,-23
9675,1,0,61,0,-61
9676,1,1,167,2471,2304
9677,1,0,67,0,-67
9678,0,0,29,0,-29
9679,1,0,35,0,-35
9680,1,1,45,1687,1642
9681,1,1,1133,1356,223
9682,0,0,22,0,-22
9683,0,0,63,0,-63
9684,1,1,944,1254,310
9685,1,1,246,1319,1073
9686,1,0,121,0,-121
9687,1,0,25,0,-25
9688,1,1,488,1770,1282
9689,1,1,154,1275,1121
9690,1,0,12,0,-12
9691,1,1,238,2086,1848
9692,1,0,107,0,-107
9693,1,1,753,1586,833
9694,0,0,10,0,-10
9695,1,0,36,0,-36
9696,1,0,61,0,-61
9697,0,0,14,0,-14
9698,1,1,537,2485,1948
9699,1,1,1577,3504,1927
9700,1,1,122,1618,1496
9701,1,0,2,0,-2
9702,1,1,973,1352,379
9703,0,0,211,0,-211
9704,0,0,9,0,-9
9705,0,0,13,0,-13
9706,1,0,20,0,-20
9707,0,0,37,0,-37
9708,1,1,1111,1430,319
9709,1,1,786,1686,900
9710,0,0,22,0,-22
9711,1,1,296,2014,1718
9712,0,0,14,0,-14
9713,1,1,732,1490,758
9714,0,0,12,0,-12
9715,1,1,577,1370,793
9716,0,0,103,0,-103
9717,1,0,52,0,-52
9718,0,0,112,0,-112
9719,0,0,9,0,-9
9720,1,0,39,0,-39
9721,1,1,80,1242,1162
9722,0,0,23,0,-23
9723,0,0,63,0,-63
9724,1,1,501,1954,1453
9725,1,0,8,0,-8
9726,0,0,35,0,-35
9727,1,1,187,1342,1155
9728,1,1,433,1486,1053
9729,1,1,102,1324,1222
9730,0,0,34,0,-34
9731,1,0,12,0,-12
9732,1,0,25,0,-25
9733,1,1,238,1972,1734
9734,1,1,79,1552,1473
9735,0,0,35,0,-35
9736,0,0,48,0,-48
9737,0,0,3,0,-3
9738,1,0,19,0,-19
9739,0,0,5,0,-5
9740,1,0,87,0,-87
9741,1,1,116,1496,1380
9742,1,1,909,2649,1740
9743,0,0,34,0,-34
9744,1,1,665,1621,956
9745,0,0,195,0,-195
9746,1,0,42,0,-42
9747,1,0,98,0,-98
9748,1,1,654,2898,2244
9749,0,0,44,0,-44
9750,0,0,37,0,-37
9751,1,0,21,0,-21
9752,1,1,356,1270,914
9753,0,0,135,0,-135
9754,1,1,277,1290,1013
9755,1,1,381,1763,1382
9756,0,0,32,0,-32
9757,0,0,9,0,-9
9758,1,0,6,0,-6
9759,1,1,732,2219,1487
9760,1,1,255,1519,1264
9761,0,0,90,0,-90
9762,1,1,63,1287,1224
9763,0,0,34,0,-34
9764,1,1,35,1809,1774
9765,0,0,10,0,-10
9766,0,0,14,0,-14
9767,1,0,58,0,-58
9768,1,1,1705,2142,437
9769,1,1,951,1304,353
9770,0,0,66,0,-66
9771,1,0,50,0,-50
9772,0,0,72,0,-72
9773,1,0,44,0,-44
9774,1,0,112,0,-112
9775,1,1,327,1563,1236
9776,1,1,58,1256,1198
9777,1,1,170,1360,1190
9778,1,0,46,0,-46
9779,1,1,575,1276,701
9780,1,1,962,1332,370
9781,1,0,43,0,-43
9782,1,0,12,0,-12
9783,0,0,36,0,-36
9784,1,1,220,1559,1339
9785,1,0,8,0,-8
9786,0,0,55,0,-55
9787,0,0,24,0,-24
9788,1,1,330,1424,1094
9789,1,1,563,1442,879
9790,1,0,34,0,-34
9791,1,0,17,0,-17
9792,1,0,10,0,-10
9793,0,0,7,0,-7
9794,1,1,111,1713,1602
9795,0,0,41,0,-41
9796,1,0,6,0,-6
9797,1,1,271,1257,986
9798,0,0,108,0,-108
9799,1,0,44,0,-44
9800,0,0,90,0,-90
9801,0,0,45,0,-45
9802,1,0,10,0,-10
9803,1,0,33,0,-33
9804,1,0,0,0,0
9805,1,1,411,1488,1077
9806,1,0,28,0,-28
9807,1,1,95,2159,2064
9808,1,1,598,1297,699
9809,1,1,77,1597,1520
9810,1,1,1063,2082,1019
9811,0,0,3,0,-3
9812,0,0,103,0,-103
9813,1,0,54,0,-54
9814,1,0,4,0,-4
9815,0,0,49,0,-49
9816,0,0,15,0,-15
9817,0,0,2,0,-2
9818,1,1,409,1332,923
9819,1,0,21,0,-21
9820,1,1,332,1466,1134
9821,1,0,72,0,-72
9822,0,0,193,0,-193
9823,1,1,371,1301,930
9824,0,0,49,0,-49
9825,1,0,4,0,-4
9826,1,1,484,1333,849
9827,1,0,53,0,-53
9828,0,0,105,0,-105
9829,1,1,103,1759,1656
9830,0,0,45,0,-45
9831,1,0,51,0,-51
9832,1,1,397,1544,1147
9833,1,0,116,0,-116
9834,1,1,852,1641,789
9835,0,0,207,0,-207
9836,0,0,75,0,-75
9837,0,0,85,0,-85
9838,1,0,31,0,-31
9839,1,0,27,0,-27
9840,0,0,90,0,-90
9841,0,0,6,0,-6
9842,1,1,347,1316,969
9843,0,0,106,0,-106
9844,1,1,1512,1442,-70
9845,1,0,95,0,-95
9846,0,0,3,0,-3
9847,1,0,82,0,-82
9848,1,1,618,1392,774
9849,0,0,58,0,-58
9850,0,0,4,0,-4
9851,0,0,32,0,-32
9852,1,1,733,1313,580
9853,1,1,137,1319,1182
9854,1,1,309,1981,1672
9855,1,1,32,1413,1381
9856,0,0,100,0,-100
9857,1,0,97,0,-97
9858,0,0,40,0,-40
9859,1,0,2,0,-2
9860,1,0,18,0,-18
9861,1,1,333,1396,1063
9862,0,0,50,0,-50
9863,1,1,1218,1730,512
9864,0,0,147,0,-147
9865,1,1,394,1379,985
9866,0,0,27,0,-27
9867,1,0,112,0,-112
9868,1,1,128,1617,1489
9869,0,0,50,0,-50
9870,0,0,121,0,-121
9871,1,1,494,1284,790
9872,1,0,30,0,-30
9873,0,0,42,0,-42
9874,0,0,44,0,-44
9875,0,0,43,0,-43
9876,1,1,686,1423,737
9877,1,1,74,1450,1376
9878,1,0,59,0,-59
9879,0,0,15,0,-15
9880,1,0,4,0,-4
9881,1,0,32,0,-32
9882,1,0,22,0,-22
9883,1,1,477,1354,877
9884,1,0,54,0,-54
9885,1,0,56,0,-56
9886,1,1,272,1262,990
9887,1,1,97,1549,1452
9888,1,1,262,1542,1280
9889,1,0,26,0,-26
9890,1,1,158,2842,2684
9891,1,1,422,1460,1038
9892,1,1,249,1320,1071
9893,0,0,49,0,-49
9894,0,0,0,0,0
9895,1,1,318,1369,1051
9896,1,0,81,0,-81
9897,1,1,323,1664,1341
9898,0,0,8,0,-8
9899,0,0,72,0,-72
9900,1,0,131,0,-131
9901,1,1,45,1788,1743
9902,0,0,2,0,-2
9903,1,1,88,1412,1324
9904,1,1,201,1473,1272
9905,1,1,524,1264,740
9906,1,0,32,0,-32
9907,1,0,19,0,-19
9908,1,0,20,0,-20
9909,0,0,2,0,-2
9910,1,0,0,0,0
9911,0,0,19,0,-19
9912,1,0,380,0,-380
9913,1,1,1426,1377,-49
9914,1,1,251,2329,2078
9915,0,0,36,0,-36
9916,1,0,101,0,-101
9917,0,0,2,0,-2
9918,0,0,53,0,-53
9919,1,0,4,0,-4
9920,1,0,56,0,-56
9921,0,0,84,0,-84
9922,1,0,47,0,-47
9923,0,0,63,0,-63
9924,1,1,996,1947,951
9925,0,0,46,0,-46
9926,1,1,766,1237,471
9927,0,0,32,0,-32
9928,0,0,15,0,-15
9929,0,0,149,0,-149
9930,1,0,10,0,-10
9931,1,1,1385,1499,114
9932,0,0,108,0,-108
9933,1,1,370,1284,914
9934,0,0,21,0,-21
9935,1,1,272,2044,1772
9936,1,1,355,1833,1478
9937,1,0,70,0,-70
9938,0,0,24,0,-24
9939,1,0,12,0,-12
9940,1,0,76,0,-76
9941,0,0,41,0,-41
9942,1,0,66,0,-66
9943,1,1,145,1557,1412
9944,1,1,590,1881,1291
9945,1,0,210,0,-210
9946,1,0,45,0,-45
9947,1,1,384,1641,1257
9948,0,0,2,0,-2
9949,0,0,53,0,-53
9950,0,0,26,0,-26
9951,1,0,19,0,-19
9952,0,0,198,0,-198
9953,0,0,52,0,-52
9954,0,0,17,0,-17
9955,0,0,87,0,-87
9956,0,0,22,0,-22
9957,0,0,31,0,-31
9958,1,1,384,1267,883
9959,0,0,8,0,-8
9960,1,0,23,0,-23
9961,1,1,398,1318,920
9962,1,1,503,1628,1125
9963,0,0,0,0,0
9964,0,0,47,0,-47
9965,1,0,41,0,-41
9966,0,0,179,0,-179
9967,1,1,94,1616,1522
9968,1,0,14,0,-14
9969,1,0,37,0,-37
9970,1,0,11,0,-11
9971,0,0,91,0,-91
9972,1,1,506,6780,6274
9973,0,0,68,0,-68
9974,1,0,11,0,-11
9975,0,0,176,0,-176
9976,1,1,478,1408,930
9977,0,0,1,0,-1
9978,0,0,65,0,-65
9979,1,0,15,0,-15
9980,1,0,13,0,-13
9981,1,0,6,0,-6
9982,1,1,249,1939,1690
9983,1,0,8,0,-8
9984,1,0,21,0,-21
9985,0,0,34,0,-34
9986,1,1,43,1332,1289
9987,0,0,25,0,-25
9988,1,1,654,2167,1513
9989,0,0,53,0,-53
9990,1,1,452,1397,945
9991,1,1,152,1311,1159
9992,1,0,7,0,-7
9993,1,1,314,4028,3714
9994,1,1,396,1489,1093
9995,0,0,57,0,-57
9996,1,0,38,0,-38
9997,1,0,256,0,-256
9998,0,0,31,0,-31
9999,1,0,175,0,-175
10000,1,0,1,0,-1
10001,1,1,516,1873,1357
10002,0,0,20,0,-20
10003,0,0,11,0,-11
10004,1,0,85,0,-85
10005,1,1,511,4323,3812
10006,1,1,22,1455,1433
10007,1,0,6,0,-6
10008,1,1,151,1410,1259
10009,1,1,139,1293,1154
10010,1,0,66,0,-66
10011,0,0,7,0,-7
10012,0,0,31,0,-31
10013,0,0,60,0,-60
10014,0,0,139,0,-139
10015,1,1,324,1311,987
10016,0,0,47,0,-47
10017,1,0,27,0,-27
10018,1,0,83,0,-83
10019,0,0,94,0,-94
10020,1,0,12,0,-12
10021,1,1,193,1420,1227
10022,1,0,86,0,-86
10023,0,0,58,0,-58
10024,1,1,84,1680,1596
10025,0,0,21,0,-21
10026,0,0,25,0,-25
10027,0,0,15,0,-15
10028,1,0,13,0,-13
10029,1,0,99,0,-99
10030,0,0,31,0,-31
10031,0,0,162,0,-162
10032,1,0,31,0,-31
10033,0,0,3,0,-3
10034,1,0,4,0,-4
10035,1,1,146,1705,1559
10036,0,0,63,0,-63
10037,1,1,313,2294,1981
10038,1,0,19,0,-19
10039,1,1,689,1310,621
10040,0,0,6,0,-6
10041,1,1,316,1289,973
10042,0,0,179,0,-179
10043,1,0,386,0,-386
10044,0,0,53,0,-53
10045,1,0,30,0,-30
10046,1,1,68,1792,1724
10047,1,1,151,1265,1114
10048,1,0,0,0,0
10049,0,0,52,0,-52
10050,1,1,139,1355,1216
10051,0,0,52,0,-52
10052,1,0,27,0,-27
10053,1,1,266,1328,1062
10054,1,0,20,0,-20
10055,1,0,32,0,-32
10056,0,0,2,0,-2
10057,1,0,31,0,-31
10058,1,0,16,0,-16
10059,1,1,659,1974,1315
10060,1,1,278,1344,1066
10061,0,0,137,0,-137
10062,1,1,20,1591,1571
10063,1,1,129,1774,1645
10064,1,0,38,0,-38
10065,1,1,1221,1248,27
10066,1,1,52,2091,2039
10067,1,1,288,1837,1549
10068,1,0,14,0,-14
10069,1,0,20,0,-20
10070,0,0,48,0,-48
10071,1,1,107,1350,1243
10072,1,0,26,0,-26
10073,1,1,185,2559,2374
10074,1,1,151,2794,2643
10075,1,1,436,1755,1319
10076,1,1,168,3026,2858
10077,1,0,105,0,-105
10078,1,0,9,0,-9
10079,1,1,26,1433,1407
10080,0,0,34,0,-34
10081,1,1,267,1250,983
10082,1,0,262,0,-262
10083,0,0,109,0,-109
10084,1,1,159,1430,1271
10085,1,1,584,2065,1481
10086,0,0,63,0,-63
10087,0,0,27,0,-27
10088,1,1,139,1506,1367
10089,1,1,147,1271,1124
10090,1,1,453,1677,1224
10091,0,0,12,0,-12
10092,0,0,26,0,-26
10093,1,1,914,1337,423
10094,1,1,333,1502,1169
10095,1,1,117,1553,1436
10096,1,1,930,1283,353
10097,0,0,92,0,-92
10098,1,0,153,0,-153
10099,1,0,24,0,-24
10100,0,0,51,0,-51
10101,0,0,70,0,-70
10102,0,0,29,0,-29
10103,1,1,663,1254,591
10104,1,0,50,0,-50
10105,0,0,37,0,-37
10106,1,1,372,1787,1415
10107,1,0,24,0,-24
10108,1,0,3,0,-3
10109,0,0,13,0,-13
10110,1,0,18,0,-18
10111,0,0,93,0,-93
10112,1,0,57,0,-57
10113,1,0,28,0,-28
10114,1,0,51,0,-51
10115,0,0,49,0,-49
10116,0,0,77,0,-77
10117,0,0,51,0,-51
10118,1,1,293,1363,1070
10119,1,1,494,1463,969
10120,1,1,658,1530,872
10121,0,0,60,0,-60
10122,0,0,1,0,-1
10123,1,0,7,0,-7
10124,1,1,555,6201,5646
10125,0,0,123,0,-123
10126,1,1,1849,1383,-466
10127,1,1,145,1341,1196
10128,1,0,37,0,-37
10129,0,0,47,0,-47
10130,0,0,65,0,-65
10131,1,1,219,1334,1115
10132,1,1,687,1425,738
10133,1,0,62,0,-62
10134,1,0,51,0,-51
10135,1,0,2,0,-2
10136,1,0,28,0,-28
10137,0,0,25,0,-25
10138,1,1,288,1333,1045
10139,1,1,271,1370,1099
10140,1,0,208,0,-208
10141,1,0,76,0,-76
10142,0,0,97,0,-97
10143,0,0,5,0,-5
10144,1,1,117,1326,1209
10145,0,0,129,0,-129
10146,1,0,0,0,0
10147,1,1,257,2883,2626
10148,0,0,48,0,-48
10149,1,1,867,1240,373
10150,1,1,420,1371,951
10151,1,1,289,2254,1965
10152,1,0,23,0,-23
10153,1,1,1485,1552,67
10154,1,1,3626,1245,-2381
10155,1,0,0,0,0
10156,1,1,145,1644,1499
10157,1,0,97,0,-97
10158,1,1,580,1742,1162
10159,1,0,16,0,-16
10160,1,1,869,2451,1582
10161,1,0,9,0,-9
10162,1,0,38,0,-38
10163,0,0,53,0,-53
10164,1,1,1400,1417,17
10165,0,0,35,0,-35
10166,1,1,835,1360,525
10167,0,0,27,0,-27
10168,0,0,35,0,-35
10169,1,1,801,1749,948
10170,1,1,350,1573,1223
10171,0,0,18,0,-18
10172,0,0,4,0,-4
10173,1,0,8,0,-8
10174,1,0,9,0,-9
10175,1,0,150,0,-150
10176,0,0,32,0,-32
10177,1,1,323,1759,1436
10178,1,1,286,3058,2772
10179,1,1,270,1788,1518
10180,1,0,0,0,0
10181,1,1,522,1368,846
10182,1,1,710,1301,591
10183,0,0,1,0,-1
10184,0,0,8,0,-8
10185,0,0,34,0,-34
10186,0,0,10,0,-10
10187,1,0,121,0,-121
10188,1,0,17,0,-17
10189,1,1,182,2529,2347
10190,1,1,414,1318,904
10191,1,0,80,0,-80
10192,1,1,424,1367,943
10193,0,0,20,0,-20
10194,1,1,424,1758,1334
10195,1,1,1156,1641,485
10196,0,0,36,0,-36
10197,0,0,14,0,-14
10198,0,0,80,0,-80
10199,1,0,156,0,-156
10200,0,0,18,0,-18
10201,1,1,367,2660,2293
10202,1,0,149,0,-149
10203,0,0,126,0,-126
10204,0,0,10,0,-10
10205,0,0,12,0,-12
10206,1,0,69,0,-69
10207,1,1,1358,1530,172
10208,1,0,17,0,-17
10209,1,1,136,1613,1477
10210,1,1,25,1436,1411
10211,0,0,194,0,-194
10212,1,1,780,2291,1511
10213,0,0,47,0,-47
10214,1,1,2127,2740,613
10215,1,0,5,0,-5
10216,1,1,376,1564,1188
10217,0,0,8,0,-8
10218,1,0,46,0,-46
10219,1,0,20,0,-20
10220,1,1,254,1373,1119
10221,0,0,81,0,-81
10222,0,0,8,0,-8
10223,0,0,17,0,-17
10224,0,0,20,0,-20
10225,1,1,113,1309,1196
10226,0,0,18,0,-18
10227,1,1,806,1235,429
10228,0,0,15,0,-15
10229,1,0,93,0,-93
10230,1,0,68,0,-68
10231,1,0,28,0,-28
10232,1,0,33,0,-33
10233,1,1,100,2604,2504
10234,1,1,116,1574,1458
10235,1,0,44,0,-44
10236,0,0,23,0,-23
10237,0,0,145,0,-145
10238,1,1,432,1380,948
10239,1,1,138,1342,1204
10240,1,1,642,1288,646
10241,0,0,7,0,-7
10242,1,1,321,1465,1144
10243,1,0,46,0,-46
10244,1,1,254,1566,1312
10245,0,0,26,0,-26
10246,1,1,506,1334,828
10247,0,0,5,0,-5
10248,1,1,568,1278,710
10249,0,0,28,0,-28
10250,0,0,24,0,-24
10251,0,0,204,0,-204
10252,0,0,9,0,-9
10253,1,0,67,0,-67
10254,1,1,58,1336,1278
10255,1,0,75,0,-75
10256,1,0,23,0,-23
10257,1,0,42,0,-42
10258,1,0,18,0,-18
10259,1,1,178,1875,1697
10260,1,1,1702,1554,-148
10261,1,1,521,1943,1422
10262,0,0,14,0,-14
10263,1,1,139,2415,2276
10264,1,1,304,1311,1007
10265,1,0,44,0,-44
10266,1,0,1,0,-1
10267,1,0,202,0,-202
10268,1,0,20,0,-20
10269,0,0,4,0,-4
10270,1,0,4,0,-4
10271,0,0,35,0,-35
10272,0,0,9,0,-9
10273,0,0,1,0,-1
10274,0,0,0,0,0
10275,1,1,140,1598,1458
10276,0,0,6,0,-6
10277,1,0,6,0,-6
10278,1,0,24,0,-24
10279,1,0,55,0,-55
10280,0,0,34,0,-34
10281,1,1,49,1253,1204
10282,0,0,8,0,-8
10283,1,0,24,0,-24
10284,0,0,10,0,-10
10285,1,0,49,0,-49
10286,1,1,1932,1453,-479
10287,1,0,148,0,-148
10288,1,1,481,1242,761
10289,1,1,452,1285,833
10290,1,1,351,2005,1654
10291,0,0,61,0,-61
10292,0,0,16,0,-16
10293,0,0,18,0,-18
10294,1,0,9,0,-9
10295,1,0,6,0,-6
10296,1,0,7,0,-7
10297,1,0,23,0,-23
10298,0,0,24,0,-24
10299,1,0,79,0,-79
10300,0,0,10,0,-10
10301,0,0,64,0,-64
10302,1,1,690,1394,704
10303,0,0,20,0,-20
10304,1,0,100,0,-100
10305,0,0,25,0,-25
10306,1,0,23,0,-23
10307,0,0,24,0,-24
10308,0,0,5,0,-5
10309,0,0,8,0,-8
10310,1,0,14,0,-14
10311,0,0,9,0,-9
10312,1,0,10,0,-10
10313,1,1,886,1274,388
10314,1,0,22,0,-22
10315,1,0,45,0,-45
10316,0,0,16,0,-16
10317,1,1,587,1750,1163
10318,1,0,4,0,-4
10319,0,0,7,0,-7
10320,1,1,453,1358,905
10321,1,0,10,0,-10
10322,1,1,93,1680,1587
10323,0,0,2,0,-2
10324,1,0,148,0,-148
10325,1,0,39,0,-39
10326,0,0,38,0,-38
10327,0,0,63,0,-63
10328,0,0,26,0,-26
10329,0,0,18,0,-18
10330,1,1,791,1663,872
10331,1,0,19,0,-19
10332,1,1,1004,1870,866
10333,1,0,73,0,-73
10334,0,0,273,0,-273
10335,1,1,271,1262,991
10336,1,0,51,0,-51
10337,1,1,920,1486,566
10338,1,1,220,1299,1079
10339,0,0,34,0,-34
10340,1,1,47,1683,1636
10341,1,0,8,0,-8
10342,0,0,89,0,-89
10343,0,0,13,0,-13
10344,0,0,0,0,0
10345,0,0,28,0,-28
10346,1,1,1507,1294,-213
10347,1,1,1523,2329,806
10348,0,0,22,0,-22
10349,1,0,44,0,-44
10350,0,0,0,0,0
10351,0,0,22,0,-22
10352,0,0,147,0,-147
10353,1,0,30,0,-30
10354,0,0,40,0,-40
10355,1,1,104,1422,1318
10356,1,1,485,1295,810
10357,0,0,121,0,-121
10358,1,0,43,0,-43
10359,1,0,6,0,-6
10360,0,0,3,0,-3
10361,1,0,31,0,-31
10362,1,0,5,0,-5
10363,0,0,66,0,-66
10364,0,0,19,0,-19
10365,1,1,461,2569,2108
10366,1,1,132,1510,1378
10367,1,1,320,1401,1081
10368,0,0,7,0,-7
10369,0,0,50,0,-50
10370,0,0,70,0,-70
10371,1,1,745,1780,1035
10372,0,0,60,0,-60
10373,1,1,554,1648,1094
10374,1,1,58,1319,1261
10375,1,0,136,0,-136
10376,0,0,42,0,-42
10377,1,1,1271,3620,2349
10378,0,0,53,0,-53
10379,0,0,15,0,-15
10380,1,0,183,0,-183
10381,0,0,39,0,-39
10382,1,0,17,0,-17
10383,1,0,58,0,-58
10384,1,1,1243,1410,167
10385,1,1,401,1417,1016
10386,0,0,52,0,-52
10387,1,0,29,0,-29
10388,0,0,5,0,-5
10389,0,0,14,0,-14
10390,1,1,1181,1602,421
10391,0,0,27,0,-27
10392,1,0,40,0,-40
10393,1,1,272,2663,2391
10394,1,0,41,0,-41
10395,1,0,6,0,-6
10396,1,0,117,0,-117
10397,1,0,18,0,-18
10398,0,0,44,0,-44
10399,1,0,30,0,-30
10400,0,0,103,0,-103
10401,1,1,27,3309,3282
10402,1,1,337,1398,1061
10403,0,0,47,0,-47
10404,1,1,1238,1614,376
10405,1,0,92,0,-92
10406,1,0,112,0,-112
10407,0,0,17,0,-17
10408,0,0,11,0,-11
10409,1,1,1146,1390,244
10410,0,0,97,0,-97
10411,0,0,48,0,-48
10412,0,0,52,0,-52
10413,0,0,1,0,-1
10414,1,1,658,3545,2887
10415,1,1,396,1521,1125
10416,1,0,27,0,-27
10417,1,0,0,0,0
10418,1,1,116,1888,1772
10419,0,0,8,0,-8
10420,0,0,6,0,-6
10421,0,0,18,0,-18
10422,1,1,665,1841,1176
10423,1,1,232,1342,1110
10424,1,0,37,0,-37
10425,1,1,120,2381,2261
10426,1,0,60,0,-60
10427,0,0,36,0,-36
10428,1,1,255,1235,980
10429,0,0,11,0,-11
10430,1,1,1137,1282,145
10431,0,0,1,0,-1
10432,1,1,777,1456,679
10433,0,0,6,0,-6
10434,0,0,12,0,-12
10435,0,0,57,0,-57
10436,0,0,111,0,-111
10437,1,1,2662,1612,-1050
10438,0,0,4,0,-4
10439,1,0,8,0,-8
10440,1,1,701,2237,1536
10441,1,1,229,1773,1544
10442,0,0,3,0,-3
10443,0,0,37,0,-37
10444,1,0,23,0,-23
10445,0,0,18,0,-18
10446,1,0,158,0,-158
10447,1,0,39,0,-39
10448,0,0,8,0,-8
10449,1,1,377,1456,1079
10450,1,1,423,1523,1100
10451,0,0,15,0,-15
10452,1,0,13,0,-13
10453,1,0,90,0,-90
10454,0,0,3,0,-3
10455,0,0,0,0,0
10456,1,1,969,1391,422
10457,1,0,177,0,-177
10458,1,0,6,0,-6
10459,1,0,51,0,-51
10460,1,0,20,0,-20
10461,1,1,410,2279,1869
10462,0,0,154,0,-154
10463,0,0,55,0,-55
10464,1,1,625,2310,1685
10465,1,0,73,0,-73
10466,1,1,320,1333,1013
10467,0,0,15,0,-15
10468,0,0,13,0,-13
10469,1,0,116,0,-116
10470,0,0,42,0,-42
10471,0,0,34,0,-34
10472,1,0,10,0,-10
10473,1,1,506,1616,1110
10474,0,0,1,0,-1
10475,0,0,1,0,-1
10476,1,1,955,1243,288
10477,0,0,44,0,-44
10478,1,0,33,0,-33
10479,1,0,33,0,-33
10480,0,0,25,0,-25
10481,1,0,27,0,-27
10482,0,0,4,0,-4
10483,0,0,33,0,-33
10484,1,0,45,0,-45
10485,0,0,89,0,-89
10486,0,0,21,0,-21
10487,0,0,89,0,-89
10488,1,0,30,0,-30
10489,0,0,102,0,-102
10490,1,1,228,1843,1615
10491,1,0,48,0,-48
10492,1,0,26,0,-26
10493,1,0,43,0,-43
10494,1,1,924,1567,643
10495,0,0,49,0,-49
10496,0,0,98,0,-98
10497,0,0,138,0,-138
10498,0,0,15,0,-15
10499,0,0,29,0,-29
10500,0,0,65,0,-65
10501,1,1,1392,1535,143
10502,0,0,79,0,-79
10503,1,0,109,0,-109
10504,0,0,7,0,-7
10505,1,1,465,1354,889
10506,1,1,368,1598,1230
10507,0,0,90,0,-90
10508,1,1,64,1805,1741
10509,1,0,64,0,-64
10510,1,0,203,0,-203
10511,0,0,93,0,-93
10512,1,0,38,0,-38
10513,1,0,23,0,-23
10514,0,0,1,0,-1
10515,1,0,50,0,-50
10516,1,1,317,1491,1174
10517,1,0,167,0,-167
10518,1,1,146,1307,1161
10519,0,0,68,0,-68
10520,1,0,13,0,-13
10521,1,1,400,1650,1250
10522,0,0,42,0,-42
10523,1,0,72,0,-72
10524,1,1,2383,1517,-866
10525,0,0,98,0,-98
10526,0,0,40,0,-40
10527,1,0,2,0,-2
10528,0,0,12,0,-12
10529,1,1,2147,1684,-463
10530,1,0,25,0,-25
10531,1,0,10,0,-10
10532,0,0,35,0,-35
10533,0,0,53,0,-53
10534,0,0,24,0,-24
10535,1,0,79,0,-79
10536,1,0,5,0,-5
10537,0,0,42,0,-42
10538,0,0,29,0,-29
10539,1,1,754,1244,490
10540,1,1,399,1274,875
10541,1,0,5,0,-5
10542,1,0,5,0,-5
10543,0,0,25,0,-25
10544,1,1,385,1784,1399
10545,0,0,27,0,-27
10546,0,0,4,0,-4
10547,1,0,44,0,-44
10548,1,1,147,1279,1132
10549,1,0,23,0,-23
10550,0,0,66,0,-66
10551,1,0,78,0,-78
10552,1,1,380,1244,864
10553,1,1,506,1464,958
10554,1,1,2324,1700,-624
10555,0,0,39,0,-39
10556,1,0,9,0,-9
10557,0,0,70,0,-70
10558,1,1,1209,1360,151
10559,1,0,88,0,-88
10560,1,0,9,0,-9
10561,0,0,97,0,-97
10562,1,1,800,1396,596
10563,0,0,12,0,-12
10564,0,0,62,0,-62
10565,1,0,10,0,-10
10566,1,1,745,2336,1591
10567,1,1,164,1296,1132
10568,1,0,165,0,-165
10569,1,1,362,1393,1031
10570,0,0,0,0,0
10571,0,0,22,0,-22
10572,1,0,42,0,-42
10573,1,1,749,1247,498
10574,0,0,13,0,-13
10575,1,1,133,1455,1322
10576,0,0,24,0,-24
10577,0,0,108,0,-108
10578,0,0,14,0,-14
10579,1,1,745,2291,1546
10580,1,1,196,1695,1499
10581,1,0,22,0,-22
10582,0,0,71,0,-71
10583,1,0,9,0,-9
10584,0,0,52,0,-52
10585,1,0,3,0,-3
10586,1,1,106,1625,1519
10587,1,1,1313,1797,484
10588,1,1,624,1616,992
10589,0,0,29,0,-29
10590,0,0,51,0,-51
10591,1,0,23,0,-23
10592,1,0,5,0,-5
10593,0,0,59,0,-59
10594,0,0,2,0,-2
10595,0,0,79,0,-79
10596,1,1,192,3226,3034
10597,0,0,20,0,-20
10598,1,1,114,1501,1387
10599,0,0,3,0,-3
10600,1,1,233,1282,1049
10601,0,0,32,0,-32
10602,1,1,483,2365,1882
10603,0,0,80,0,-80
10604,1,1,172,1474,1302
10605,0,0,90,0,-90
10606,1,0,111,0,-111
10607,0,0,89,0,-89
10608,0,0,38,0,-38
10609,1,0,71,0,-71
10610,0,0,5,0,-5
10611,1,0,8,0,-8
10612,0,0,150,0,-150
10613,0,0,67,0,-67
10614,0,0,16,0,-16
10615,1,1,444,1503,1059
10616,0,0,18,0,-18
10617,0,0,110,0,-110
10618,1,0,8,0,-8
10619,1,1,90,1260,1170
10620,1,1,125,5191,5066
10621,0,0,15,0,-15
10622,1,0,42,0,-42
10623,0,0,94,0,-94
10624,0,0,27,0,-27
10625,0,0,35,0,-35
10626,0,0,21,0,-21
10627,1,0,86,0,-86
10628,0,0,16,0,-16
10629,0,0,9,0,-9
10630,1,1,515,1392,877
10631,0,0,13,0,-13
10632,1,0,20,0,-20
10633,0,0,100,0,-100
10634,0,0,4,0,-4
10635,0,0,35,0,-35
10636,1,1,194,1266,1072
10637,1,1,33,1458,1425
10638,1,1,515,1294,779
10639,1,0,41,0,-41
10640,1,0,18,0,-18
10641,0,0,15,0,-15
10642,0,0,123,0,-123
10643,1,0,18,0,-18
10644,1,1,1365,2109,744
10645,0,0,11,0,-11
10646,0,0,19,0,-19
10647,0,0,8,0,-8
10648,1,0,39,0,-39
10649,1,0,155,0,-155
10650,0,0,61,0,-61
10651,0,0,43,0,-43
10652,1,1,677,1345,668
10653,0,0,12,0,-12
10654,0,0,20,0,-20
10655,1,1,161,1289,1128
10656,1,0,80,0,-80
10657,1,0,61,0,-61
10658,0,0,29,0,-29
10659,0,0,35,0,-35
10660,1,0,54,0,-54
10661,1,0,93,0,-93
10662,1,0,25,0,-25
10663,1,0,43,0,-43
10664,1,0,82,0,-82
10665,0,0,112,0,-112
10666,0,0,2,0,-2
10667,1,0,91,0,-91
10668,0,0,18,0,-18
10669,1,1,893,1629,736
10670,1,1,380,1299,919
10671,1,1,478,1600,1122
10672,1,0,21,0,-21
10673,1,0,53,0,-53
10674,1,1,220,1305,1085
10675,1,0,337,0,-337
10676,0,0,20,0,-20
10677,1,0,37,0,-37
10678,1,1,329,1305,976
10679,1,1,68,1236,1168
10680,0,0,31,0,-31
10681,1,1,290,1399,1109
10682,0,0,9,0,-9
10683,0,0,89,0,-89
10684,0,0,29,0,-29
10685,0,0,4,0,-4
10686,0,0,37,0,-37
10687,0,0,27,0,-27
10688,0,0,27,0,-27
10689,1,0,32,0,-32
10690,1,0,123,0,-123
10691,1,0,34,0,-34
10692,1,0,95,0,-95
10693,0,0,48,0,-48
10694,0,0,77,0,-77
10695,0,0,17,0,-17
10696,1,1,467,1635,1168
10697,1,1,762,1387,625
10698,1,1,174,1377,1203
10699,0,0,44,0,-44
10700,0,0,4,0,-4
10701,1,1,109,2098,1989
10702,1,1,686,1457,771
10703,1,1,541,1371,830
10704,1,1,416,2011,1595
10705,0,0,10,0,-10
10706,0,0,19,0,-19
10707,1,1,780,1250,470
10708,0,0,29,0,-29
10709,1,1,331,1547,1216
10710,1,1,531,1466,935
10711,0,0,72,0,-72
10712,1,1,185,1687,1502
10713,1,1,202,1842,1640
10714,1,0,37,0,-37
10715,1,1,299,1449,1150
10716,1,0,109,0,-109
10717,1,1,55,1490,1435
10718,0,0,99,0,-99
10719,1,1,94,1289,1195
10720,1,0,23,0,-23
10721,1,1,100,1578,1478
10722,0,0,19,0,-19
10723,0,0,65,0,-65
10724,0,0,15,0,-15
10725,1,1,1344,2471,1127
10726,1,0,356,0,-356
10727,1,1,275,2040,1765
10728,0,0,70,0,-70
10729,1,1,1421,1291,-130
10730,1,0,3,0,-3
10731,0,0,20,0,-20
10732,0,0,0,0,0
10733,0,0,10,0,-10
10734,0,0,37,0,-37
10735,1,0,7,0,-7
10736,0,0,1,0,-1
10737,1,0,25,0,-25
10738,1,1,566,1342,776
10739,1,1,491,1248,757
10740,1,0,15,0,-15
10741,0,0,148,0,-148
10742,1,0,52,0,-52
10743,0,0,22,0,-22
10744,1,1,369,1262,893
10745,1,0,55,0,-55
10746,0,0,93,0,-93
10747,1,0,32,0,-32
10748,0,0,123,0,-123
10749,1,1,681,1485,804
10750,1,0,17,0,-17
10751,1,0,27,0,-27
10752,1,0,106,0,-106
10753,0,0,47,0,-47
10754,0,0,24,0,-24
10755,1,0,2,0,-2
10756,1,0,10,0,-10
10757,1,1,501,1732,1231
10758,1,1,1125,1646,521
10759,0,0,104,0,-104
10760,0,0,129,0,-129
10761,1,0,21,0,-21
10762,0,0,32,0,-32
10763,1,1,73,1485,1412
10764,0,0,12,0,-12
10765,0,0,244,0,-244
10766,1,1,75,1544,1469
10767,0,0,169,0,-169
10768,1,1,191,1287,1096
10769,1,1,416,1347,931
10770,1,0,64,0,-64
10771,0,0,90,0,-90
10772,1,0,2,0,-2
10773,0,0,131,0,-131
10774,0,0,62,0,-62
10775,1,0,153,0,-153
10776,1,1,495,2521,2026
10777,1,0,44,0,-44
10778,0,0,56,0,-56
10779,1,1,481,1397,916
10780,1,0,101,0,-101
10781,1,0,45,0,-45
10782,1,0,93,0,-93
10783,1,1,404,1315,911
10784,0,0,120,0,-120
10785,1,0,19,0,-19
10786,1,1,385,1380,995
10787,1,0,22,0,-22
10788,1,0,44,0,-44
10789,0,0,3,0,-3
10790,0,0,60,0,-60
10791,1,1,880,1423,543
10792,0,0,57,0,-57
10793,1,1,130,1505,1375
10794,1,0,33,0,-33
10795,1,0,57,0,-57
10796,0,0,69,0,-69
10797,1,1,876,1458,582
10798,1,0,0,0,0
10799,1,0,38,0,-38
10800,0,0,38,0,-38
10801,1,1,882,1410,528
10802,0,0,73,0,-73
10803,0,0,64,0,-64
10804,0,0,138,0,-138
10805,0,0,64,0,-64
10806,1,1,375,1368,993
10807,1,1,63,1516,1453
10808,1,1,791,1764,973
10809,0,0,126,0,-126
10810,1,0,92,0,-92
10811,1,1,845,1513,668
10812,1,1,1844,1502,-342
10813,0,0,35,0,-35
10814,1,0,90,0,-90
10815,1,0,67,0,-67
10816,0,0,2,0,-2
10817,0,0,226,0,-226
10818,1,0,89,0,-89
10819,1,1,1073,1235,162
10820,0,0,2,0,-2
10821,1,1,440,1329,889
10822,0,0,56,0,-56
10823,1,1,360,1609,1249
10824,0,0,2,0,-2
10825,1,1,450,1774,1324
10826,1,1,1148,1562,414
10827,0,0,111,0,-111
10828,1,1,192,1302,1110
10829,1,1,1038,2149,1111
10830,1,0,88,0,-88
10831,0,0,7,0,-7
10832,1,1,107,1254,1147
10833,0,0,2,0,-2
10834,1,0,121,0,-121
10835,1,0,4,0,-4
10836,0,0,35,0,-35
10837,1,1,708,1743,1035
10838,1,1,376,1741,1365
10839,0,0,6,0,-6
10840,1,1,205,1844,1639
10841,1,1,137,1265,1128
10842,0,0,54,0,-54
10843,1,1,162,2070,1908
10844,0,0,9,0,-9
10845,0,0,37,0,-37
10846,1,0,16,0,-16
10847,1,0,103,0,-103
10848,1,0,8,0,-8
10849,1,1,343,1241,898
10850,1,1,372,1417,1045
10851,1,1,425,1341,916
10852,1,1,49,1240,1191
10853,0,0,115,0,-115
10854,1,1,48,1498,1450
10855,1,0,66,0,-66
10856,1,0,38,0,-38
10857,1,1,108,1542,1434
10858,1,0,117,0,-117
10859,1,0,99,0,-99
10860,1,0,32,0,-32
10861,1,1,748,1693,945
10862,1,0,34,0,-34
10863,0,0,66,0,-66
10864,1,0,44,0,-44
10865,0,0,50,0,-50
10866,1,0,143,0,-143
10867,0,0,20,0,-20
10868,1,0,5,0,-5
10869,1,0,19,0,-19
10870,0,0,0,0,0
10871,1,1,331,1345,1014
10872,1,0,17,0,-17
10873,1,0,34,0,-34
10874,1,1,124,1415,1291
10875,0,0,13,0,-13
10876,1,0,16,0,-16
10877,0,0,55,0,-55
10878,1,1,2717,1260,-1457
10879,1,1,151,1949,1798
10880,1,0,3,0,-3
10881,1,0,42,0,-42
10882,1,0,214,0,-214
10883,1,0,8,0,-8
10884,1,1,357,1349,992
10885,0,0,5,0,-5
10886,1,1,364,1479,1115
10887,1,1,979,1363,384
10888,1,0,141,0,-141
10889,1,0,68,0,-68
10890,0,0,24,0,-24
10891,0,0,3,0,-3
10892,0,0,2,0,-2
10893,0,0,3,0,-3
10894,1,0,2,0,-2
10895,0,0,23,0,-23
10896,0,0,59,0,-59
10897,1,1,1957,1652,-305
10898,1,0,24,0,-24
10899,1,1,854,1566,712
10900,1,1,182,1753,1571
10901,0,0,217,0,-217
10902,0,0,37,0,-37
10903,1,1,657,1573,916
10904,0,0,20,0,-20
10905,0,0,79,0,-79
10906,0,0,98,0,-98
10907,0,0,1,0,-1
10908,1,0,102,0,-102
10909,0,0,13,0,-13
10910,1,1,1053,1235,182
10911,0,0,5,0,-5
10912,1,1,937,1391,454
10913,0,0,175,0,-175
10914,1,1,501,1299,798
10915,0,0,83,0,-83
10916,1,0,107,0,-107
10917,1,0,147,0,-147
10918,1,0,126,0,-126
10919,1,1,1018,1292,274
10920,0,0,65,0,-65
10921,1,1,1111,1517,406
10922,1,0,143,0,-143
10923,1,0,28,0,-28
10924,1,1,586,1403,817
10925,0,0,36,0,-36
10926,1,0,41,0,-41
10927,0,0,78,0,-78
10928,0,0,2,0,-2
10929,0,0,16,0,-16
10930,1,1,237,1626,1389
10931,1,1,235,1452,1217
10932,1,0,101,0,-101
10933,1,1,614,3651,3037
10934,1,1,236,2007,1771
10935,0,0,29,0,-29
10936,1,0,45,0,-45
10937,1,1,457,1527,1070
10938,1,1,84,2091,2007
10939,1,0,48,0,-48
10940,1,1,477,1449,972
10941,1,1,1687,1669,-18
10942,0,0,12,0,-12
10943,1,0,45,0,-45
10944,1,0,10,0,-10
10945,1,1,27,1242,1215
10946,1,1,1078,1448,370
10947,1,1,1334,1340,6
10948,1,0,11,0,-11
10949,1,1,79,1251,1172
10950,0,0,67,0,-67
10951,1,1,181,1479,1298
10952,1,1,497,1938,1441
10953,1,0,3,0,-3
10954,0,0,82,0,-82
10955,1,0,128,0,-128
10956,0,0,101,0,-101
10957,1,1,985,2121,1136
10958,0,0,62,0,-62
10959,0,0,22,0,-22
10960,0,0,21,0,-21
10961,1,0,30,0,-30
10962,0,0,38,0,-38
10963,1,0,126,0,-126
10964,0,0,1,0,-1
10965,1,1,396,1649,1253
10966,0,0,25,0,-25
10967,1,1,1805,2504,699
10968,1,1,54,1377,1323
10969,1,0,64,0,-64
10970,0,0,35,0,-35
10971,1,0,4,0,-4
10972,0,0,88,0,-88
10973,1,0,30,0,-30
10974,1,1,229,2086,1857
10975,0,0,176,0,-176
10976,1,0,43,0,-43
10977,1,1,286,1239,953
10978,1,1,839,4195,3356
10979,1,0,108,0,-108
10980,0,0,10,0,-10
10981,0,0,54,0,-54
10982,1,1,252,1297,1045
10983,0,0,17,0,-17
10984,1,1,970,1447,477
10985,1,1,1913,1362,-551
10986,0,0,24,0,-24
10987,0,0,68,0,-68
10988,1,1,596,2343,1747
10989,1,1,121,1239,1118
10990,1,0,10,0,-10
10991,1,1,683,3333,2650
10992,1,1,459,1776,1317
10993,1,0,78,0,-78
10994,1,0,57,0,-57
10995,1,0,32,0,-32
10996,1,0,89,0,-89
10997,0,0,27,0,-27
10998,1,1,697,1262,565
10999,0,0,128,0,-128
11000,1,1,155,1333,1178
11001,0,0,71,0,-71
11002,1,0,13,0,-13
11003,1,0,45,0,-45
11004,0,0,16,0,-16
11005,0,0,13,0,-13
11006,0,0,26,0,-26
11007,1,1,251,1665,1414
11008,1,1,188,1541,1353
11009,0,0,50,0,-50
11010,1,1,363,1281,918
11011,1,0,45,0,-45
11012,1,1,105,1482,1377
11013,0,0,2,0,-2
11014,1,0,104,0,-104
11015,0,0,93,0,-93
11016,0,0,46,0,-46
11017,0,0,80,0,-80
11018,1,0,24,0,-24
11019,1,0,61,0,-61
11020,1,0,91,0,-91
11021,1,0,10,0,-10
11022,0,0,37,0,-37
11023,1,0,13,0,-13
11024,0,0,53,0,-53
11025,1,1,148,1475,1327
11026,1,1,828,1251,423
11027,0,0,1,0,-1
11028,1,1,655,1243,588
11029,1,1,704,1866,1162
11030,0,0,0,0,0
11031,0,0,31,0,-31
11032,1,1,462,1398,936
11033,1,0,29,0,-29
11034,0,0,49,0,-49
11035,1,0,116,0,-116
11036,1,1,141,1272,1131
11037,1,0,77,0,-77
11038,1,1,307,2717,2410
11039,1,1,181,1547,1366
11040,0,0,63,0,-63
11041,1,1,162,2183,2021
11042,0,0,89,0,-89
11043,1,0,42,0,-42
11044,0,0,38,0,-38
11045,1,1,1383,1774,391
11046,1,0,112,0,-112
11047,1,1,239,1582,1343
11048,1,0,19,0,-19
11049,1,1,371,1593,1222
11050,0,0,3,0,-3
11051,0,0,4,0,-4
11052,1,1,354,1477,1123
11053,1,1,66,1407,1341
11054,1,1,104,1287,1183
11055,1,1,178,1675,1497
11056,0,0,67,0,-67
11057,0,0,51,0,-51
11058,0,0,134,0,-134
11059,1,0,75,0,-75
11060,1,0,48,0,-48
11061,1,1,257,1237,980
11062,0,0,15,0,-15
11063,1,0,18,0,-18
11064,0,0,11,0,-11
11065,0,0,2,0,-2
11066,0,0,72,0,-72
11067,0,0,13,0,-13
11068,0,0,2,0,-2
11069,1,1,952,2118,1166
11070,0,0,122,0,-122
11071,1,0,67,0,-67
11072,1,0,48,0,-48
11073,0,0,9,0,-9
11074,1,0,18,0,-18
11075,0,0,18,0,-18
11076,1,1,1563,1530,-33
11077,1,1,289,1769,1480
11078,0,0,11,0,-11
11079,0,0,33,0,-33
11080,1,0,78,0,-78
11081,0,0,46,0,-46
11082,1,1,181,1605,1424
11083,1,1,461,1607,1146
11084,0,0,11,0,-11
11085,1,1,1099,1507,408
11086,1,0,9,0,-9
11087,0,0,1,0,-1
11088,1,1,174,1372,1198
11089,1,0,86,0,-86
11090,1,0,31,0,-31
11091,0,0,35,0,-35
11092,1,1,463,1527,1064
11093,0,0,13,0,-13
11094,1,1,213,1756,1543
11095,0,0,15,0,-15
11096,0,0,14,0,-14
11097,0,0,79,0,-79
11098,0,0,6,0,-6
11099,1,0,27,0,-27
11100,0,0,24,0,-24
11101,1,1,829,1535,706
11102,1,0,75,0,-75
11103,1,1,1165,1634,469
11104,1,1,224,2399,2175
11105,1,1,526,1450,924
11106,0,0,25,0,-25
11107,0,0,79,0,-79
11108,1,0,190,0,-190
11109,1,1,347,1279,932
11110,0,0,175,0,-175
11111,0,0,51,0,-51
11112,1,0,20,0,-20
11113,1,0,41,0,-41
11114,1,1,569,1434,865
11115,1,0,4,0,-4
11116,1,0,36,0,-36
11117,1,1,402,1883,1481
11118,0,0,44,0,-44
11119,1,0,25,0,-25
11120,0,0,18,0,-18
11121,1,1,451,1487,1036
11122,1,0,46,0,-46
11123,1,1,251,1538,1287
11124,1,1,109,1624,1515
11125,1,0,171,0,-171
11126,0,0,93,0,-93
11127,0,0,33,0,-33
11128,1,0,55,0,-55
11129,1,1,115,3750,3635
11130,1,1,3325,1333,-1992
11131,1,0,78,0,-78
11132,1,0,5,0,-5
11133,1,0,50,0,-50
11134,0,0,13,0,-13
11135,0,0,118,0,-118
11136,1,1,224,1252,1028
11137,1,0,8,0,-8
11138,1,1,607,1745,1138
11139,0,0,44,0,-44
11140,1,0,98,0,-98
11141,0,0,134,0,-134
11142,1,1,402,1820,1418
11143,1,0,9,0,-9
11144,0,0,68,0,-68
11145,0,0,115,0,-115
11146,0,0,9,0,-9
11147,0,0,24,0,-24
11148,1,0,44,0,-44
11149,1,1,22,1289,1267
11150,1,1,609,1385,776
11151,1,1,357,1395,1038
11152,1,0,31,0,-31
11153,0,0,9,0,-9
11154,0,0,21,0,-21
11155,1,1,112,1869,1757
11156,0,0,45,0,-45
11157,0,0,8,0,-8
11158,1,0,5,0,-5
11159,1,1,1038,1865,827
11160,1,1,456,1309,853
11161,1,1,246,1987,1741
11162,0,0,7,0,-7
11163,0,0,12,0,-12
11164,1,0,39,0,-39
11165,1,1,32,1260,1228
11166,0,0,96,0,-96
11167,1,1,1016,1347,331
11168,0,0,24,0,-24
11169,1,0,214,0,-214
11170,0,0,6,0,-6
11171,0,0,271,0,-271
11172,0,0,13,0,-13
11173,1,1,857,1239,382
11174,1,0,117,0,-117
11175,1,0,72,0,-72
11176,1,1,547,1391,844
11177,0,0,73,0,-73
11178,1,1,493,1354,861
11179,0,0,147,0,-147
11180,0,0,129,0,-129
11181,0,0,63,0,-63
11182,1,0,92,0,-92
11183,0,0,67,0,-67
11184,0,0,52,0,-52
11185,1,0,133,0,-133
11186,1,1,146,1620,1474
11187,1,1,170,1650,1480
11188,0,0,32,0,-32
11189,1,1,285,1382,1097
11190,1,1,208,1917,1709
11191,0,0,39,0,-39
11192,1,0,82,0,-82
11193,0,0,26,0,-26
11194,1,0,9,0,-9
11195,0,0,91,0,-91
11196,1,0,43,0,-43
11197,0,0,20,0,-20
11198,1,1,332,2751,2419
11199,1,0,154,0,-154
11200,1,1,346,1376,1030
11201,0,0,40,0,-40
11202,0,0,27,0,-27
11203,0,0,28,0,-28
11204,0,0,19,0,-19
11205,0,0,9,0,-9
11206,1,0,64,0,-64
11207,0,0,54,0,-54
11208,1,1,302,1300,998
11209,0,0,142,0,-142
11210,0,0,22,0,-22
11211,0,0,10,0,-10
11212,1,0,70,0,-70
11213,0,0,18,0,-18
11214,1,0,17,0,-17
11215,0,0,17,0,-17
11216,1,0,16,0,-16
11217,0,0,12,0,-12
11218,0,0,1,0,-1
11219,0,0,108,0,-108
11220,0,0,76,0,-76
11221,1,0,72,0,-72
11222,1,0,25,0,-25
11223,1,0,19,0,-19
11224,0,0,113,0,-113
11225,1,0,12,0,-12
11226,1,0,31,0,-31
11227,1,0,31,0,-31
11228,0,0,28,0,-28
11229,1,0,0,0,0
11230,1,0,6,0,-6
11231,0,0,25,0,-25
11232,1,0,32,0,-32
11233,0,0,20,0,-20
11234,0,0,24,0,-24
11235,1,0,146,0,-146
11236,0,0,13,0,-13
11237,1,1,2032,1950,-82
11238,1,1,579,1285,706
11239,1,1,1266,1768,502
11240,1,0,39,0,-39
11241,1,1,453,1262,809
11242,1,0,43,0,-43
11243,1,1,811,1452,641
11244,0,0,43,0,-43
11245,0,0,44,0,-44
11246,1,1,251,1414,1163
11247,0,0,24,0,-24
11248,1,0,8,0,-8
11249,0,0,94,0,-94
11250,0,0,16,0,-16
11251,1,1,211,1517,1306
11252,0,0,22,0,-22
11253,0,0,117,0,-117
11254,1,0,10,0,-10
11255,0,0,45,0,-45
11256,1,0,12,0,-12
11257,0,0,73,0,-73
11258,0,0,14,0,-14
11259,1,0,55,0,-55
11260,1,1,360,1913,1553
11261,0,0,65,0,-65
11262,1,1,269,1695,1426
11263,0,0,2,0,-2
11264,0,0,99,0,-99
11265,0,0,11,0,-11
11266,1,0,84,0,-84
11267,0,0,57,0,-57
11268,1,1,268,1701,1433
11269,1,0,91,0,-91
11270,1,0,20,0,-20
11271,1,0,174,0,-174
11272,0,0,9,0,-9
11273,1,0,46,0,-46
11274,1,0,0,0,0
11275,0,0,3,0,-3
11276,1,0,62,0,-62
11277,1,1,182,1490,1308
11278,1,0,14,0,-14
11279,1,1,308,1326,1018
11280,1,1,158,1646,1488
11281,1,0,68,0,-68
11282,1,0,125,0,-125
11283,1,1,366,2322,1956
11284,0,0,4,0,-4
11285,1,1,296,1372,1076
11286,1,1,586,1599,1013
11287,1,0,12,0,-12
11288,1,1,333,1263,930
11289,1,1,79,2907,2828
11290,1,0,73,0,-73
11291,1,0,40,0,-40
11292,0,0,63,0,-63
11293,1,0,98,0,-98
11294,1,1,59,1266,1207
11295,0,0,0,0,0
11296,1,0,1,0,-1
11297,1,0,17,0,-17
11298,1,0,21,0,-21
11299,0,0,32,0,-32
11300,0,0,8,0,-8
11301,0,0,51,0,-51
11302,1,0,3,0,-3
11303,0,0,59,0,-59
11304,0,0,11,0,-11
11305,0,0,93,0,-93
11306,0,0,15,0,-15
11307,0,0,299,0,-299
11308,1,0,91,0,-91
11309,0,0,8,0,-8
11310,0,0,45,0,-45
11311,1,0,63,0,-63
11312,0,0,141,0,-141
11313,1,1,1531,1636,105
11314,0,0,10,0,-10
11315,1,0,20,0,-20
11316,1,0,64,0,-64
11317,1,1,852,1482,630
11318,0,0,39,0,-39
11319,0,0,0,0,0
11320,0,0,2,0,-2
11321,0,0,1,0,-1
11322,1,0,44,0,-44
11323,1,0,166,0,-166
11324,0,0,28,0,-28
11325,1,1,494,1242,748
11326,0,0,43,0,-43
11327,1,0,13,0,-13
11328,0,0,52,0,-52
11329,1,0,7,0,-7
11330,0,0,33,0,-33
11331,0,0,41,0,-41
11332,1,0,219,0,-219
11333,1,0,28,0,-28
11334,0,0,82,0,-82
11335,1,0,20,0,-20
11336,1,0,80,0,-80
11337,1,1,439,1423,984
11338,1,0,61,0,-61
11339,1,1,413,1699,1286
11340,0,0,95,0,-95
11341,1,1,198,1686,1488
11342,0,0,119,0,-119
11343,1,0,37,0,-37
11344,1,0,173,0,-173
11345,0,0,26,0,-26
11346,0,0,22,0,-22
11347,1,1,519,1371,852
11348,0,0,2,0,-2
11349,1,1,803,1339,536
11350,1,1,332,1554,1222
11351,1,1,1594,5349,3755
11352,0,0,63,0,-63
11353,1,1,23,2040,2017
11354,1,0,31,0,-31
11355,0,0,25,0,-25
11356,0,0,2,0,-2
11357,1,1,109,1691,1582
11358,0,0,81,0,-81
11359,0,0,95,0,-95
11360,0,0,39,0,-39
11361,0,0,136,0,-136
11362,1,1,734,1333,599
11363,0,0,43,0,-43
11364,0,0,65,0,-65
11365,1,0,12,0,-12
11366,1,0,46,0,-46
11367,1,1,113,1291,1178
11368,0,0,6,0,-6
11369,1,0,18,0,-18
11370,1,1,421,2078,1657
11371,0,0,148,0,-148
11372,1,1,131,1762,1631
11373,1,1,600,1239,639
11374,0,0,24,0,-24
11375,1,1,1104,1406,302
11376,0,0,20,0,-20
11377,1,0,34,0,-34
11378,0,0,11,0,-11
11379,1,0,7,0,-7
11380,1,0,2,0,-2
11381,1,1,472,1239,767
11382,0,0,25,0,-25
11383,0,0,75,0,-75
11384,0,0,15,0,-15
11385,1,0,23,0,-23
11386,0,0,19,0,-19
11387,1,1,838,2142,1304
11388,1,1,498,1389,891
11389,0,0,12,0,-12
11390,1,1,412,1412,1000
11391,0,0,36,0,-36
11392,1,0,21,0,-21
11393,1,1,332,2031,1699
11394,0,0,10,0,-10
11395,1,1,340,1560,1220
11396,1,1,84,1430,1346
11397,0,0,206,0,-206
11398,1,0,29,0,-29
11399,0,0,14,0,-14
11400,1,1,1046,2285,1239
11401,1,0,14,0,-14
11402,0,0,20,0,-20
11403,1,1,669,1962,1293
11404,1,0,0,0,0
11405,1,0,81,0,-81
11406,0,0,15,0,-15
11407,0,0,103,0,-103
11408,0,0,51,0,-51
11409,1,1,345,1707,1362
11410,0,0,1,0,-1
11411,1,0,60,0,-60
11412,1,1,465,1393,928
11413,1,1,642,1712,1070
11414,0,0,66,0,-66
11415,1,0,42,0,-42
11416,1,0,40,0,-40
11417,0,0,33,0,-33
11418,1,0,57,0,-57
11419,1,0,89,0,-89
11420,1,1,164,1601,1437
11421,0,0,24,0,-24
11422,0,0,120,0,-120
11423,1,0,43,0,-43
11424,0,0,71,0,-71
11425,1,1,2780,1422,-1358
11426,1,0,39,0,-39
11427,1,0,148,0,-148
11428,0,0,85,0,-85
11429,1,1,2390,1506,-884
11430,0,0,41,0,-41
11431,1,1,26,1703,1677
11432,1,1,16,1666,1650
11433,1,1,387,1745,1358
11434,1,0,13,0,-13
11435,1,1,444,1593,1149
11436,0,0,30,0,-30
11437,0,0,107,0,-107
11438,1,0,24,0,-24
11439,1,0,20,0,-20
11440,1,0,2,0,-2
11441,0,0,74,0,-74
11442,1,1,1258,2565,1307
11443,1,1,329,1400,1071
11444,0,0,115,0,-115
11445,0,0,75,0,-75
11446,0,0,6,0,-6
11447,0,0,47,0,-47
11448,1,1,100,2093,1993
11449,0,0,11,0,-11
11450,1,1,127,1411,1284
11451,0,0,51,0,-51
11452,1,0,20,0,-20
11453,1,1,572,1277,705
11454,0,0,29,0,-29
11455,0,0,2,0,-2
11456,0,0,187,0,-187
11457,1,1,830,2393,1563
11458,1,0,33,0,-33
11459,1,0,6,0,-6
11460,1,1,378,1548,1170
11461,0,0,0,0,0
11462,1,1,147,1912,1765
11463,0,0,5,0,-5
11464,1,1,181,1616,1435
11465,1,1,287,1415,1128
11466,1,1,1341,1433,92
11467,1,1,359,1384,1025
11468,0,0,32,0,-32
11469,0,0,108,0,-108
11470,0,0,36,0,-36
11471,1,1,628,2622,1994
11472,0,0,231,0,-231
11473,0,0,41,0,-41
11474,1,0,61,0,-61
11475,0,0,93,0,-93
11476,0,0,34,0,-34
11477,0,0,60,0,-60
11478,1,1,810,1520,710
11479,1,0,103,0,-103
11480,0,0,13,0,-13
11481,1,1,170,1620,1450
11482,1,0,11,0,-11
11483,1,1,674,1238,564
11484,1,0,79,0,-79
11485,1,0,12,0,-12
11486,1,1,45,1293,1248
11487,1,1,240,2048,1808
11488,0,0,59,0,-59
11489,1,1,167,1392,1225
11490,1,1,1004,1416,412
11491,1,0,119,0,-119
11492,1,1,678,2189,1511
11493,0,0,24,0,-24
11494,1,1,337,1311,974
11495,0,0,42,0,-42
11496,0,0,146,0,-146
11497,0,0,35,0,-35
11498,0,0,28,0,-28
11499,1,1,608,1408,800
11500,0,0,28,0,-28
11501,0,0,9,0,-9
11502,1,1,165,1380,1215
11503,0,0,208,0,-208
11504,0,0,34,0,-34
11505,1,1,874,1429,555
11506,1,1,72,4885,4813
11507,1,1,105,2029,1924
11508,1,0,35,0,-35
11509,1,0,6,0,-6
11510,1,1,1114,1616,502
11511,0,0,43,0,-43
11512,1,0,60,0,-60
11513,0,0,15,0,-15
11514,1,0,86,0,-86
11515,1,1,30,1873,1843
11516,1,1,497,1251,754
11517,0,0,47,0,-47
11518,1,0,67,0,-67
11519,1,0,109,0,-109
11520,1,0,26,0,-26
11521,0,0,12,0,-12
11522,1,0,12,0,-12
11523,1,1,544,1476,932
11524,1,0,15,0,-15
11525,0,0,14,0,-14
11526,1,1,308,1238,930
11527,0,0,47,0,-47
11528,0,0,203,0,-203
11529,1,1,275,1393,1118
11530,1,1,1604,1499,-105
11531,1,0,53,0,-53
11532,0,0,310,0,-310
11533,1,0,51,0,-51
11534,0,0,95,0,-95
11535,0,0,53,0,-53
11536,1,1,1383,1428,45
11537,1,0,9,0,-9
11538,1,1,888,2001,1113
11539,1,1,211,1584,1373
11540,1,0,104,0,-104
11541,1,1,1480,1349,-131
11542,1,0,144,0,-144
11543,1,1,341,1275,934
11544,1,0,11,0,-11
11545,1,1,1024,1248,224
11546,0,0,22,0,-22
11547,0,0,31,0,-31
11548,0,0,2,0,-2
11549,0,0,138,0,-138
11550,0,0,11,0,-11
11551,0,0,102,0,-102
11552,1,0,11,0,-11
11553,1,0,12,0,-12
11554,1,1,936,1561,625
11555,1,0,3,0,-3
11556,0,0,40,0,-40
11557,0,0,115,0,-115
11558,1,0,18,0,-18
11559,0,0,20,0,-20
11560,0,0,88,0,-88
11561,1,0,147,0,-147
11562,1,1,464,1935,1471
11563,0,0,19,0,-19
11564,1,0,18,0,-18
11565,1,1,650,1840,1190
11566,0,0,32,0,-32
11567,1,0,51,0,-51
11568,0,0,10,0,-10
11569,0,0,87,0,-87
11570,0,0,0,0,0
11571,0,0,83,0,-83
11572,0,0,120,0,-120
11573,1,1,152,1643,1491
11574,1,1,301,2105,1804
11575,1,1,111,1345,1234
11576,1,0,10,0,-10
11577,0,0,16,0,-16
11578,1,0,127,0,-127
11579,0,0,46,0,-46
11580,1,0,54,0,-54
11581,0,0,18,0,-18
11582,1,0,165,0,-165
11583,0,0,58,0,-58
11584,1,0,37,0,-37
11585,1,1,188,8036,7848
11586,1,1,397,1339,942
11587,1,1,66,1278,1212
11588,1,0,50,0,-50
11589,0,0,77,0,-77
11590,1,0,8,0,-8
11591,0,0,121,0,-121
11592,1,1,896,2003,1107
11593,1,0,18,0,-18
11594,0,0,17,0,-17
11595,0,0,130,0,-130
11596,0,0,25,0,-25
11597,1,0,19,0,-19
11598,1,1,138,2329,2191
11599,0,0,97,0,-97
11600,0,0,57,0,-57
11601,0,0,120,0,-120
11602,1,1,695,1243,548
11603,0,0,10,0,-10
11604,0,0,66,0,-66
11605,1,1,516,1285,769
11606,1,0,68,0,-68
11607,1,1,702,1865,1163
11608,0,0,32,0,-32
11609,1,1,1114,1290,176
11610,0,0,100,0,-100
11611,1,0,18,0,-18
11612,1,0,213,0,-213
11613,0,0,4,0,-4
11614,0,0,66,0,-66
11615,1,0,25,0,-25
11616,0,0,75,0,-75
11617,0,0,57,0,-57
11618,1,1,510,1850,1340
11619,1,0,2,0,-2
11620,0,0,46,0,-46
11621,1,0,27,0,-27
11622,1,1,519,1528,1009
11623,1,0,56,0,-56
11624,1,1,3115,1331,-1784
11625,1,1,181,2019,1838
11626,0,0,43,0,-43
11627,1,1,813,1639,826
11628,0,0,90,0,-90
11629,1,1,289,1332,1043
11630,1,0,6,0,-6
11631,1,1,86,1327,1241
11632,0,0,77,0,-77
11633,0,0,32,0,-32
11634,1,0,5,0,-5
11635,0,0,11,0,-11
11636,0,0,49,0,-49
11637,1,0,56,0,-56
11638,0,0,9,0,-9
11639,0,0,18,0,-18
11640,1,1,202,1498,1296
11641,1,1,193,1552,1359
11642,1,1,518,1394,876
11643,1,0,6,0,-6
11644,0,0,166,0,-166
11645,1,1,330,1529,1199
11646,0,0,9,0,-9
11647,1,0,31,0,-31
11648,1,0,154,0,-154
11649,0,0,116,0,-116
11650,1,0,13,0,-13
11651,1,0,7,0,-7
11652,1,1,48,1309,1261
11653,1,1,117,1391,1274
11654,0,0,41,0,-41
11655,1,1,720,1290,570
11656,1,1,290,1325,1035
11657,1,0,5,0,-5
11658,1,0,11,0,-11
11659,0,0,108,0,-108
11660,1,1,122,1387,1265
11661,1,1,631,1319,688
11662,1,1,300,2435,2135
11663,1,1,725,1579,854
11664,1,0,16,0,-16
11665,0,0,6,0,-6
11666,1,1,576,1267,691
11667,0,0,6,0,-6
11668,0,0,168,0,-168
11669,1,0,8,0,-8
11670,0,0,128,0,-128
11671,1,1,102,1325,1223
11672,1,1,767,1889,1122
11673,1,0,24,0,-24
11674,1,1,511,2009,1498
11675,1,1,318,1429,1111
11676,0,0,11,0,-11
11677,1,0,87,0,-87
11678,0,0,7,0,-7
11679,0,0,184,0,-184
11680,1,0,121,0,-121
11681,0,0,26,0,-26
11682,1,0,24,0,-24
11683,1,1,292,1384,1092
11684,1,0,5,0,-5
11685,1,0,65,0,-65
11686,1,1,463,1952,1489
11687,1,1,1100,1781,681
11688,0,0,5,0,-5
11689,0,0,0,0,0
11690,1,1,1673,1636,-37
11691,0,0,15,0,-15
11692,1,0,92,0,-92
11693,0,0,78,0,-78
11694,1,1,1691,1238,-453
11695,1,1,170,4261,4091
11696,1,0,93,0,-93
11697,1,0,21,0,-21
11698,0,0,0,0,0
11699,1,0,16,0,-16
11700,1,1,544,1799,1255
11701,0,0,84,0,-84
11702,1,1,241,1370,1129
11703,0,0,6,0,-6
11704,0,0,155,0,-155
11705,1,0,14,0,-14
11706,0,0,140,0,-140
11707,1,0,8,0,-8
11708,1,0,56,0,-56
11709,0,0,31,0,-31
11710,0,0,147,0,-147
11711,0,0,17,0,-17
11712,1,0,26,0,-26
11713,1,0,3,0,-3
11714,0,0,9,0,-9
11715,1,0,5,0,-5
11716,1,0,6,0,-6
11717,0,0,7,0,-7
11718,0,0,173,0,-173
11719,1,0,68,0,-68
11720,1,1,565,1243,678
11721,1,1,401,1504,1103
11722,1,0,22,0,-22
11723,0,0,5,0,-5
11724,0,0,80,0,-80
11725,1,0,62,0,-62
11726,0,0,6,0,-6
11727,0,0,19,0,-19
11728,1,1,2124,1241,-883
11729,0,0,62,0,-62
11730,0,0,71,0,-71
11731,1,1,316,1372,1056
11732,0,0,16,0,-16
11733,1,1,111,1329,1218
11734,1,1,184,1336,1152
11735,1,1,602,1280,678
11736,0,0,22,0,-22
11737,1,0,55,0,-55
11738,1,0,55,0,-55
11739,1,0,25,0,-25
11740,0,0,39,0,-39
11741,1,1,214,1249,1035
11742,1,0,61,0,-61
11743,1,0,1,0,-1
11744,1,1,284,2148,1864
11745,0,0,38,0,-38
11746,1,0,4,0,-4
11747,1,1,381,1442,1061
11748,0,0,15,0,-15
11749,1,1,309,1383,1074
11750,0,0,43,0,-43
11751,0,0,121,0,-121
11752,1,0,65,0,-65
11753,0,0,29,0,-29
11754,0,0,1,0,-1
11755,1,1,362,1302,940
11756,1,0,1,0,-1
11757,1,1,309,2518,2209
11758,1,0,12,0,-12
11759,1,0,7,0,-7
11760,1,1,47,2107,2060
11761,0,0,20,0,-20
11762,1,1,538,1984,1446
11763,1,0,90,0,-90
11764,1,1,903,1773,870
11765,1,0,23,0,-23
11766,1,0,3,0,-3
11767,0,0,25,0,-25
11768,1,0,10,0,-10
11769,0,0,159,0,-159
11770,1,1,1018,1250,232
11771,1,1,455,1804,1349
11772,0,0,1,0,-1
11773,1,0,11,0,-11
11774,0,0,11,0,-11
11775,1,1,118,1319,1201
11776,0,0,40,0,-40
11777,1,0,227,0,-227
11778,0,0,6,0,-6
11779,1,0,3,0,-3
11780,0,0,23,0,-23
11781,0,0,0,0,0
11782,1,1,189,1339,1150
11783,0,0,107,0,-107
11784,1,0,64,0,-64
11785,1,0,1,0,-1
11786,0,0,259,0,-259
11787,1,0,82,0,-82
11788,1,1,313,1244,931
11789,0,0,32,0,-32
11790,1,1,112,1965,1853
11791,1,1,351,2479,2128
11792,0,0,4,0,-4
11793,1,0,46,0,-46
11794,0,0,37,0,-37
11795,0,0,56,0,-56
11796,1,0,33,0,-33
11797,0,0,97,0,-97
11798,1,1,247,1815,1568
11799,1,1,56,1248,1192
11800,1,0,25,0,-25
11801,1,0,7,0,-7
11802,0,0,45,0,-45
11803,1,1,238,1270,1032
11804,1,1,1509,1368,-141
11805,1,0,76,0,-76
11806,1,1,111,2241,2130
11807,1,0,2,0,-2
11808,1,1,58,1298,1240
11809,1,0,12,0,-12
11810,1,1,318,1294,976
11811,1,0,15,0,-15
11812,1,0,44,0,-44
11813,0,0,15,0,-15
11814,0,0,0,0,0
11815,0,0,60,0,-60
11816,1,1,504,1618,1114
11817,0,0,40,0,-40
11818,0,0,95,0,-95
11819,1,1,425,1329,904
11820,1,1,82,1865,1783
11821,1,1,40,1601,1561
11822,1,0,38,0,-38
11823,1,1,537,1976,1439
11824,0,0,6,0,-6
11825,1,0,1,0,-1
11826,0,0,14,0,-14
11827,1,1,718,1705,987
11828,1,1,261,1280,1019
11829,1,1,989,1874,885
11830,1,0,58,0,-58
11831,1,1,282,1775,1493
11832,1,1,1412,1813,401
11833,0,0,13,0,-13
11834,1,1,734,1898,1164
11835,1,1,427,3614,3187
11836,1,1,672,1244,572
11837,1,1,1020,1323,303
11838,1,1,308,1532,1224
11839,0,0,58,0,-58
11840,0,0,20,0,-20
11841,1,0,111,0,-111
11842,0,0,18,0,-18
11843,1,0,65,0,-65
11844,1,0,2,0,-2
11845,0,0,140,0,-140
11846,0,0,14,0,-14
11847,0,0,17,0,-17
11848,0,0,63,0,-63
11849,0,0,10,0,-10
11850,0,0,5,0,-5
11851,0,0,70,0,-70
11852,0,0,111,0,-111
11853,1,1,279,1247,968
11854,1,0,28,0,-28
11855,0,0,155,0,-155
11856,1,1,589,1338,749
11857,0,0,30,0,-30
11858,0,0,0,0,0
11859,0,0,51,0,-51
11860,1,0,39,0,-39
11861,1,0,8,0,-8
11862,1,0,200,0,-200
11863,1,1,111,1678,1567
11864,0,0,21,0,-21
11865,1,0,133,0,-133
11866,1,0,39,0,-39
11867,1,1,889,1411,522
11868,0,0,34,0,-34
11869,1,1,377,2050,1673
11870,1,0,128,0,-128
11871,1,0,24,0,-24
11872,1,0,4,0,-4
11873,1,1,366,1660,1294
11874,1,1,148,1999,1851
11875,1,0,29,0,-29
11876,1,1,867,2357,1490
11877,1,0,65,0,-65
11878,1,0,39,0,-39
11879,0,0,6,0,-6
11880,1,0,10,0,-10
11881,1,0,112,0,-112
11882,1,1,2227,1359,-868
11883,1,0,21,0,-21
11884,0,0,120,0,-120
11885,1,0,100,0,-100
11886,1,1,889,1355,466
11887,1,1,259,1608,1349
11888,1,0,56,0,-56
11889,0,0,117,0,-117
11890,1,0,76,0,-76
11891,1,0,43,0,-43
11892,0,0,9,0,-9
11893,1,1,1311,1288,-23
11894,1,1,298,1328,1030
11895,1,1,842,1313,471
11896,1,1,165,1439,1274
11897,0,0,3,0,-3
11898,0,0,11,0,-11
11899,0,0,1,0,-1
11900,1,1,915,1535,620
11901,1,0,22,0,-22
11902,0,0,47,0,-47
11903,0,0,62,0,-62
11904,0,0,2,0,-2
11905,1,0,12,0,-12
11906,0,0,1,0,-1
11907,0,0,28,0,-28
11908,1,1,130,1335,1205
11909,1,0,23,0,-23
11910,0,0,16,0,-16
11911,1,0,27,0,-27
11912,1,1,626,1353,727
11913,0,0,34,0,-34
11914,0,0,145,0,-145
11915,1,1,184,1565,1381
11916,1,1,392,1272,880
11917,1,0,31,0,-31
11918,0,0,8,0,-8
11919,1,0,70,0,-70
11920,0,0,9,0,-9
11921,1,1,1253,1250,-3
11922,0,0,175,0,-175
11923,1,1,476,1404,928
11924,1,0,132,0,-132
11925,0,0,115,0,-115
11926,0,0,25,0,-25
11927,1,1,907,1247,340
11928,1,0,40,0,-40
11929,0,0,139,0,-139
11930,0,0,5,0,-5
11931,0,0,119,0,-119
11932,1,1,1430,1759,329
11933,1,0,109,0,-109
11934,1,1,855,1512,657
11935,1,1,1548,1577,29
11936,0,0,322,0,-322
11937,1,1,111,1246,1135
11938,0,0,23,0,-23
11939,1,0,123,0,-123
11940,0,0,47,0,-47
11941,1,0,35,0,-35
11942,0,0,3,0,-3
11943,1,1,1036,1606,570
11944,1,1,324,2045,1721
11945,0,0,90,0,-90
11946,1,0,126,0,-126
11947,0,0,4,0,-4
11948,0,0,97,0,-97
11949,1,1,645,1300,655
11950,0,0,4,0,-4
11951,1,1,2162,1359,-803
11952,1,0,79,0,-79
11953,0,0,2,0,-2
11954,0,0,85,0,-85
11955,1,0,18,0,-18
11956,0,0,148,0,-148
11957,0,0,85,0,-85
11958,1,1,487,1275,788
11959,1,1,964,1628,664
11960,1,1,390,1280,890
11961,1,1,906,1340,434
11962,1,0,24,0,-24
11963,0,0,47,0,-47
11964,1,0,8,0,-8
11965,0,0,104,0,-104
11966,1,1,1225,1984,759
11967,1,0,32,0,-32
11968,0,0,96,0,-96
11969,0,0,41,0,-41
11970,1,1,131,1342,1211
11971,0,0,11,0,-11
11972,0,0,53,0,-53
11973,0,0,57,0,-57
11974,0,0,95,0,-95
11975,1,1,991,2521,1530
11976,0,0,85,0,-85
11977,1,0,24,0,-24
11978,1,1,1786,1371,-415
11979,0,0,11,0,-11
11980,1,0,39,0,-39
11981,0,0,0,0,0
11982,0,0,23,0,-23
11983,0,0,33,0,-33
11984,1,0,110,0,-110
11985,1,1,1175,1342,167
11986,0,0,194,0,-194
11987,0,0,17,0,-17
11988,1,1,481,1554,1073
11989,0,0,17,0,-17
11990,1,0,144,0,-144
11991,1,0,22,0,-22
11992,1,1,276,1310,1034
11993,0,0,113,0,-113
11994,1,1,1274,1814,540
11995,1,0,46,0,-46
11996,1,1,321,1551,1230
11997,0,0,45,0,-45
11998,1,0,55,0,-55
11999,0,0,37,0,-37
12000,0,0,1,0,-1
12001,1,0,41,0,-41
12002,1,1,1321,1519,198
12003,0,0,15,0,-15
12004,0,0,12,0,-12
12005,0,0,21,0,-21
12006,1,1,345,1256,911
12007,0,0,28,0,-28
12008,0,0,3,0,-3
12009,1,1,219,2413,2194
12010,1,1,926,1327,401
12011,1,1,331,1772,1441
12012,0,0,39,0,-39
12013,1,1,1660,1798,138
12014,1,1,497,1816,1319
12015,0,0,13,0,-13
12016,0,0,27,0,-27
12017,1,1,468,2227,1759
12018,0,0,15,0,-15
12019,0,0,50,0,-50
12020,0,0,4,0,-4
12021,1,1,573,1240,667
12022,1,1,64,1540,1476
12023,0,0,0,0,0
12024,1,0,35,0,-35
12025,0,0,99,0,-99
12026,1,0,50,0,-50
12027,1,1,1248,2078,830
12028,1,1,272,1302,1030
12029,1,1,397,1763,1366
12030,1,0,37,0,-37
12031,0,0,61,0,-61
12032,0,0,13,0,-13
12033,1,1,165,1420,1255
12034,0,0,31,0,-31
12035,1,0,70,0,-70
12036,1,0,38,0,-38
12037,1,1,145,2189,2044
12038,1,0,14,0,-14
12039,1,0,73,0,-73
12040,1,0,52,0,-52
12041,0,0,55,0,-55
12042,1,1,178,1479,1301
12043,1,1,912,1762,850
12044,0,0,4,0,-4
12045,1,0,10,0,-10
12046,1,1,419,1291,872
12047,1,0,28,0,-28
12048,0,0,69,0,-69
12049,0,0,15,0,-15
12050,1,1,188,1489,1301
12051,0,0,17,0,-17
12052,0,0,9,0,-9
12053,0,0,46,0,-46
12054,1,1,140,1356,1216
12055,1,1,65,1462,1397
12056,0,0,26,0,-26
12057,1,1,1288,1593,305
12058,0,0,104,0,-104
12059,1,1,838,4185,3347
12060,1,1,39,1238,1199
12061,0,0,56,0,-56
12062,0,0,2,0,-2
12063,1,1,1215,1551,336
12064,0,0,3,0,-3
12065,0,0,111,0,-111
12066,0,0,44,0,-44
12067,1,0,30,0,-30
12068,1,1,943,1474,531
12069,1,1,204,1293,1089
12070,1,0,124,0,-124
12071,0,0,69,0,-69
12072,0,0,47,0,-47
12073,1,1,384,1555,1171
12074,0,0,12,0,-12
12075,1,0,5,0,-5
12076,1,0,53,0,-53
12077,0,0,7,0,-7
12078,1,0,113,0,-113
12079,1,0,63,0,-63
12080,1,1,583,2742,2159
12081,1,0,69,0,-69
12082,1,1,338,1348,1010
12083,1,0,67,0,-67
12084,1,1,592,1375,783
12085,0,0,22,0,-22
12086,0,0,26,0,-26
12087,0,0,48,0,-48
12088,1,1,274,1295,1021
12089,1,0,3,0,-3
12090,1,0,47,0,-47
12091,0,0,22,0,-22
12092,1,0,55,0,-55
12093,1,0,51,0,-51
12094,0,0,17,0,-17
12095,0,0,29,0,-29
12096,1,1,991,2710,1719
12097,1,1,723,1459,736
12098,1,1,274,1541,1267
12099,0,0,82,0,-82
12100,0,0,11,0,-11
12101,0,0,3,0,-3
12102,0,0,49,0,-49
12103,0,0,165,0,-165
12104,0,0,3,0,-3
12105,0,0,26,0,-26
12106,1,0,13,0,-13
12107,1,1,1729,1549,-180
12108,1,0,60,0,-60
12109,0,0,77,0,-77
12110,1,0,137,0,-137
12111,1,0,66,0,-66
12112,1,1,83,1791,1708
12113,1,0,83,0,-83
12114,0,0,46,0,-46
12115,1,1,101,1375,1274
12116,0,0,40,0,-40
12117,0,0,16,0,-16
12118,0,0,36,0,-36
12119,1,0,35,0,-35
12120,1,0,85,0,-85
12121,1,0,118,0,-118
12122,0,0,44,0,-44
12123,0,0,62,0,-62
12124,0,0,67,0,-67
12125,0,0,48,0,-48
12126,0,0,69,0,-69
12127,0,0,57,0,-57
12128,0,0,77,0,-77
12129,1,0,41,0,-41
12130,1,1,349,1540,1191
12131,1,1,2336,1632,-704
12132,0,0,39,0,-39
12133,0,0,83,0,-83
12134,1,0,111,0,-111
12135,1,1,34,1241,1207
12136,1,1,496,1680,1184
12137,1,0,15,0,-15
12138,1,1,134,1377,1243
12139,1,1,412,1430,1018
12140,0,0,15,0,-15
12141,1,1,650,2607,1957
12142,0,0,107,0,-107
12143,1,0,73,0,-73
12144,0,0,50,0,-50
12145,1,1,52,1432,1380
12146,1,1,583,1290,707
12147,1,1,737,3490,2753
12148,0,0,65,0,-65
12149,0,0,48,0,-48
12150,1,1,392,2259,1867
12151,1,0,46,0,-46
12152,1,0,62,0,-62
12153,1,0,9,0,-9
12154,0,0,79,0,-79
12155,0,0,2,0,-2
12156,0,0,50,0,-50
12157,0,0,5,0,-5
12158,0,0,62,0,-62
12159,1,0,250,0,-250
12160,1,0,3,0,-3
12161,1,0,96,0,-96
12162,0,0,96,0,-96
12163,1,1,243,1326,1083
12164,1,0,91,0,-91
12165,1,1,725,1343,618
12166,1,1,669,1426,757
12167,1,0,74,0,-74
12168,1,1,1852,1433,-419
12169,1,1,1134,1334,200
12170,1,0,34,0,-34
12171,1,1,334,2572,2238
12172,0,0,7,0,-7
12173,1,0,70,0,-70
12174,1,1,159,1934,1775
12175,0,0,62,0,-62
12176,1,0,57,0,-57
12177,1,1,264,1355,1091
12178,1,1,247,1429,1182
12179,1,0,7,0,-7
12180,1,1,373,1797,1424
12181,1,1,964,1272,308
12182,0,0,42,0,-42
12183,1,0,22,0,-22
12184,1,0,28,0,-28
12185,1,0,78,0,-78
12186,0,0,107,0,-107
12187,0,0,5,0,-5
12188,1,1,1857,1454,-403
12189,0,0,21,0,-21
12190,1,1,542,1404,862
12191,1,1,588,1455,867
12192,1,1,137,1934,1797
12193,0,0,74,0,-74
12194,1,1,546,1640,1094
12195,1,0,16,0,-16
12196,1,1,231,1378,1147
12197,1,1,49,1274,1225
12198,1,1,1207,1323,116
12199,1,0,8,0,-8
12200,0,0,53,0,-53
12201,0,0,37,0,-37
12202,1,0,2,0,-2
12203,0,0,10,0,-10
12204,1,1,81,1551,1470
12205,1,0,108,0,-108
12206,0,0,195,0,-195
12207,0,0,45,0,-45
12208,1,1,327,1525,1198
12209,1,0,15,0,-15
12210,1,0,65,0,-65
12211,1,0,36,0,-36
12212,1,0,38,0,-38
12213,1,1,698,2906,2208
12214,1,1,330,1697,1367
12215,1,1,93,1251,1158
12216,1,1,249,1534,1285
12217,1,1,74,1269,1195
12218,0,0,38,0,-38
12219,0,0,7,0,-7
12220,1,1,1735,1496,-239
12221,1,0,47,0,-47
12222,1,1,151,1532,1381
12223,0,0,44,0,-44
12224,0,0,6,0,-6
12225,1,1,244,1374,1130
12226,0,0,212,0,-212
12227,0,0,116,0,-116
12228,1,0,43,0,-43
12229,0,0,17,0,-17
12230,0,0,14,0,-14
12231,0,0,56,0,-56
12232,0,0,72,0,-72
12233,0,0,69,0,-69
12234,1,0,108,0,-108
12235,1,1,371,1446,1075
12236,0,0,80,0,-80
12237,1,0,71,0,-71
12238,1,0,30,0,-30
12239,0,0,2,0,-2
12240,1,1,911,1963,1052
12241,1,0,214,0,-214
12242,1,1,308,1352,1044
12243,1,0,24,0,-24
12244,1,0,47,0,-47
12245,1,0,35,0,-35
12246,1,1,1513,1772,259
12247,1,1,455,1542,1087
12248,1,0,14,0,-14
12249,0,0,49,0,-49
12250,0,0,102,0,-102
12251,1,0,2,0,-2
12252,1,1,998,4523,3525
12253,0,0,48,0,-48
12254,0,0,16,0,-16
12255,1,0,36,0,-36
12256,1,0,83,0,-83
12257,0,0,26,0,-26
12258,0,0,55,0,-55
12259,1,1,163,1608,1445
12260,1,0,143,0,-143
12261,0,0,57,0,-57
12262,1,1,164,1449,1285
12263,1,0,137,0,-137
12264,1,0,22,0,-22
12265,1,0,89,0,-89
12266,0,0,40,0,-40
12267,0,0,94,0,-94
12268,0,0,26,0,-26
12269,1,1,419,2005,1586
12270,0,0,9,0,-9
12271,1,0,12,0,-12
12272,0,0,25,0,-25
12273,1,1,735,1564,829
12274,1,1,296,1814,1518
12275,0,0,222,0,-222
12276,1,1,928,1319,391
12277,0,0,110,0,-110
12278,0,0,33,0,-33
12279,1,1,144,1255,1111
12280,0,0,50,0,-50
12281,0,0,26,0,-26
12282,1,0,22,0,-22
12283,0,0,47,0,-47
12284,1,1,1344,1344,0
12285,0,0,38,0,-38
12286,1,1,2059,1278,-781
12287,0,0,85,0,-85
12288,1,1,151,2050,1899
12289,1,0,3,0,-3
12290,1,0,27,0,-27
12291,0,0,13,0,-13
12292,1,0,29,0,-29
12293,0,0,29,0,-29
12294,0,0,118,0,-118
12295,0,0,1,0,-1
12296,1,0,0,0,0
12297,1,0,89,0,-89
12298,1,0,29,0,-29
12299,0,0,32,0,-32
12300,0,0,4,0,-4
12301,0,0,28,0,-28
12302,1,0,179,0,-179
12303,1,1,955,1733,778
12304,0,0,116,0,-116
12305,1,0,1,0,-1
12306,1,0,47,0,-47
12307,0,0,157,0,-157
12308,1,1,747,1571,824
12309,0,0,112,0,-112
12310,1,1,386,1275,889
12311,1,1,402,1559,1157
12312,1,0,17,0,-17
12313,1,0,43,0,-43
12314,0,0,10,0,-10
12315,0,0,22,0,-22
12316,0,0,92,0,-92
12317,1,1,561,1259,698
12318,0,0,96,0,-96
12319,1,0,26,0,-26
12320,0,0,78,0,-78
12321,0,0,30,0,-30
12322,1,0,3,0,-3
12323,1,0,2,0,-2
12324,0,0,43,0,-43
12325,0,0,52,0,-52
12326,0,0,70,0,-70
12327,0,0,90,0,-90
12328,1,1,386,1449,1063
12329,1,1,227,1415,1188
12330,1,0,2,0,-2
12331,1,0,6,0,-6
12332,0,0,2,0,-2
12333,1,0,22,0,-22
12334,0,0,31,0,-31
12335,1,1,493,1767,1274
12336,1,1,79,1326,1247
12337,0,0,2,0,-2
12338,0,0,40,0,-40
12339,1,0,166,0,-166
12340,1,1,418,1927,1509
12341,1,0,21,0,-21
12342,0,0,11,0,-11
12343,1,1,504,1256,752
12344,1,1,86,1279,1193
12345,0,0,4,0,-4
12346,0,0,26,0,-26
12347,0,0,18,0,-18
12348,1,0,10,0,-10
12349,1,1,541,1408,867
12350,0,0,26,0,-26
12351,1,0,27,0,-27
12352,0,0,86,0,-86
12353,1,0,39,0,-39
12354,0,0,86,0,-86
12355,0,0,34,0,-34
12356,1,1,278,1608,1330
12357,1,0,40,0,-40
12358,0,0,26,0,-26
12359,0,0,5,0,-5
12360,1,0,42,0,-42
12361,1,0,3,0,-3
12362,1,0,43,0,-43
12363,0,0,5,0,-5
12364,1,0,1,0,-1
12365,0,0,16,0,-16
12366,0,0,70,0,-70
12367,0,0,7,0,-7
12368,0,0,66,0,-66
12369,1,1,346,3522,3176
12370,1,0,94,0,-94
12371,0,0,48,0,-48
12372,0,0,10,0,-10
12373,1,0,37,0,-37
12374,1,0,56,0,-56
12375,0,0,23,0,-23
12376,0,0,78,0,-78
12377,0,0,37,0,-37
12378,0,0,120,0,-120
12379,1,1,1106,1311,205
12380,1,0,75,0,-75
12381,0,0,43,0,-43
12382,1,0,53,0,-53
12383,1,1,349,2177,1828
12384,1,1,895,1243,348
12385,1,0,47,0,-47
12386,0,0,7,0,-7
12387,1,0,23,0,-23
12388,1,1,511,1453,942
12389,0,0,50,0,-50
12390,0,0,14,0,-14
12391,1,0,38,0,-38
12392,0,0,68,0,-68
12393,1,0,100,0,-100
12394,1,0,15,0,-15
12395,0,0,3,0,-3
12396,0,0,9,0,-9
12397,0,0,134,0,-134
12398,1,1,158,1480,1322
12399,1,0,71,0,-71
12400,0,0,13,0,-13
12401,0,0,17,0,-17
12402,1,1,1368,3732,2364
12403,1,1,161,4215,4054
12404,1,0,146,0,-146
12405,1,1,2170,1973,-197
12406,0,0,46,0,-46
12407,0,0,103,0,-103
12408,0,0,41,0,-41
12409,1,0,11,0,-11
12410,1,1,1180,1327,147
12411,1,0,4,0,-4
12412,0,0,45,0,-45
12413,0,0,147,0,-147
12414,1,1,188,1525,1337
12415,1,0,41,0,-41
12416,0,0,8,0,-8
12417,1,1,144,1548,1404
12418,1,0,68,0,-68
12419,1,1,1008,1260,252
12420,0,0,63,0,-63
12421,0,0,24,0,-24
12422,0,0,169,0,-169
12423,0,0,26,0,-26
12424,0,0,117,0,-117
12425,0,0,18,0,-18
12426,0,0,128,0,-128
12427,0,0,139,0,-139
12428,0,0,100,0,-100
12429,0,0,4,0,-4
12430,0,0,30,0,-30
12431,1,0,15,0,-15
12432,1,0,25,0,-25
12433,0,0,2,0,-2
12434,0,0,5,0,-5
12435,1,0,81,0,-81
12436,1,0,94,0,-94
12437,1,1,288,1622,1334
12438,0,0,1,0,-1
12439,0,0,34,0,-34
12440,0,0,79,0,-79
12441,0,0,10,0,-10
12442,1,1,114,1339,1225
12443,1,0,63,0,-63
12444,1,1,545,1545,1000
12445,1,1,107,2026,1919
12446,1,1,1324,1367,43
12447,1,1,304,1390,1086
12448,1,1,1199,1964,765
12449,0,0,134,0,-134
12450,0,0,91,0,-91
12451,0,0,41,0,-41
12452,1,1,274,1402,1128
12453,0,0,17,0,-17
12454,1,1,1043,1467,424
12455,1,1,1835,1397,-438
12456,1,1,522,1837,1315
12457,0,0,1,0,-1
12458,0,0,44,0,-44
12459,1,0,49,0,-49
12460,0,0,41,0,-41
12461,1,1,430,1374,944
12462,1,0,29,0,-29
12463,1,0,7,0,-7
12464,1,0,181,0,-181
12465,1,1,30,1610,1580
12466,1,1,697,2034,1337
12467,1,1,993,1741,748
12468,0,0,23,0,-23
12469,1,0,38,0,-38
12470,1,0,38,0,-38
12471,1,0,12,0,-12
12472,0,0,6,0,-6
12473,1,1,211,1398,1187
12474,0,0,107,0,-107
12475,1,0,75,0,-75
12476,0,0,45,0,-45
12477,1,1,996,1292,296
12478,1,1,480,1271,791
12479,1,0,36,0,-36
12480,0,0,67,0,-67
12481,0,0,50,0,-50
12482,1,0,30,0,-30
12483,1,0,37,0,-37
12484,0,0,63,0,-63
12485,1,1,2041,1534,-507
12486,0,0,56,0,-56
12487,1,0,159,0,-159
12488,1,1,192,1511,1319
12489,0,0,22,0,-22
12490,0,0,276,0,-276
12491,1,1,597,1236,639
12492,0,0,126,0,-126
12493,0,0,19,0,-19
12494,1,1,914,1512,598
12495,1,1,612,1495,883
12496,1,0,89,0,-89
12497,1,0,108,0,-108
12498,0,0,124,0,-124
12499,0,0,6,0,-6
12500,0,0,183,0,-183
12501,1,1,277,2940,2663
12502,1,0,4,0,-4
12503,1,1,290,1248,958
12504,1,0,14,0,-14
12505,1,0,27,0,-27
12506,1,1,111,1283,1172
12507,1,1,1348,1423,75
12508,1,0,23,0,-23
12509,1,1,62,2904,2842
12510,1,1,290,1793,1503
12511,0,0,90,0,-90
12512,1,0,18,0,-18
12513,1,0,9,0,-9
12514,0,0,60,0,-60
12515,0,0,47,0,-47
12516,1,0,121,0,-121
12517,1,1,1487,1469,-18
12518,0,0,8,0,-8
12519,1,1,934,1255,321
12520,0,0,151,0,-151
12521,0,0,22,0,-22
12522,0,0,38,0,-38
12523,0,0,19,0,-19
12524,0,0,34,0,-34
12525,0,0,15,0,-15
12526,1,0,89,0,-89
12527,1,1,101,1546,1445
12528,1,1,1436,1588,152
12529,1,0,54,0,-54
12530,0,0,27,0,-27
12531,1,1,58,1530,1472
12532,1,1,2961,1317,-1644
12533,1,0,39,0,-39
12534,0,0,244,0,-244
12535,1,0,91,0,-91
12536,1,0,15,0,-15
12537,0,0,71,0,-71
12538,0,0,83,0,-83
12539,1,0,1,0,-1
12540,1,1,1098,1895,797
12541,1,0,58,0,-58
12542,0,0,21,0,-21
12543,0,0,202,0,-202
12544,1,0,242,0,-242
12545,0,0,4,0,-4
12546,1,0,14,0,-14
12547,1,0,46,0,-46
12548,0,0,19,0,-19
12549,1,0,16,0,-16
12550,0,0,6,0,-6
12551,1,0,100,0,-100
12552,0,0,123,0,-123
12553,0,0,2,0,-2
12554,1,1,204,1836,1632
12555,0,0,112,0,-112
12556,0,0,202,0,-202
12557,1,1,707,1384,677
12558,0,0,39,0,-39
12559,1,0,13,0,-13
12560,0,0,26,0,-26
12561,1,0,48,0,-48
12562,1,1,343,1379,1036
12563,1,1,138,1388,1250
12564,0,0,82,0,-82
12565,1,1,405,1388,983
12566,0,0,57,0,-57
12567,0,0,69,0,-69
12568,1,0,20,0,-20
12569,0,0,12,0,-12
12570,1,0,34,0,-34
12571,0,0,8,0,-8
12572,0,0,28,0,-28
12573,0,0,32,0,-32
12574,0,0,28,0,-28
12575,0,0,123,0,-123
12576,1,0,36,0,-36
12577,1,1,750,1267,517
12578,1,0,12,0,-12
12579,0,0,179,0,-179
12580,1,0,171,0,-171
12581,0,0,100,0,-100
12582,1,1,341,2648,2307
12583,1,0,6,0,-6
12584,1,0,18,0,-18
12585,0,0,51,0,-51
12586,1,1,155,2148,1993
12587,0,0,58,0,-58
12588,1,1,539,1464,925
12589,1,1,60,1719,1659
12590,0,0,173,0,-173
12591,1,0,28,0,-28
12592,0,0,3,0,-3
12593,0,0,68,0,-68
12594,0,0,129,0,-129
12595,1,0,23,0,-23
12596,1,1,323,1265,942
12597,1,0,23,0,-23
12598,1,1,448,1270,822
12599,1,1,783,1577,794
12600,1,0,65,0,-65
12601,0,0,70,0,-70
12602,1,0,248,0,-248
12603,1,0,139,0,-139
12604,0,0,0,0,0
12605,0,0,22,0,-22
12606,0,0,9,0,-9
12607,1,0,26,0,-26
12608,1,0,17,0,-17
12609,1,1,175,1402,1227
12610,0,0,23,0,-23
12611,1,0,144,0,-144
12612,1,1,834,1385,551
12613,1,0,83,0,-83
12614,1,0,111,0,-111
12615,0,0,74,0,-74
12616,1,1,88,1365,1277
12617,0,0,20,0,-20
12618,1,1,133,1295,1162
12619,1,0,10,0,-10
12620,1,1,825,1690,865
12621,0,0,53,0,-53
12622,0,0,66,0,-66
12623,0,0,12,0,-12
12624,0,0,72,0,-72
12625,1,0,165,0,-165
12626,1,1,189,1607,1418
12627,0,0,189,0,-189
12628,0,0,54,0,-54
12629,0,0,64,0,-64
12630,1,1,608,2095,1487
12631,0,0,75,0,-75
12632,1,1,451,1500,1049
12633,1,1,206,1260,1054
12634,0,0,37,0,-37
12635,1,1,486,2288,1802
12636,0,0,108,0,-108
12637,0,0,4,0,-4
12638,0,0,73,0,-73
12639,1,1,1520,1660,140
12640,1,0,169,0,-169
12641,1,0,25,0,-25
12642,1,0,16,0,-16
12643,1,0,9,0,-9
12644,1,1,1358,2175,817
12645,1,0,6,0,-6
12646,0,0,143,0,-143
12647,1,1,425,1342,917
12648,1,0,38,0,-38
12649,1,1,313,1465,1152
12650,0,0,89,0,-89
12651,1,0,41,0,-41
12652,0,0,11,0,-11
12653,0,0,69,0,-69
12654,0,0,147,0,-147
12655,0,0,64,0,-64
12656,1,0,89,0,-89
12657,1,0,52,0,-52
12658,0,0,178,0,-178
12659,1,1,618,1917,1299
12660,1,0,29,0,-29
12661,1,0,119,0,-119
12662,1,1,409,1265,856
12663,1,0,45,0,-45
12664,0,0,33,0,-33
12665,0,0,44,0,-44
12666,0,0,37,0,-37
12667,1,1,29,1792,1763
12668,1,0,69,0,-69
12669,1,0,15,0,-15
12670,1,1,168,2287,2119
12671,1,0,16,0,-16
12672,0,0,18,0,-18
12673,1,1,161,1757,1596
12674,0,0,26,0,-26
12675,1,1,308,2041,1733
12676,1,0,45,0,-45
12677,1,1,1045,1459,414
12678,0,0,51,0,-51
12679,1,0,91,0,-91
12680,0,0,58,0,-58
12681,0,0,31,0,-31
12682,1,0,92,0,-92
12683,1,1,326,1440,1114
12684,0,0,15,0,-15
12685,1,1,245,1235,990
12686,0,0,75,0,-75
12687,0,0,145,0,-145
12688,1,1,579,2714,2135
12689,1,0,38,0,-38
12690,1,0,11,0,-11
12691,0,0,23,0,-23
12692,0,0,1,0,-1
12693,1,0,39,0,-39
12694,0,0,41,0,-41
12695,0,0,55,0,-55
12696,1,0,8,0,-8
12697,0,0,24,0,-24
12698,1,0,48,0,-48
12699,1,1,996,2764,1768
12700,0,0,43,0,-43
12701,1,0,121,0,-121
12702,1,1,108,1416,1308
12703,1,1,84,1417,1333
12704,1,1,1750,1339,-411
12705,0,0,8,0,-8
12706,1,0,0,0,0
12707,1,0,43,0,-43
12708,1,0,14,0,-14
12709,0,0,1,0,-1
12710,0,0,82,0,-82
12711,0,0,17,0,-17
12712,1,0,19,0,-19
12713,1,1,184,1307,1123
12714,0,0,31,0,-31
12715,1,1,220,2224,2004
12716,0,0,99,0,-99
12717,1,1,114,1491,1377
12718,1,1,517,1825,1308
12719,1,1,1243,1498,255
12720,1,0,13,0,-13
12721,1,0,15,0,-15
12722,1,1,583,1378,795
12723,0,0,66,0,-66
12724,1,1,241,1574,1333
12725,1,1,60,1402,1342
12726,1,0,15,0,-15
12727,0,0,54,0,-54
12728,0,0,35,0,-35
12729,0,0,29,0,-29
12730,0,0,46,0,-46
12731,1,0,164,0,-164
12732,1,0,66,0,-66
12733,1,0,177,0,-177
12734,1,1,654,1288,634
12735,1,0,55,0,-55
12736,1,0,61,0,-61
12737,0,0,29,0,-29
12738,1,1,1017,1236,219
12739,0,0,2,0,-2
12740,1,1,153,1816,1663
12741,1,1,439,1313,874
12742,1,0,5,0,-5
12743,1,0,8,0,-8
12744,1,1,165,1284,1119
12745,1,1,412,1410,998
12746,0,0,23,0,-23
12747,0,0,22,0,-22
12748,1,1,1057,1495,438
12749,1,0,21,0,-21
12750,0,0,7,0,-7
12751,1,1,107,1612,1505
12752,1,0,50,0,-50
12753,1,0,28,0,-28
12754,0,0,26,0,-26
12755,1,1,416,1235,819
12756,1,1,427,1645,1218
12757,1,0,33,0,-33
12758,0,0,226,0,-226
12759,1,0,73,0,-73
12760,1,0,150,0,-150
12761,1,1,813,1490,677
12762,0,0,22,0,-22
12763,1,0,10,0,-10
12764,1,0,48,0,-48
12765,1,1,255,1411,1156
12766,1,1,82,1329,1247
12767,0,0,5,0,-5
12768,0,0,37,0,-37
12769,1,0,34,0,-34
12770,0,0,12,0,-12
12771,1,1,99,1250,1151
12772,0,0,12,0,-12
12773,1,0,51,0,-51
12774,1,0,63,0,-63
12775,1,1,321,1356,1035
12776,1,0,53,0,-53
12777,0,0,193,0,-193
12778,0,0,13,0,-13
12779,0,0,8,0,-8
12780,1,0,66,0,-66
12781,0,0,71,0,-71
12782,1,1,121,2094,1973
12783,1,1,250,1685,1435
12784,0,0,27,0,-27
12785,0,0,60,0,-60
12786,1,1,189,1563,1374
12787,0,0,138,0,-138
12788,0,0,38,0,-38
12789,1,0,26,0,-26
12790,1,1,676,1721,1045
12791,0,0,5,0,-5
12792,1,0,197,0,-197
12793,0,0,193,0,-193
12794,0,0,98,0,-98
12795,0,0,35,0,-35
12796,1,1,54,1419,1365
12797,1,1,1802,1278,-524
12798,1,1,216,1547,1331
12799,0,0,94,0,-94
12800,1,1,204,1363,1159
12801,1,1,2741,1625,-1116
12802,1,1,1104,1287,183
12803,0,0,92,0,-92
12804,1,1,174,1665,1491
12805,1,0,22,0,-22
12806,1,1,170,1326,1156
12807,0,0,200,0,-200
12808,1,1,1145,3069,1924
12809,1,1,512,1652,1140
12810,1,1,458,1349,891
12811,1,0,19,0,-19
12812,1,1,229,2145,1916
12813,1,1,1141,1606,465
12814,0,0,4,0,-4
12815,1,0,10,0,-10
12816,0,0,32,0,-32
12817,0,0,156,0,-156
12818,0,0,8,0,-8
12819,1,1,353,1746,1393
12820,0,0,5,0,-5
12821,1,1,521,1292,771
12822,1,0,9,0,-9
12823,1,1,820,1545,725
12824,0,0,3,0,-3
12825,1,1,298,1758,1460
12826,1,0,32,0,-32
12827,1,1,49,1519,1470
12828,1,0,165,0,-165
12829,1,1,474,1310,836
12830,0,0,59,0,-59
12831,1,0,0,0,0
12832,1,1,1007,1335,328
12833,0,0,5,0,-5
12834,0,0,8,0,-8
12835,1,0,83,0,-83
12836,0,0,79,0,-79
12837,0,0,130,0,-130
12838,0,0,25,0,-25
12839,1,1,793,1588,795
12840,1,0,47,0,-47
12841,1,0,60,0,-60
12842,1,0,4,0,-4
12843,0,0,17,0,-17
12844,0,0,56,0,-56
12845,1,0,33,0,-33
12846,0,0,1,0,-1
12847,0,0,6,0,-6
12848,1,1,197,1258,1061
12849,1,0,81,0,-81
12850,1,1,133,1378,1245
12851,0,0,54,0,-54
12852,0,0,2,0,-2
12853,0,0,31,0,-31
12854,1,1,249,1551,1302
12855,0,0,102,0,-102
12856,0,0,8,0,-8
12857,1,0,27,0,-27
12858,1,0,0,0,0
12859,0,0,27,0,-27
12860,0,0,7,0,-7
12861,1,1,212,1560,1348
12862,1,1,461,1246,785
12863,1,0,33,0,-33
12864,1,0,0,0,0
12865,0,0,74,0,-74
12866,0,0,37,0,-37
12867,1,1,745,1932,1187
12868,0,0,3,0,-3
12869,1,1,327,1314,987
12870,1,1,79,1464,1385
12871,1,1,266,1253,987
12872,0,0,45,0,-45
12873,0,0,31,0,-31
12874,1,1,852,1258,406
12875,0,0,3,0,-3
12876,1,1,138,1862,1724
12877,1,1,363,2854,2491
12878,1,0,75,0,-75
12879,1,0,57,0,-57
12880,1,1,150,2003,1853
12881,1,0,83,0,-83
12882,0,0,15,0,-15
12883,0,0,6,0,-6
12884,0,0,2,0,-2
12885,1,0,24,0,-24
12886,1,1,532,1308,776
12887,0,0,97,0,-97
12888,1,1,309,1640,1331
12889,1,0,122,0,-122
12890,0,0,11,0,-11
12891,1,1,831,4313,3482
12892,1,0,69,0,-69
12893,0,0,58,0,-58
12894,1,0,18,0,-18
12895,0,0,3,0,-3
12896,1,0,5,0,-5
12897,1,1,1084,2122,1038
12898,0,0,40,0,-40
12899,0,0,63,0,-63
12900,1,0,168,0,-168
12901,1,1,106,1239,1133
12902,0,0,66,0,-66
12903,0,0,85,0,-85
12904,1,0,59,0,-59
12905,1,0,3,0,-3
12906,1,1,67,1328,1261
12907,0,0,69,0,-69
12908,1,0,30,0,-30
12909,1,1,163,1466,1303
12910,0,0,25,0,-25
12911,0,0,3,0,-3
12912,1,0,4,0,-4
12913,1,1,838,1367,529
12914,1,0,26,0,-26
12915,0,0,0,0,0
12916,1,0,8,0,-8
12917,1,0,17,0,-17
12918,1,1,17,1752,1735
12919,1,1,502,1287,785
12920,1,1,448,1376,928
12921,1,1,659,1321,662
12922,1,0,71,0,-71
12923,1,1,690,1328,638
12924,1,1,62,1903,1841
12925,1,0,23,0,-23
12926,1,0,40,0,-40
12927,0,0,11,0,-11
12928,0,0,18,0,-18
12929,0,0,6,0,-6
12930,1,0,0,0,0
12931,0,0,55,0,-55
12932,1,0,124,0,-124
12933,0,0,61,0,-61
12934,0,0,3,0,-3
12935,1,0,13,0,-13
12936,1,0,8,0,-8
12937,1,0,64,0,-64
12938,0,0,85,0,-85
12939,1,1,704,1890,1186
12940,1,1,2038,2643,605
12941,0,0,48,0,-48
12942,0,0,17,0,-17
12943,0,0,11,0,-11
12944,0,0,19,0,-19
12945,0,0,47,0,-47
12946,1,0,129,0,-129
12947,0,0,14,0,-14
12948,0,0,51,0,-51
12949,0,0,17,0,-17
12950,1,1,1120,2334,1214
12951,1,0,19,0,-19
12952,0,0,37,0,-37
12953,1,0,22,0,-22
12954,1,0,57,0,-57
12955,0,0,14,0,-14
12956,0,0,6,0,-6
12957,0,0,37,0,-37
12958,1,0,62,0,-62
12959,0,0,20,0,-20
12960,0,0,13,0,-13
12961,0,0,22,0,-22
12962,0,0,15,0,-15
12963,1,0,10,0,-10
12964,0,0,12,0,-12
12965,0,0,2,0,-2
12966,1,0,57,0,-57
12967,1,1,272,1498,1226
12968,0,0,119,0,-119
12969,1,1,2403,1484,-919
12970,1,1,1138,2332,1194
12971,1,0,6,0,-6
12972,0,0,19,0,-19
12973,1,1,90,1338,1248
12974,0,0,7,0,-7
12975,0,0,32,0,-32
12976,1,1,660,1250,590
12977,0,0,46,0,-46
12978,1,0,71,0,-71
12979,1,1,360,2041,1681
12980,1,0,4,0,-4
12981,1,1,832,1364,532
12982,1,1,471,1879,1408
12983,0,0,2,0,-2
12984,1,0,50,0,-50
12985,1,0,173,0,-173
12986,1,1,1650,2361,711
12987,0,0,84,0,-84
12988,0,0,22,0,-22
12989,1,0,112,0,-112
12990,1,1,851,1252,401
12991,1,1,1199,1591,392
12992,1,1,26,1465,1439
12993,1,0,67,0,-67
12994,0,0,91,0,-91
12995,1,0,5,0,-5
12996,1,0,36,0,-36
12997,1,0,12,0,-12
12998,1,0,9,0,-9
12999,1,0,14,0,-14
13000,0,0,69,0,-69
13001,1,0,39,0,-39
13002,0,0,8,0,-8
13003,1,0,168,0,-168
13004,1,0,6,0,-6
13005,1,1,32,1753,1721
13006,0,0,16,0,-16
13007,0,0,63,0,-63
13008,1,1,442,2098,1656
13009,1,1,304,1254,950
13010,1,0,27,0,-27
13011,1,1,284,3782,3498
13012,1,1,821,3724,2903
13013,1,0,34,0,-34
13014,0,0,5,0,-5
13015,1,1,914,1877,963
13016,1,1,315,1866,1551
13017,1,1,529,1317,788
13018,1,0,15,0,-15
13019,1,1,530,1838,1308
13020,1,0,12,0,-12
13021,1,0,23,0,-23
13022,0,0,21,0,-21
13023,1,0,17,0,-17
13024,1,1,251,1631,1380
13025,1,1,299,1634,1335
13026,1,1,1016,2071,1055
13027,0,0,5,0,-5
13028,0,0,20,0,-20
13029,0,0,83,0,-83
13030,0,0,9,0,-9
13031,0,0,128,0,-128
13032,1,1,227,1489,1262
13033,1,0,6,0,-6
13034,1,0,15,0,-15
13035,1,1,419,2020,1601
13036,1,1,219,1272,1053
13037,0,0,33,0,-33
13038,0,0,83,0,-83
13039,0,0,13,0,-13
13040,1,1,310,1468,1158
13041,1,0,34,0,-34
13042,0,0,46,0,-46
13043,0,0,0,0,0
13044,1,0,5,0,-5
13045,1,1,313,1817,1504
13046,0,0,14,0,-14
13047,0,0,10,0,-10
13048,1,1,419,1268,849
13049,1,0,6,0,-6
13050,1,0,20,0,-20
13051,0,0,2,0,-2
13052,1,1,280,1422,1142
13053,0,0,32,0,-32
13054,0,0,132,0,-132
13055,0,0,52,0,-52
13056,1,0,11,0,-11
13057,0,0,10,0,-10
13058,1,0,98,0,-98
13059,1,1,271,1960,1689
13060,0,0,108,0,-108
13061,0,0,80,0,-80
13062,1,1,835,2028,1193
13063,1,0,0,0,0
13064,1,0,69,0,-69
13065,1,1,36,1361,1325
13066,1,1,807,1533,726
13067,1,0,48,0,-48
13068,1,0,57,0,-57
13069,1,1,1101,2695,1594
13070,0,0,131,0,-131
13071,0,0,54,0,-54
13072,0,0,81,0,-81
13073,1,1,324,1960,1636
13074,1,0,11,0,-11
13075,0,0,47,0,-47
13076,0,0,4,0,-4
13077,1,0,73,0,-73
13078,0,0,14,0,-14
13079,1,1,54,1236,1182
13080,1,1,1000,2250,1250
13081,0,0,17,0,-17
13082,1,1,255,3658,3403
13083,0,0,107,0,-107
13084,0,0,144,0,-144
13085,0,0,49,0,-49
13086,1,0,54,0,-54
13087,0,0,23,0,-23
13088,1,1,806,1542,736
13089,1,0,24,0,-24
13090,1,1,310,1258,948
13091,1,0,23,0,-23
13092,0,0,106,0,-106
13093,1,0,370,0,-370
13094,1,1,993,1813,820
13095,0,0,82,0,-82
13096,1,0,51,0,-51
13097,1,1,194,2188,1994
13098,0,0,10,0,-10
13099,1,1,499,1392,893
13100,0,0,205,0,-205
13101,1,0,96,0,-96
13102,0,0,14,0,-14
13103,0,0,31,0,-31
13104,0,0,4,0,-4
13105,0,0,174,0,-174
13106,1,1,191,1245,1054
13107,0,0,1,0,-1
13108,1,0,34,0,-34
13109,1,1,80,1581,1501
13110,0,0,10,0,-10
13111,1,0,61,0,-61
13112,0,0,137,0,-137
13113,1,1,314,1629,1315
13114,1,1,101,1236,1135
13115,0,0,66,0,-66
13116,1,1,230,1638,1408
13117,1,0,15,0,-15
13118,0,0,3,0,-3
13119,1,0,257,0,-257
13120,1,0,61,0,-61
13121,1,1,165,1243,1078
13122,0,0,34,0,-34
13123,1,0,224,0,-224
13124,0,0,1,0,-1
13125,1,0,6,0,-6
13126,1,1,175,1917,1742
13127,0,0,22,0,-22
13128,1,1,1339,1278,-61
13129,1,1,421,1302,881
13130,0,0,102,0,-102
13131,1,0,12,0,-12
13132,0,0,38,0,-38
13133,1,1,150,1337,1187
13134,1,1,1213,1376,163
13135,1,1,762,1308,546
13136,1,1,115,2286,2171
13137,0,0,59,0,-59
13138,0,0,36,0,-36
13139,1,1,620,1307,687
13140,1,1,938,1453,515
13141,1,1,890,1246,356
13142,1,0,16,0,-16
13143,1,1,1536,1744,208
13144,0,0,98,0,-98
13145,0,0,22,0,-22
13146,0,0,25,0,-25
13147,1,0,37,0,-37
13148,1,1,829,1373,544
13149,0,0,20,0,-20
13150,0,0,59,0,-59
13151,0,0,9,0,-9
13152,0,0,94,0,-94
13153,0,0,84,0,-84
13154,1,0,40,0,-40
13155,0,0,19,0,-19
13156,0,0,16,0,-16
13157,1,1,356,1362,1006
13158,1,0,30,0,-30
13159,1,1,666,1415,749
13160,0,0,1,0,-1
13161,0,0,43,0,-43
13162,0,0,112,0,-112
13163,0,0,9,0,-9
13164,0,0,79,0,-79
13165,1,0,34,0,-34
13166,0,0,48,0,-48
13167,0,0,115,0,-115
13168,1,1,1926,1310,-616
13169,1,1,187,1298,1111
13170,1,0,5,0,-5
13171,1,1,74,1235,1161
13172,1,0,28,0,-28
13173,1,1,809,2719,1910
13174,1,0,38,0,-38
13175,1,1,140,1397,1257
13176,0,0,2,0,-2
13177,0,0,39,0,-39
13178,0,0,27,0,-27
13179,0,0,46,0,-46
13180,1,1,434,1481,1047
13181,0,0,11,0,-11
13182,1,0,120,0,-120
13183,1,1,1277,1595,318
13184,0,0,113,0,-113
13185,1,1,185,1630,1445
13186,1,1,615,1681,1066
13187,0,0,29,0,-29
13188,0,0,115,0,-115
13189,0,0,75,0,-75
13190,1,1,1078,1349,271
13191,1,0,45,0,-45
13192,1,0,21,0,-21
13193,1,1,2014,1251,-763
13194,1,1,179,2219,2040
13195,0,0,80,0,-80
13196,0,0,146,0,-146
13197,0,0,11,0,-11
13198,0,0,5,0,-5
13199,0,0,29,0,-29
13200,1,1,2274,2352,78
13201,0,0,44,0,-44
13202,0,0,55,0,-55
13203,1,0,64,0,-64
13204,0,0,49,0,-49
13205,1,1,60,1373,1313
13206,1,0,26,0,-26
13207,1,0,146,0,-146
13208,1,1,173,1384,1211
13209,0,0,141,0,-141
13210,1,0,51,0,-51
13211,1,0,30,0,-30
13212,0,0,27,0,-27
13213,0,0,99,0,-99
13214,1,0,48,0,-48
13215,0,0,17,0,-17
13216,1,0,27,0,-27
13217,1,1,1047,1705,658
13218,1,1,355,1550,1195
13219,0,0,41,0,-41
13220,0,0,50,0,-50
13221,1,1,1163,1533,370
13222,1,1,434,1317,883
13223,1,0,46,0,-46
13224,0,0,4,0,-4
13225,1,1,140,1364,1224
13226,1,0,77,0,-77
13227,1,0,93,0,-93
13228,1,1,1194,1495,301
13229,0,0,120,0,-120
13230,0,0,6,0,-6
13231,0,0,14,0,-14
13232,0,0,1,0,-1
13233,0,0,10,0,-10
13234,1,0,106,0,-106
13235,1,0,11,0,-11
13236,0,0,121,0,-121
13237,1,1,1322,1410,88
13238,1,1,360,1280,920
13239,0,0,0,0,0
13240,1,1,699,1875,1176
13241,0,0,31,0,-31
13242,1,1,270,1620,1350
13243,1,0,172,0,-172
13244,0,0,22,0,-22
13245,1,1,384,1649,1265
13246,1,0,5,0,-5
13247,1,0,94,0,-94
13248,1,1,367,1625,1258
13249,0,0,73,0,-73
13250,0,0,11,0,-11
13251,1,1,1285,1370,85
13252,0,0,53,0,-53
13253,1,0,19,0,-19
13254,1,1,619,1497,878
13255,1,1,216,2295,2079
13256,0,0,111,0,-111
13257,0,0,50,0,-50
13258,1,0,61,0,-61
13259,1,0,15,0,-15
13260,1,1,206,2717,2511
13261,1,0,136,0,-136
13262,0,0,19,0,-19
13263,1,0,10,0,-10
13264,1,0,154,0,-154
13265,1,0,61,0,-61
13266,1,1,434,1325,891
13267,1,0,11,0,-11
13268,1,0,7,0,-7
13269,1,0,75,0,-75
13270,1,0,4,0,-4
13271,1,0,9,0,-9
13272,1,0,1,0,-1
13273,1,1,757,1413,656
13274,1,0,16,0,-16
13275,0,0,62,0,-62
13276,1,1,465,2081,1616
13277,0,0,81,0,-81
13278,0,0,33,0,-33
13279,0,0,24,0,-24
13280,1,0,24,0,-24
13281,1,1,707,1325,618
13282,1,1,779,1619,840
13283,1,1,993,1310,317
13284,0,0,7,0,-7
13285,1,0,39,0,-39
13286,0,0,9,0,-9
13287,1,1,339,2016,1677
13288,1,1,1798,1593,-205
13289,0,0,67,0,-67
13290,1,0,37,0,-37
13291,0,0,55,0,-55
13292,1,0,21,0,-21
13293,0,0,98,0,-98
13294,0,0,19,0,-19
13295,1,1,764,1330,566
13296,0,0,24,0,-24
13297,0,0,4,0,-4
13298,1,1,80,1251,1171
13299,0,0,0,0,0
13300,0,0,108,0,-108
13301,0,0,96,0,-96
13302,0,0,26,0,-26
13303,1,0,263,0,-263
13304,0,0,17,0,-17
13305,0,0,28,0,-28
13306,0,0,45,0,-45
13307,1,1,149,1267,1118
13308,1,1,518,1445,927
13309,0,0,19,0,-19
13310,1,1,124,1885,1761
13311,0,0,112,0,-112
13312,1,1,77,1638,1561
13313,1,1,217,1566,1349
13314,0,0,24,0,-24
13315,1,1,316,1367,1051
13316,1,0,4,0,-4
13317,1,1,215,3743,3528
13318,1,1,748,1236,488
13319,0,0,92,0,-92
13320,1,1,990,1842,852
13321,0,0,120,0,-120
13322,1,0,81,0,-81
13323,0,0,125,0,-125
13324,1,0,53,0,-53
13325,1,1,1230,1347,117
13326,0,0,44,0,-44
13327,1,1,420,1248,828
13328,1,0,90,0,-90
13329,1,1,371,1416,1045
13330,0,0,46,0,-46
13331,1,0,75,0,-75
13332,0,0,0,0,0
13333,1,0,7,0,-7
13334,1,1,99,3204,3105
13335,1,0,9,0,-9
13336,0,0,39,0,-39
13337,1,1,306,1469,1163
13338,1,1,172,1435,1263
13339,1,0,28,0,-28
13340,1,1,413,1279,866
13341,0,0,0,0,0
13342,1,1,570,2261,1691
13343,0,0,24,0,-24
13344,1,1,49,2100,2051
13345,0,0,94,0,-94
13346,0,0,11,0,-11
13347,1,0,107,0,-107
13348,1,0,56,0,-56
13349,1,1,1569,1288,-281
13350,0,0,20,0,-20
13351,0,0,112,0,-112
13352,0,0,2,0,-2
13353,1,0,44,0,-44
13354,1,1,595,1970,1375
13355,1,1,216,1658,1442
13356,0,0,14,0,-14
13357,1,1,443,1244,801
13358,0,0,30,0,-30
13359,1,1,152,1343,1191
13360,0,0,42,0,-42
13361,0,0,42,0,-42
13362,1,0,83,0,-83
13363,1,1,30,1720,1690
13364,0,0,134,0,-134
13365,0,0,51,0,-51
13366,0,0,44,0,-44
13367,1,0,34,0,-34
13368,1,0,4,0,-4
13369,0,0,48,0,-48
13370,1,1,89,1263,1174
13371,0,0,59,0,-59
13372,1,0,87,0,-87
13373,0,0,37,0,-37
13374,0,0,25,0,-25
13375,1,0,27,0,-27
13376,0,0,72,0,-72
13377,1,0,44,0,-44
13378,1,0,22,0,-22
13379,0,0,19,0,-19
13380,1,1,182,1518,1336
13381,1,0,129,0,-129
13382,1,1,138,2097,1959
13383,0,0,86,0,-86
13384,1,1,131,1349,1218
13385,1,0,142,0,-142
13386,1,1,233,1464,1231
13387,1,1,159,1259,1100
13388,1,0,59,0,-59
13389,1,1,229,2083,1854
13390,0,0,16,0,-16
13391,1,0,356,0,-356
13392,0,0,47,0,-47
13393,0,0,135,0,-135
13394,1,1,519,2237,1718
13395,1,1,467,1549,1082
13396,1,1,852,1288,436
13397,1,0,25,0,-25
13398,1,1,439,1283,844
13399,0,0,0,0,0
13400,1,1,536,1895,1359
13401,1,1,271,2233,1962
13402,1,1,863,1869,1006
13403,0,0,55,0,-55
13404,0,0,0,0,0
13405,1,1,257,1411,1154
13406,1,0,30,0,-30
13407,1,1,204,1382,1178
13408,1,0,36,0,-36
13409,1,1,1422,1248,-174
13410,0,0,41,0,-41
13411,1,1,768,1235,467
13412,0,0,120,0,-120
13413,0,0,11,0,-11
13414,1,1,510,1570,1060
13415,1,0,45,0,-45
13416,1,1,824,1315,491
13417,1,1,375,1290,915
13418,1,1,982,1265,283
13419,1,0,14,0,-14
13420,1,0,38,0,-38
13421,1,0,11,0,-11
13422,1,0,3,0,-3
13423,1,0,42,0,-42
13424,1,1,296,1321,1025
13425,1,1,464,1430,966
13426,1,1,1341,1367,26
13427,0,0,97,0,-97
13428,1,1,2095,1236,-859
13429,0,0,104,0,-104
13430,0,0,104,0,-104
13431,1,1,283,1634,1351
13432,1,0,81,0,-81
13433,0,0,39,0,-39
13434,0,0,36,0,-36
13435,0,0,3,0,-3
13436,1,0,14,0,-14
13437,0,0,26,0,-26
13438,1,0,55,0,-55
13439,0,0,47,0,-47
13440,1,1,87,2654,2567
13441,0,0,97,0,-97
13442,1,1,475,1592,1117
13443,1,1,311,2083,1772
13444,1,1,934,1867,933
13445,1,0,16,0,-16
13446,1,1,682,2930,2248
13447,1,1,290,1271,981
13448,1,0,10,0,-10
13449,1,0,144,0,-144
13450,1,1,462,1415,953
13451,1,1,685,1382,697
13452,1,1,1029,1271,242
13453,1,1,1320,1856,536
13454,1,0,1,0,-1
13455,1,1,270,1284,1014
13456,1,1,290,1310,1020
13457,1,1,609,1300,691
13458,0,0,6,0,-6
13459,1,0,10,0,-10
13460,0,0,42,0,-42
13461,1,1,403,1347,944
13462,0,0,63,0,-63
13463,1,0,50,0,-50
13464,1,0,102,0,-102
13465,1,0,51,0,-51
13466,1,1,393,1710,1317
13467,0,0,13,0,-13
13468,1,1,1645,1649,4
13469,1,0,6,0,-6
13470,1,0,96,0,-96
13471,1,0,10,0,-10
13472,1,1,66,1368,1302
13473,0,0,15,0,-15
13474,1,1,303,1666,1363
13475,0,0,141,0,-141
13476,1,1,597,1348,751
13477,1,0,67,0,-67
13478,0,0,195,0,-195
13479,1,0,34,0,-34
13480,1,0,116,0,-116
13481,0,0,3,0,-3
13482,1,0,16,0,-16
13483,1,0,25,0,-25
13484,0,0,70,0,-70
13485,0,0,187,0,-187
13486,0,0,158,0,-158
13487,0,0,18,0,-18
13488,1,0,248,0,-248
13489,1,1,964,1482,518
13490,1,1,303,1622,1319
13491,0,0,23,0,-23
13492,1,0,76,0,-76
13493,1,1,241,2192,1951
13494,1,0,30,0,-30
13495,1,1,1087,2862,1775
13496,1,0,110,0,-110
13497,1,0,94,0,-94
13498,0,0,27,0,-27
13499,1,1,640,1764,1124
13500,1,0,246,0,-246
13501,1,0,89,0,-89
13502,0,0,24,0,-24
13503,0,0,113,0,-113
13504,0,0,137,0,-137
13505,0,0,11,0,-11
13506,1,1,114,1236,1122
13507,0,0,93,0,-93
13508,1,1,515,2304,1789
13509,1,1,2331,1580,-751
13510,0,0,104,0,-104
13511,1,0,0,0,0
13512,0,0,5,0,-5
13513,1,1,187,1326,1139
13514,1,0,23,0,-23
13515,1,0,110,0,-110
13516,1,1,572,1273,701
13517,1,0,6,0,-6
13518,1,0,36,0,-36
13519,1,0,18,0,-18
13520,1,1,952,1347,395
13521,0,0,116,0,-116
13522,0,0,11,0,-11
13523,1,1,627,1388,761
13524,1,0,40,0,-40
13525,1,1,840,1497,657
13526,1,1,879,1289,410
13527,1,0,45,0,-45
13528,1,1,1565,1794,229
13529,1,0,53,0,-53
13530,0,0,41,0,-41
13531,0,0,110,0,-110
13532,1,1,272,1457,1185
13533,1,1,150,3217,3067
13534,1,0,1,0,-1
13535,0,0,48,0,-48
13536,1,1,673,1248,575
13537,1,0,15,0,-15
13538,0,0,44,0,-44
13539,0,0,8,0,-8
13540,1,1,43,1338,1295
13541,0,0,251,0,-251
13542,1,1,770,1429,659
13543,0,0,41,0,-41
13544,1,1,190,1740,1550
13545,0,0,126,0,-126
13546,0,0,26,0,-26
13547,0,0,24,0,-24
13548,0,0,88,0,-88
13549,1,1,691,1389,698
13550,0,0,76,0,-76
13551,0,0,38,0,-38
13552,1,1,2227,1442,-785
13553,0,0,92,0,-92
13554,0,0,12,0,-12
13555,1,1,159,1339,1180
13556,1,0,52,0,-52
13557,0,0,6,0,-6
13558,1,1,138,2488,2350
13559,1,1,3398,1469,-1929
13560,0,0,78,0,-78
13561,0,0,77,0,-77
13562,1,1,222,2627,2405
13563,0,0,57,0,-57
13564,1,1,380,1402,1022
13565,1,1,312,2251,1939
13566,0,0,27,0,-27
13567,1,1,385,1707,1322
13568,1,0,66,0,-66
13569,0,0,9,0,-9
13570,1,0,70,0,-70
13571,0,0,64,0,-64
13572,1,0,95,0,-95
13573,0,0,109,0,-109
13574,0,0,123,0,-123
13575,0,0,153,0,-153
13576,1,0,15,0,-15
13577,0,0,78,0,-78
13578,1,1,679,1451,772
13579,0,0,21,0,-21
13580,0,0,22,0,-22
13581,0,0,84,0,-84
13582,1,0,59,0,-59
13583,1,1,745,1422,677
13584,1,1,524,1488,964
13585,1,1,985,2054,1069
13586,0,0,2,0,-2
13587,0,0,7,0,-7
13588,1,0,22,0,-22
13589,1,0,30,0,-30
13590,1,1,398,1281,883
13591,1,1,517,1431,914
13592,0,0,22,0,-22
13593,1,1,535,1560,1025
13594,0,0,24,0,-24
13595,1,1,280,1975,1695
13596,1,0,4,0,-4
13597,1,1,110,2410,2300
13598,1,1,1780,2217,437
13599,0,0,20,0,-20
13600,0,0,5,0,-5
13601,0,0,18,0,-18
13602,0,0,106,0,-106
13603,1,0,155,0,-155
13604,1,1,877,1301,424
13605,1,1,289,1256,967
13606,1,0,12,0,-12
13607,0,0,44,0,-44
13608,1,1,579,1551,972
13609,1,0,4,0,-4
13610,1,0,1,0,-1
13611,0,0,22,0,-22
13612,1,0,95,0,-95
13613,0,0,22,0,-22
13614,1,1,400,1246,846
13615,0,0,97,0,-97
13616,1,1,186,2552,2366
13617,1,0,179,0,-179
13618,0,0,31,0,-31
13619,1,1,149,1394,1245
13620,1,0,3,0,-3
13621,1,1,443,1740,1297
13622,1,0,34,0,-34
13623,1,0,48,0,-48
13624,0,0,111,0,-111
13625,1,1,33,1717,1684
13626,0,0,52,0,-52
13627,1,0,25,0,-25
13628,1,1,728,1499,771
13629,0,0,133,0,-133
13630,1,0,158,0,-158
13631,1,0,90,0,-90
13632,1,1,297,1383,1086
13633,1,0,18,0,-18
13634,1,1,521,1446,925
13635,0,0,139,0,-139
13636,1,0,123,0,-123
13637,1,0,62,0,-62
13638,0,0,40,0,-40
13639,0,0,117,0,-117
13640,1,0,27,0,-27
13641,1,1,1145,1291,146
13642,0,0,17,0,-17
13643,1,0,17,0,-17
13644,1,0,176,0,-176
13645,0,0,40,0,-40
13646,1,1,387,2721,2334
13647,1,0,4,0,-4
13648,1,1,2586,3020,434
13649,1,1,256,1994,1738
13650,0,0,29,0,-29
13651,0,0,3,0,-3
13652,0,0,22,0,-22
13653,1,0,37,0,-37
13654,1,0,183,0,-183
13655,1,1,216,1889,1673
13656,1,0,18,0,-18
13657,0,0,6,0,-6
13658,0,0,122,0,-122
13659,1,1,228,1353,1125
13660,0,0,50,0,-50
13661,0,0,2,0,-2
13662,0,0,51,0,-51
13663,0,0,60,0,-60
13664,1,0,83,0,-83
13665,1,1,462,1859,1397
13666,1,1,537,1274,737
13667,0,0,96,0,-96
13668,0,0,3,0,-3
13669,1,1,686,1380,694
13670,0,0,7,0,-7
13671,1,0,12,0,-12
13672,1,0,20,0,-20
13673,1,1,415,1481,1066
13674,1,1,275,1860,1585
13675,0,0,20,0,-20
13676,1,0,23,0,-23
13677,1,1,463,1646,1183
13678,1,0,24,0,-24
13679,1,0,7,0,-7
13680,1,0,105,0,-105
13681,1,1,214,1882,1668
13682,0,0,17,0,-17
13683,0,0,0,0,0
13684,1,1,600,1764,1164
13685,1,0,14,0,-14
13686,0,0,0,0,0
13687,0,0,33,0,-33
13688,0,0,57,0,-57
13689,1,0,9,0,-9
13690,1,1,724,1257,533
13691,1,0,49,0,-49
13692,1,1,60,1333,1273
13693,0,0,142,0,-142
13694,0,0,10,0,-10
13695,1,0,0,0,0
13696,1,0,10,0,-10
13697,0,0,14,0,-14
13698,1,0,124,0,-124
13699,1,0,70,0,-70
13700,1,0,15,0,-15
13701,0,0,12,0,-12
13702,1,0,25,0,-25
13703,1,1,1321,1488,167
13704,0,0,60,0,-60
13705,0,0,5,0,-5
13706,1,1,618,2068,1450
13707,1,0,149,0,-149
13708,1,1,239,1272,1033
13709,0,0,83,0,-83
13710,0,0,58,0,-58
13711,1,0,39,0,-39
13712,1,1,555,1382,827
13713,0,0,3,0,-3
13714,1,0,15,0,-15
13715,1,1,773,4520,3747
13716,1,0,20,0,-20
13717,1,1,1572,1406,-166
13718,1,1,149,1681,1532
13719,1,1,578,1241,663
13720,0,0,68,0,-68
13721,0,0,5,0,-5
13722,0,0,6,0,-6
13723,1,1,1703,1886,183
13724,1,0,162,0,-162
13725,1,1,296,1602,1306
13726,1,1,127,1716,1589
13727,1,1,954,1409,455
13728,1,1,370,1346,976
13729,0,0,153,0,-153
13730,0,0,71,0,-71
13731,1,0,28,0,-28
13732,1,1,221,1588,1367
13733,1,0,112,0,-112
13734,0,0,31,0,-31
13735,1,0,21,0,-21
13736,1,1,161,1573,1412
13737,0,0,67,0,-67
13738,0,0,92,0,-92
13739,1,1,565,1675,1110
13740,0,0,5,0,-5
13741,1,0,74,0,-74
13742,1,1,1253,1298,45
13743,1,0,82,0,-82
13744,1,0,47,0,-47
13745,1,1,454,2709,2255
13746,1,0,76,0,-76
13747,0,0,15,0,-15
13748,1,1,305,1301,996
13749,1,0,42,0,-42
13750,1,0,5,0,-5
13751,1,1,1154,1723,569
13752,1,0,2,0,-2
13753,1,0,5,0,-5
13754,1,0,24,0,-24
13755,1,1,452,1299,847
13756,1,0,3,0,-3
13757,1,0,26,0,-26
13758,0,0,9,0,-9
13759,1,0,9,0,-9
13760,1,1,904,1853,949
13761,1,0,7,0,-7
13762,1,1,1421,1296,-125
13763,0,0,14,0,-14
13764,1,0,2,0,-2
13765,0,0,25,0,-25
13766,1,1,65,2298,2233
13767,1,1,283,1254,971
13768,1,1,237,1583,1346
13769,0,0,3,0,-3
13770,0,0,111,0,-111
13771,0,0,29,0,-29
13772,0,0,8,0,-8
13773,1,1,1254,1413,159
13774,1,0,11,0,-11
13775,1,0,109,0,-109
13776,0,0,7,0,-7
13777,0,0,68,0,-68
13778,0,0,12,0,-12
13779,1,0,11,0,-11
13780,1,0,67,0,-67
13781,1,0,69,0,-69
13782,1,0,1,0,-1
13783,0,0,111,0,-111
13784,1,0,8,0,-8
13785,1,0,24,0,-24
13786,0,0,63,0,-63
13787,1,0,79,0,-79
13788,1,1,175,1871,1696
13789,0,0,70,0,-70
13790,1,1,399,1671,1272
13791,1,0,4,0,-4
13792,1,1,1131,1319,188
13793,1,0,31,0,-31
13794,1,1,515,1535,1020
13795,0,0,80,0,-80
13796,1,0,72,0,-72
13797,1,0,54,0,-54
13798,1,0,13,0,-13
13799,1,0,12,0,-12
13800,1,1,123,1521,1398
13801,1,0,40,0,-40
13802,1,0,14,0,-14
13803,1,0,22,0,-22
13804,0,0,178,0,-178
13805,1,0,52,0,-52
13806,0,0,30,0,-30
13807,1,0,50,0,-50
13808,0,0,11,0,-11
13809,1,1,231,1821,1590
13810,1,0,26,0,-26
13811,0,0,140,0,-140
13812,1,0,51,0,-51
13813,1,1,608,1292,684
13814,1,1,307,1638,1331
13815,1,1,764,1898,1134
13816,1,1,336,1343,1007
13817,0,0,85,0,-85
13818,1,0,35,0,-35
13819,1,1,315,1756,1441
13820,1,1,300,1253,953
13821,1,1,247,2903,2656
13822,1,0,27,0,-27
13823,1,1,70,1280,1210
13824,0,0,36,0,-36
13825,0,0,5,0,-5
13826,0,0,24,0,-24
13827,0,0,19,0,-19
13828,1,0,40,0,-40
13829,1,0,20,0,-20
13830,1,1,642,1932,1290
13831,0,0,9,0,-9
13832,1,0,26,0,-26
13833,0,0,34,0,-34
13834,1,1,1511,1715,204
13835,0,0,76,0,-76
13836,0,0,12,0,-12
13837,1,0,7,0,-7
13838,0,0,9,0,-9
13839,1,0,90,0,-90
13840,0,0,52,0,-52
13841,0,0,27,0,-27
13842,1,0,38,0,-38
13843,0,0,11,0,-11
13844,1,0,24,0,-24
13845,0,0,75,0,-75
13846,1,0,15,0,-15
13847,0,0,127,0,-127
13848,1,0,5,0,-5
13849,1,0,22,0,-22
13850,1,0,56,0,-56
13851,1,1,503,1253,750
13852,1,1,301,1418,1117
13853,1,0,18,0,-18
13854,0,0,13,0,-13
13855,1,1,96,1654,1558
13856,1,0,33,0,-33
13857,0,0,92,0,-92
13858,1,1,701,1381,680
13859,0,0,53,0,-53
13860,1,0,1,0,-1
13861,1,1,707,1949,1242
13862,1,1,1049,1742,693
13863,1,1,359,1401,1042
13864,0,0,100,0,-100
13865,0,0,9,0,-9
13866,1,1,1453,1360,-93
13867,1,1,700,1597,897
13868,1,1,441,1414,973
13869,1,0,127,0,-127
13870,1,1,231,1325,1094
13871,0,0,125,0,-125
13872,1,0,116,0,-116
13873,0,0,11,0,-11
13874,1,0,0,0,0
13875,0,0,79,0,-79
13876,1,1,815,1254,439
13877,1,0,11,0,-11
13878,1,0,37,0,-37
13879,1,1,154,2737,2583
13880,1,1,15,1419,1404
13881,1,1,1473,1860,387
13882,0,0,18,0,-18
13883,1,1,610,2159,1549
13884,1,1,865,1275,410
13885,0,0,44,0,-44
13886,1,0,89,0,-89
13887,0,0,7,0,-7
13888,1,1,238,1922,1684
13889,1,1,125,1250,1125
13890,1,0,51,0,-51
13891,1,0,18,0,-18
13892,0,0,14,0,-14
13893,0,0,15,0,-15
13894,0,0,14,0,-14
13895,1,0,30,0,-30
13896,0,0,36,0,-36
13897,0,0,14,0,-14
13898,0,0,89,0,-89
13899,0,0,26,0,-26
13900,0,0,15,0,-15
13901,0,0,11,0,-11
13902,1,0,10,0,-10
13903,0,0,56,0,-56
13904,1,0,27,0,-27
13905,1,1,351,2038,1687
13906,1,1,173,2242,2069
13907,1,0,16,0,-16
13908,1,1,196,1430,1234
13909,1,0,22,0,-22
13910,0,0,42,0,-42
13911,0,0,12,0,-12
13912,1,0,9,0,-9
13913,1,1,681,1328,647
13914,1,1,637,1250,613
13915,0,0,95,0,-95
13916,0,0,27,0,-27
13917,1,0,4,0,-4
13918,1,0,49,0,-49
13919,1,0,19,0,-19
13920,0,0,26,0,-26
13921,0,0,102,0,-102
13922,0,0,45,0,-45
13923,1,0,8,0,-8
13924,1,1,102,1353,1251
13925,1,0,4,0,-4
13926,1,1,177,2685,2508
13927,0,0,12,0,-12
13928,1,1,561,1971,1410
13929,1,1,458,1242,784
13930,1,0,163,0,-163
13931,1,0,49,0,-49
13932,0,0,35,0,-35
13933,1,0,44,0,-44
13934,0,0,100,0,-100
13935,0,0,28,0,-28
13936,1,0,82,0,-82
13937,1,0,17,0,-17
13938,1,1,189,3934,3745
13939,1,1,337,1407,1070
13940,1,1,851,1607,756
13941,1,0,50,0,-50
13942,0,0,93,0,-93
13943,1,0,16,0,-16
13944,1,1,886,1780,894
13945,1,0,19,0,-19
13946,0,0,107,0,-107
13947,1,0,72,0,-72
13948,0,0,122,0,-122
13949,1,1,715,1476,761
13950,0,0,72,0,-72
13951,1,1,89,1747,1658
13952,1,0,35,0,-35
13953,1,1,182,1477,1295
13954,1,0,32,0,-32
13955,0,0,31,0,-31
13956,1,0,139,0,-139
13957,0,0,46,0,-46
13958,1,0,6,0,-6
13959,0,0,30,0,-30
13960,0,0,89,0,-89
13961,1,0,12,0,-12
13962,0,0,106,0,-106
13963,0,0,41,0,-41
13964,1,0,12,0,-12
13965,1,0,3,0,-3
13966,0,0,28,0,-28
13967,1,0,40,0,-40
13968,1,1,273,1669,1396
13969,1,1,517,1304,787
13970,1,0,37,0,-37
13971,0,0,39,0,-39
13972,0,0,34,0,-34
13973,1,1,569,1613,1044
13974,0,0,44,0,-44
13975,1,0,59,0,-59
13976,1,1,234,2025,1791
13977,1,1,152,1267,1115
13978,1,0,19,0,-19
13979,1,1,206,1605,1399
13980,1,0,25,0,-25
13981,1,0,65,0,-65
13982,1,1,175,1761,1586
13983,0,0,177,0,-177
13984,1,0,36,0,-36
13985,1,0,75,0,-75
13986,0,0,146,0,-146
13987,1,0,34,0,-34
13988,1,1,737,1482,745
13989,0,0,147,0,-147
13990,0,0,2,0,-2
13991,1,0,2,0,-2
13992,0,0,125,0,-125
13993,0,0,107,0,-107
13994,1,1,193,1249,1056
13995,1,0,84,0,-84
13996,1,1,325,1295,970
13997,0,0,21,0,-21
13998,1,0,17,0,-17
13999,1,0,41,0,-41
14000,1,1,1414,1243,-171
14001,0,0,47,0,-47
14002,1,1,571,1285,714
14003,0,0,31,0,-31
14004,0,0,4,0,-4
14005,0,0,95,0,-95
14006,1,0,162,0,-162
14007,0,0,12,0,-12
14008,1,0,49,0,-49
14009,1,1,284,1387,1103
14010,0,0,51,0,-51
14011,1,0,7,0,-7
14012,0,0,44,0,-44
14013,0,0,69,0,-69
14014,0,0,2,0,-2
14015,0,0,10,0,-10
14016,1,0,48,0,-48
14017,0,0,22,0,-22
14018,0,0,23,0,-23
14019,1,1,977,1667,690
14020,1,1,1004,1691,687
14021,1,1,110,1322,1212
14022,1,0,25,0,-25
14023,0,0,52,0,-52
14024,1,0,75,0,-75
14025,0,0,17,0,-17
14026,0,0,132,0,-132
14027,0,0,36,0,-36
14028,1,1,234,1415,1181
14029,1,0,202,0,-202
14030,1,0,18,0,-18
14031,1,1,93,1862,1769
14032,1,0,10,0,-10
14033,1,0,112,0,-112
14034,1,1,322,3261,2939
14035,1,1,308,1494,1186
14036,1,0,90,0,-90
14037,0,0,89,0,-89
14038,0,0,40,0,-40
14039,1,1,239,1342,1103
14040,0,0,106,0,-106
14041,0,0,17,0,-17
14042,1,1,359,2225,1866
14043,0,0,89,0,-89
14044,1,1,664,1677,1013
14045,0,0,2,0,-2
14046,0,0,183,0,-183
14047,1,0,14,0,-14
14048,0,0,45,0,-45
14049,0,0,62,0,-62
14050,1,1,587,1266,679
14051,1,0,3,0,-3
14052,0,0,34,0,-34
14053,1,0,5,0,-5
14054,1,0,16,0,-16
14055,1,1,540,1333,793
14056,1,0,174,0,-174
14057,1,0,80,0,-80
14058,1,0,131,0,-131
14059,1,1,202,2479,2277
14060,1,0,60,0,-60
14061,1,1,725,1775,1050
14062,0,0,22,0,-22
14063,1,0,24,0,-24
14064,0,0,117,0,-117
14065,1,1,205,1298,1093
14066,1,0,0,0,0
14067,0,0,36,0,-36
14068,0,0,8,0,-8
14069,1,1,819,1720,901
14070,0,0,46,0,-46
14071,1,1,210,1433,1223
14072,1,0,15,0,-15
14073,1,0,33,0,-33
14074,0,0,3,0,-3
14075,1,0,16,0,-16
14076,0,0,2,0,-2
14077,0,0,30,0,-30
14078,1,1,1002,3160,2158
14079,0,0,81,0,-81
14080,1,1,214,1489,1275
14081,1,0,95,0,-95
14082,1,1,509,2172,1663
14083,0,0,69,0,-69
14084,1,0,41,0,-41
14085,0,0,135,0,-135
14086,0,0,19,0,-19
14087,1,0,34,0,-34
14088,0,0,92,0,-92
14089,1,1,66,1631,1565
14090,0,0,21,0,-21
14091,1,0,9,0,-9
14092,1,1,76,1523,1447
14093,1,0,107,0,-107
14094,1,0,16,0,-16
14095,1,0,15,0,-15
14096,1,0,6,0,-6
14097,1,1,129,1467,1338
14098,1,1,673,1528,855
14099,0,0,34,0,-34
14100,0,0,71,0,-71
14101,1,0,6,0,-6
14102,1,0,58,0,-58
14103,0,0,91,0,-91
14104,1,1,316,1373,1057
14105,0,0,4,0,-4
14106,1,0,22,0,-22
14107,0,0,73,0,-73
14108,1,1,548,3378,2830
14109,1,1,3293,1270,-2023
14110,1,1,192,1261,1069
14111,1,1,242,1460,1218
14112,1,1,172,1980,1808
14113,1,0,106,0,-106
14114,1,1,183,1904,1721
14115,1,1,461,2014,1553
14116,1,0,49,0,-49
14117,0,0,255,0,-255
14118,0,0,66,0,-66
14119,1,0,25,0,-25
14120,0,0,48,0,-48
14121,0,0,21,0,-21
14122,0,0,81,0,-81
14123,0,0,235,0,-235
14124,1,1,1140,1324,184
14125,1,1,510,1291,781
14126,0,0,72,0,-72
14127,1,0,74,0,-74
14128,1,0,4,0,-4
14129,0,0,9,0,-9
14130,1,0,0,0,0
14131,1,0,76,0,-76
14132,1,0,45,0,-45
14133,1,0,64,0,-64
14134,1,1,819,1554,735
14135,1,0,8,0,-8
14136,1,0,138,0,-138
14137,0,0,26,0,-26
14138,1,0,61,0,-61
14139,0,0,109,0,-109
14140,1,0,15,0,-15
14141,0,0,53,0,-53
14142,1,0,5,0,-5
14143,0,0,79,0,-79
14144,1,1,102,1545,1443
14145,0,0,82,0,-82
14146,1,0,114,0,-114
14147,0,0,12,0,-12
14148,1,1,1023,1285,262
14149,1,1,261,1620,1359
14150,1,0,20,0,-20
14151,1,1,335,1336,1001
14152,0,0,4,0,-4
14153,1,1,568,1276,708
14154,0,0,21,0,-21
14155,1,1,682,1500,818
14156,1,1,378,1258,880
14157,0,0,85,0,-85
14158,1,1,858,1550,692
14159,1,1,1649,1242,-407
14160,1,1,581,1441,860
14161,0,0,78,0,-78
14162,0,0,3,0,-3
14163,0,0,4,0,-4
14164,1,0,19,0,-19
14165,0,0,32,0,-32
14166,0,0,2,0,-2
14167,0,0,28,0,-28
14168,0,0,32,0,-32
14169,1,1,282,1543,1261
14170,0,0,9,0,-9
14171,0,0,43,0,-43
14172,1,0,10,0,-10
14173,0,0,86,0,-86
14174,1,1,254,1536,1282
14175,1,1,336,2044,1708
14176,0,0,53,0,-53
14177,0,0,61,0,-61
14178,0,0,7,0,-7
14179,1,0,33,0,-33
14180,1,0,182,0,-182
14181,0,0,4,0,-4
14182,1,0,7,0,-7
14183,0,0,22,0,-22
14184,0,0,61,0,-61
14185,1,0,78,0,-78
14186,1,1,959,1402,443
14187,0,0,73,0,-73
14188,1,1,395,1269,874
14189,1,1,491,1245,754
14190,1,1,202,1363,1161
14191,1,0,23,0,-23
14192,1,0,22,0,-22
14193,0,0,2,0,-2
14194,0,0,57,0,-57
14195,1,0,12,0,-12
14196,0,0,123,0,-123
14197,1,0,30,0,-30
14198,1,1,1001,1390,389
14199,1,1,928,1355,427
14200,1,1,555,1819,1264
14201,1,1,257,1448,1191
14202,1,1,43,1305,1262
14203,1,0,18,0,-18
14204,0,0,8,0,-8
14205,1,0,37,0,-37
14206,1,1,671,4825,4154
14207,1,1,204,1238,1034
14208,1,1,1857,1624,-233
14209,1,0,24,0,-24
14210,1,0,18,0,-18
14211,1,0,184,0,-184
14212,0,0,47,0,-47
14213,0,0,25,0,-25
14214,0,0,6,0,-6
14215,0,0,18,0,-18
14216,0,0,42,0,-42
14217,0,0,9,0,-9
14218,1,0,50,0,-50
14219,0,0,151,0,-151
14220,0,0,5,0,-5
14221,1,0,107,0,-107
14222,0,0,71,0,-71
14223,1,0,94,0,-94
14224,0,0,69,0,-69
14225,0,0,52,0,-52
14226,1,1,239,1298,1059
14227,1,1,26,1296,1270
14228,0,0,26,0,-26
14229,1,1,398,1269,871
14230,1,0,10,0,-10
14231,1,1,370,1670,1300
14232,0,0,63,0,-63
14233,0,0,95,0,-95
14234,0,0,84,0,-84
14235,1,0,17,0,-17
14236,1,1,70,1307,1237
14237,1,1,298,1444,1146
14238,0,0,218,0,-218
14239,1,1,564,1260,696
14240,1,1,1495,1287,-208
14241,0,0,2,0,-2
14242,1,0,20,0,-20
14243,1,0,86,0,-86
14244,1,0,85,0,-85
14245,0,0,63,0,-63
14246,1,1,123,2342,2219
14247,1,1,99,2214,2115
14248,0,0,61,0,-61
14249,1,0,8,0,-8
14250,0,0,5,0,-5
14251,1,1,73,1259,1186
14252,1,1,691,1267,576
14253,1,1,332,1267,935
14254,0,0,43,0,-43
14255,0,0,5,0,-5
14256,1,1,884,1577,693
14257,0,0,1,0,-1
14258,0,0,31,0,-31
14259,1,1,1168,1777,609
14260,1,1,51,1860,1809
14261,1,0,41,0,-41
14262,1,1,317,1437,1120
14263,0,0,52,0,-52
14264,1,0,53,0,-53
14265,0,0,103,0,-103
14266,1,1,487,1380,893
14267,1,0,147,0,-147
14268,0,0,14,0,-14
14269,1,0,9,0,-9
14270,0,0,23,0,-23
14271,0,0,29,0,-29
14272,1,0,22,0,-22
14273,1,1,760,3230,2470
14274,0,0,78,0,-78
14275,1,0,1,0,-1
14276,0,0,31,0,-31
14277,1,1,195,1984,1789
14278,1,1,1397,1378,-19
14279,1,0,34,0,-34
14280,1,0,7,0,-7
14281,1,0,19,0,-19
14282,1,1,195,1308,1113
14283,1,0,41,0,-41
14284,0,0,6,0,-6
14285,1,1,527,1287,760
14286,1,0,69,0,-69
14287,0,0,21,0,-21
14288,0,0,5,0,-5
14289,0,0,147,0,-147
14290,1,0,223,0,-223
14291,0,0,111,0,-111
14292,1,1,1129,1662,533
14293,0,0,90,0,-90
14294,1,0,49,0,-49
14295,0,0,1,0,-1
14296,1,0,54,0,-54
14297,0,0,127,0,-127
14298,1,1,1360,2254,894
14299,0,0,4,0,-4
14300,1,0,54,0,-54
14301,0,0,18,0,-18
14302,0,0,46,0,-46
14303,0,0,22,0,-22
14304,0,0,84,0,-84
14305,0,0,54,0,-54
14306,1,1,1182,1299,117
14307,0,0,73,0,-73
14308,1,1,429,1550,1121
14309,0,0,48,0,-48
14310,1,0,111,0,-111
14311,0,0,13,0,-13
14312,1,1,1044,1371,327
14313,1,1,728,1327,599
14314,1,0,32,0,-32
14315,1,1,304,1737,1433
14316,1,0,19,0,-19
14317,1,0,8,0,-8
14318,1,0,52,0,-52
14319,1,1,165,1254,1089
14320,1,0,20,0,-20
14321,1,1,299,1512,1213
14322,1,1,168,1435,1267
14323,1,0,0,0,0
14324,0,0,166,0,-166
14325,1,0,96,0,-96
14326,1,1,165,2026,1861
14327,0,0,23,0,-23
14328,1,0,56,0,-56
14329,1,0,1,0,-1
14330,1,1,1117,1452,335
14331,1,0,70,0,-70
14332,1,0,143,0,-143
14333,0,0,126,0,-126
14334,0,0,0,0,0
14335,1,1,643,1293,650
14336,1,1,945,1380,435
14337,1,1,321,2139,1818
14338,1,1,546,1279,733
14339,0,0,178,0,-178
14340,1,1,23,1449,1426
14341,1,1,28,1362,1334
14342,0,0,81,0,-81
14343,0,0,6,0,-6
14344,0,0,63,0,-63
14345,1,0,21,0,-21
14346,1,1,246,2460,2214
14347,1,1,1735,1513,-222
14348,0,0,7,0,-7
14349,0,0,51,0,-51
14350,0,0,12,0,-12
14351,0,0,82,0,-82
14352,0,0,9,0,-9
14353,0,0,273,0,-273
14354,1,1,467,1880,1413
14355,0,0,203,0,-203
14356,0,0,35,0,-35
14357,1,1,672,1462,790
14358,1,0,24,0,-24
14359,0,0,3,0,-3
14360,1,0,115,0,-115
14361,1,0,7,0,-7
14362,0,0,13,0,-13
14363,1,0,28,0,-28
14364,1,1,302,1254,952
14365,1,1,972,1395,423
14366,1,0,63,0,-63
14367,0,0,10,0,-10
14368,0,0,47,0,-47
14369,1,1,146,1307,1161
14370,1,1,313,1380,1067
14371,1,1,467,1642,1175
14372,0,0,32,0,-32
14373,1,0,52,0,-52
14374,1,1,1133,1275,142
14375,0,0,58,0,-58
14376,0,0,11,0,-11
14377,1,1,94,1289,1195
14378,0,0,62,0,-62
14379,1,0,58,0,-58
14380,0,0,31,0,-31
14381,0,0,27,0,-27
14382,1,0,0,0,0
14383,1,0,113,0,-113
14384,0,0,105,0,-105
14385,1,1,366,1541,1175
14386,0,0,1,0,-1
14387,0,0,282,0,-282
14388,0,0,20,0,-20
14389,1,1,3437,1435,-2002
14390,1,0,165,0,-165
14391,0,0,8,0,-8
14392,0,0,80,0,-80
14393,0,0,85,0,-85
14394,0,0,18,0,-18
14395,0,0,25,0,-25
14396,0,0,28,0,-28
14397,1,0,44,0,-44
14398,1,1,225,1743,1518
14399,1,0,32,0,-32
14400,0,0,53,0,-53
14401,0,0,1,0,-1
14402,1,1,680,1508,828
14403,0,0,38,0,-38
14404,1,0,3,0,-3
14405,1,1,937,1248,311
14406,0,0,1,0,-1
14407,0,0,10,0,-10
14408,1,1,749,1266,517
14409,1,1,541,1246,705
14410,1,0,12,0,-12
14411,0,0,49,0,-49
14412,0,0,44,0,-44
14413,1,0,19,0,-19
14414,1,1,166,1262,1096
14415,1,0,5,0,-5
14416,0,0,25,0,-25
14417,1,1,124,1504,1380
14418,1,1,232,1666,1434
14419,1,1,189,1244,1055
14420,1,1,65,2730,2665
14421,0,0,15,0,-15
14422,1,0,7,0,-7
14423,1,1,136,2254,2118
14424,0,0,96,0,-96
14425,0,0,3,0,-3
14426,0,0,51,0,-51
14427,0,0,45,0,-45
14428,0,0,38,0,-38
14429,0,0,12,0,-12
14430,0,0,87,0,-87
14431,1,0,14,0,-14
14432,1,0,59,0,-59
14433,1,1,820,1352,532
14434,0,0,95,0,-95
14435,1,0,2,0,-2
14436,1,0,133,0,-133
14437,1,1,72,1439,1367
14438,0,0,56,0,-56
14439,0,0,108,0,-108
14440,1,0,13,0,-13
14441,1,1,841,1455,614
14442,1,1,192,1253,1061
14443,0,0,42,0,-42
14444,1,1,1237,1335,98
14445,0,0,26,0,-26
14446,0,0,57,0,-57
14447,1,1,292,1896,1604
14448,1,1,957,1260,303
14449,1,0,45,0,-45
14450,1,0,78,0,-78
14451,1,0,6,0,-6
14452,0,0,21,0,-21
14453,1,0,172,0,-172
14454,1,1,932,1727,795
14455,1,0,90,0,-90
14456,0,0,15,0,-15
14457,1,0,176,0,-176
14458,1,0,109,0,-109
14459,1,0,75,0,-75
14460,1,0,44,0,-44
14461,1,1,1627,1400,-227
14462,1,1,821,3618,2797
14463,0,0,79,0,-79
14464,1,1,117,1303,1186
14465,1,1,1406,1672,266
14466,0,0,62,0,-62
14467,1,0,3,0,-3
14468,0,0,4,0,-4
14469,1,1,2455,2355,-100
14470,1,0,17,0,-17
14471,0,0,10,0,-10
14472,1,0,6,0,-6
14473,1,0,82,0,-82
14474,1,1,688,1565,877
14475,1,1,366,1442,1076
14476,1,1,769,1326,557
14477,1,0,10,0,-10
14478,0,0,45,0,-45
14479,0,0,95,0,-95
14480,1,0,9,0,-9
14481,0,0,35,0,-35
14482,1,0,6,0,-6
14483,0,0,79,0,-79
14484,1,1,743,1250,507
14485,0,0,28,0,-28
14486,0,0,14,0,-14
14487,0,0,74,0,-74
14488,1,1,311,1289,978
14489,1,0,6,0,-6
14490,1,1,234,1583,1349
14491,1,1,198,1869,1671
14492,0,0,24,0,-24
14493,1,0,96,0,-96
14494,0,0,45,0,-45
14495,1,1,345,1544,1199
14496,0,0,29,0,-29
14497,1,1,64,1237,1173
14498,1,1,203,1693,1490
14499,1,1,765,1397,632
14500,1,0,12,0,-12
14501,1,1,49,1441,1392
14502,0,0,1,0,-1
14503,1,1,204,1254,1050
14504,1,1,436,1789,1353
14505,1,0,41,0,-41
14506,0,0,44,0,-44
14507,1,0,9,0,-9
14508,1,1,151,1468,1317
14509,0,0,0,0,0
14510,1,1,308,1448,1140
14511,1,0,16,0,-16
14512,1,0,29,0,-29
14513,1,0,17,0,-17
14514,1,0,167,0,-167
14515,0,0,155,0,-155
14516,0,0,17,0,-17
14517,1,1,63,1746,1683
14518,0,0,165,0,-165
14519,0,0,31,0,-31
14520,1,1,184,1748,1564
14521,1,1,68,1711,1643
14522,0,0,6,0,-6
14523,1,0,71,0,-71
14524,1,0,164,0,-164
14525,0,0,39,0,-39
14526,1,0,3,0,-3
14527,1,1,349,1578,1229
14528,0,0,4,0,-4
14529,1,0,3,0,-3
14530,1,0,39,0,-39
14531,1,1,616,1575,959
14532,1,1,807,1244,437
14533,1,1,305,1246,941
14534,1,0,31,0,-31
14535,0,0,9,0,-9
14536,0,0,5,0,-5
14537,0,0,16,0,-16
14538,1,1,854,1355,501
14539,1,0,29,0,-29
14540,0,0,4,0,-4
14541,1,1,92,1452,1360
14542,1,0,18,0,-18
14543,0,0,0,0,0
14544,0,0,59,0,-59
14545,1,1,2052,1845,-207
14546,1,0,50,0,-50
14547,0,0,26,0,-26
14548,0,0,18,0,-18
14549,1,0,42,0,-42
14550,0,0,254,0,-254
14551,0,0,21,0,-21
14552,1,1,94,1429,1335
14553,1,1,603,1894,1291
14554,1,0,69,0,-69
14555,1,0,1,0,-1
14556,1,0,13,0,-13
14557,0,0,111,0,-111
14558,1,1,930,1586,656
14559,0,0,19,0,-19
14560,0,0,38,0,-38
14561,1,0,11,0,-11
14562,0,0,61,0,-61
14563,1,0,5,0,-5
14564,1,1,687,1509,822
14565,1,1,336,2696,2360
14566,0,0,3,0,-3
14567,1,1,286,1617,1331
14568,0,0,115,0,-115
14569,0,0,89,0,-89
14570,0,0,51,0,-51
14571,1,0,51,0,-51
14572,1,1,677,1574,897
14573,1,0,35,0,-35
14574,0,0,1,0,-1
14575,1,1,949,1891,942
14576,0,0,15,0,-15
14577,1,1,212,1419,1207
14578,1,1,139,1439,1300
14579,1,0,41,0,-41
14580,1,0,27,0,-27
14581,0,0,58,0,-58
14582,1,0,28,0,-28
14583,0,0,9,0,-9
14584,1,0,27,0,-27
14585,1,0,186,0,-186
14586,0,0,54,0,-54
14587,0,0,93,0,-93
14588,1,0,306,0,-306
14589,0,0,28,0,-28
14590,1,1,294,1687,1393
14591,1,0,65,0,-65
14592,1,1,491,1740,1249
14593,1,1,761,1405,644
14594,0,0,28,0,-28
14595,1,1,94,1373,1279
14596,0,0,24,0,-24
14597,1,0,79,0,-79
14598,1,0,24,0,-24
14599,1,0,8,0,-8
14600,1,0,25,0,-25
14601,1,1,79,1692,1613
14602,1,1,717,1677,960
14603,1,1,308,1427,1119
14604,1,1,98,1240,1142
14605,0,0,70,0,-70
14606,1,0,8,0,-8
14607,1,0,81,0,-81
14608,1,0,266,0,-266
14609,1,1,548,2677,2129
14610,1,1,405,1649,1244
14611,1,0,0,0,0
14612,1,1,1833,1448,-385
14613,1,0,18,0,-18
14614,0,0,33,0,-33
14615,0,0,49,0,-49
14616,1,1,324,1341,1017
14617,1,1,40,1568,1528
14618,1,0,24,0,-24
14619,0,0,6,0,-6
14620,1,1,1089,1924,835
14621,1,0,54,0,-54
14622,1,0,14,0,-14
14623,1,1,155,2150,1995
14624,0,0,38,0,-38
14625,0,0,30,0,-30
14626,0,0,69,0,-69
14627,1,0,42,0,-42
14628,1,0,14,0,-14
14629,0,0,17,0,-17
14630,1,0,61,0,-61
14631,0,0,59,0,-59
14632,1,0,26,0,-26
14633,1,1,181,1675,1494
14634,1,1,727,1870,1143
14635,1,1,90,1551,1461
14636,0,0,7,0,-7
14637,1,0,48,0,-48
14638,1,1,343,1597,1254
14639,1,1,598,1305,707
14640,0,0,22,0,-22
14641,1,1,300,1257,957
14642,1,0,68,0,-68
14643,1,0,140,0,-140
14644,1,1,209,1356,1147
14645,1,0,50,0,-50
14646,1,1,773,2325,1552
14647,0,0,17,0,-17
14648,1,1,553,1705,1152
14649,1,1,795,1725,930
14650,1,1,290,1292,1002
14651,0,0,105,0,-105
14652,1,0,28,0,-28
14653,1,0,44,0,-44
14654,0,0,51,0,-51
14655,0,0,16,0,-16
14656,1,0,27,0,-27
14657,0,0,64,0,-64
14658,1,0,34,0,-34
14659,0,0,78,0,-78
14660,1,1,399,1321,922
14661,0,0,62,0,-62
14662,0,0,30,0,-30
14663,1,0,104,0,-104
14664,1,1,168,1958,1790
14665,1,0,51,0,-51
14666,0,0,8,0,-8
14667,1,1,161,1528,1367
14668,0,0,10,0,-10
14669,1,0,18,0,-18
14670,1,1,657,1241,584
14671,0,0,80,0,-80
14672,1,1,537,1337,800
14673,0,0,16,0,-16
14674,0,0,128,0,-128
14675,1,1,1383,1883,500
14676,1,0,26,0,-26
14677,0,0,15,0,-15
14678,1,1,139,1791,1652
14679,0,0,112,0,-112
14680,0,0,95,0,-95
14681,1,0,32,0,-32
14682,1,1,236,1764,1528
14683,0,0,11,0,-11
14684,0,0,270,0,-270
14685,1,0,9,0,-9
14686,0,0,68,0,-68
14687,1,1,287,1268,981
14688,1,1,526,1592,1066
14689,1,1,88,1973,1885
14690,1,1,1343,1333,-10
14691,1,1,202,1372,1170
14692,1,1,694,1246,552
14693,1,1,87,1598,1511
14694,0,0,13,0,-13
14695,1,1,774,1454,680
14696,1,0,57,0,-57
14697,1,0,7,0,-7
14698,1,1,189,2042,1853
14699,0,0,8,0,-8
14700,1,0,195,0,-195
14701,1,1,57,1655,1598
14702,1,1,116,1962,1846
14703,0,0,21,0,-21
14704,1,0,25,0,-25
14705,1,1,278,1239,961
14706,1,1,2032,1245,-787
14707,1,1,329,1260,931
14708,1,1,45,1462,1417
14709,0,0,37,0,-37
14710,0,0,13,0,-13
14711,1,0,39,0,-39
14712,0,0,109,0,-109
14713,1,0,0,0,0
14714,1,1,292,1684,1392
14715,0,0,38,0,-38
14716,1,1,609,1349,740
14717,0,0,13,0,-13
14718,1,1,60,1543,1483
14719,1,0,235,0,-235
14720,0,0,37,0,-37
14721,0,0,11,0,-11
14722,0,0,98,0,-98
14723,1,0,44,0,-44
14724,1,0,78,0,-78
14725,1,0,20,0,-20
14726,1,0,61,0,-61
14727,1,0,49,0,-49
14728,1,1,294,1542,1248
14729,1,1,488,1692,1204
14730,0,0,33,0,-33
14731,0,0,18,0,-18
14732,1,1,625,1620,995
14733,1,1,128,1796,1668
14734,1,1,420,1347,927
14735,1,0,46,0,-46
14736,1,0,36,0,-36
14737,0,0,22,0,-22
14738,1,1,142,1334,1192
14739,0,0,37,0,-37
14740,1,1,564,1244,680
14741,0,0,1,0,-1
14742,1,1,146,1591,1445
14743,0,0,61,0,-61
14744,1,1,123,1937,1814
14745,0,0,65,0,-65
14746,1,1,325,1869,1544
14747,1,0,14,0,-14
14748,0,0,68,0,-68
14749,1,0,7,0,-7
14750,0,0,23,0,-23
14751,1,1,1353,1715,362
14752,0,0,5,0,-5
14753,1,0,95,0,-95
14754,1,1,363,1506,1143
14755,0,0,46,0,-46
14756,1,1,457,1660,1203
14757,0,0,41,0,-41
14758,0,0,13,0,-13
14759,0,0,175,0,-175
14760,0,0,15,0,-15
14761,1,0,32,0,-32
14762,0,0,36,0,-36
14763,1,0,7,0,-7
14764,1,0,21,0,-21
14765,1,0,17,0,-17
14766,1,1,238,1967,1729
14767,0,0,25,0,-25
14768,0,0,33,0,-33
14769,0,0,61,0,-61
14770,0,0,9,0,-9
14771,1,1,636,1815,1179
14772,0,0,4,0,-4
14773,1,0,61,0,-61
14774,0,0,39,0,-39
14775,0,0,22,0,-22
14776,1,0,53,0,-53
14777,1,1,266,2635,2369
14778,1,1,17,2206,2189
14779,0,0,8,0,-8
14780,1,0,7,0,-7
14781,1,0,66,0,-66
14782,0,0,65,0,-65
14783,1,0,30,0,-30
14784,0,0,1,0,-1
14785,0,0,53,0,-53
14786,1,0,8,0,-8
14787,0,0,76,0,-76
14788,1,1,108,1404,1296
14789,1,1,28,1883,1855
14790,1,1,575,1417,842
14791,1,1,675,1414,739
14792,0,0,11,0,-11
14793,1,1,575,1544,969
14794,0,0,19,0,-19
14795,1,0,85,0,-85
14796,1,1,3204,1295,-1909
14797,0,0,53,0,-53
14798,0,0,131,0,-131
14799,1,0,26,0,-26
14800,0,0,0,0,0
14801,1,1,118,1332,1214
14802,0,0,11,0,-11
14803,0,0,77,0,-77
14804,1,1,193,2030,1837
14805,0,0,64,0,-64
14806,1,1,217,1303,1086
14807,0,0,19,0,-19
14808,0,0,1,0,-1
14809,1,0,57,0,-57
14810,0,0,39,0,-39
14811,0,0,5,0,-5
14812,0,0,28,0,-28
14813,1,0,83,0,-83
14814,1,0,100,0,-100
14815,1,1,352,1567,1215
14816,1,0,79,0,-79
14817,0,0,13,0,-13
14818,0,0,3,0,-3
14819,1,1,907,1585,678
14820,1,1,1153,1336,183
14821,1,1,82,1461,1379
14822,0,0,80,0,-80
14823,0,0,19,0,-19
14824,1,0,25,0,-25
14825,0,0,102,0,-102
14826,0,0,34,0,-34
14827,1,1,636,2039,1403
14828,0,0,187,0,-187
14829,1,0,17,0,-17
14830,1,1,511,1265,754
14831,1,0,68,0,-68
14832,1,0,5,0,-5
14833,1,0,17,0,-17
14834,0,0,1,0,-1
14835,1,0,0,0,0
14836,1,0,92,0,-92
14837,1,0,109,0,-109
14838,0,0,5,0,-5
14839,0,0,199,0,-199
14840,0,0,229,0,-229
14841,1,1,255,1283,1028
14842,0,0,5,0,-5
14843,1,1,351,1319,968
14844,1,1,108,1311,1203
14845,1,0,14,0,-14
14846,0,0,67,0,-67
14847,1,1,181,1597,1416
14848,0,0,4,0,-4
14849,1,1,1727,1639,-88
14850,1,1,624,1591,967
14851,1,0,64,0,-64
14852,0,0,7,0,-7
14853,1,1,184,1605,1421
14854,1,0,206,0,-206
14855,1,1,694,1429,735
14856,0,0,73,0,-73
14857,1,1,198,1278,1080
14858,1,1,202,1378,1176
14859,1,1,2322,3318,996
14860,1,0,6,0,-6
14861,0,0,10,0,-10
14862,1,1,109,2651,2542
14863,0,0,35,0,-35
14864,0,0,8,0,-8
14865,1,0,43,0,-43
14866,0,0,101,0,-101
14867,1,1,295,1272,977
14868,1,1,154,1744,1590
14869,1,0,53,0,-53
14870,0,0,19,0,-19
14871,1,0,40,0,-40
14872,1,1,1408,2149,741
14873,1,1,274,1958,1684
14874,1,0,106,0,-106
14875,1,0,10,0,-10
14876,0,0,194,0,-194
14877,0,0,13,0,-13
14878,0,0,33,0,-33
14879,1,0,75,0,-75
14880,1,1,768,2430,1662
14881,0,0,119,0,-119
14882,1,1,27,1426,1399
14883,1,0,110,0,-110
14884,0,0,77,0,-77
14885,0,0,14,0,-14
14886,1,0,34,0,-34
14887,0,0,21,0,-21
14888,1,0,36,0,-36
14889,0,0,51,0,-51
14890,0,0,12,0,-12
14891,1,1,765,1329,564
14892,1,1,831,1845,1014
14893,0,0,16,0,-16
14894,1,0,23,0,-23
14895,0,0,0,0,0
14896,1,0,65,0,-65
14897,0,0,24,0,-24
14898,1,0,26,0,-26
14899,0,0,24,0,-24
14900,1,1,437,1696,1259
14901,1,0,9,0,-9
14902,0,0,21,0,-21
14903,0,0,140,0,-140
14904,1,1,599,1355,756
14905,1,1,398,1360,962
14906,1,0,101,0,-101
14907,1,0,63,0,-63
14908,0,0,42,0,-42
14909,1,1,342,1391,1049
14910,0,0,89,0,-89
14911,0,0,16,0,-16
14912,1,1,934,1675,741
14913,0,0,121,0,-121
14914,1,1,336,1709,1373
14915,1,1,77,1973,1896
14916,1,0,41,0,-41
14917,0,0,82,0,-82
14918,0,0,124,0,-124
14919,0,0,26,0,-26
14920,0,0,130,0,-130
14921,1,1,788,2262,1474
14922,0,0,13,0,-13
14923,0,0,0,0,0
14924,0,0,23,0,-23
14925,1,1,328,1384,1056
14926,1,0,34,0,-34
14927,1,0,24,0,-24
14928,0,0,13,0,-13
14929,1,1,143,1258,1115
14930,1,1,555,1240,685
14931,1,0,55,0,-55
14932,0,0,0,0,0
14933,0,0,147,0,-147
14934,1,0,51,0,-51
14935,0,0,80,0,-80
14936,0,0,100,0,-100
14937,1,0,2,0,-2
14938,0,0,40,0,-40
14939,1,1,282,1340,1058
14940,1,1,122,2826,2704
14941,1,0,173,0,-173
14942,1,1,187,1367,1180
14943,0,0,42,0,-42
14944,1,1,256,1741,1485
14945,0,0,38,0,-38
14946,1,1,869,1324,455
14947,0,0,10,0,-10
14948,0,0,150,0,-150
14949,1,1,416,1380,964
14950,1,0,83,0,-83
14951,1,1,285,1354,1069
14952,0,0,91,0,-91
14953,1,0,16,0,-16
14954,1,0,75,0,-75
14955,0,0,86,0,-86
14956,0,0,29,0,-29
14957,0,0,78,0,-78
14958,0,0,120,0,-120
14959,0,0,13,0,-13
14960,1,0,30,0,-30
14961,1,1,89,1490,1401
14962,1,0,106,0,-106
14963,1,1,1366,1459,93
14964,1,1,16,1394,1378
14965,1,0,5,0,-5
14966,1,0,70,0,-70
14967,1,0,36,0,-36
14968,1,1,1030,1886,856
14969,1,1,252,1431,1179
14970,1,0,0,0,0
14971,0,0,29,0,-29
14972,0,0,5,0,-5
14973,0,0,5,0,-5
14974,1,0,21,0,-21
14975,0,0,118,0,-118
14976,1,0,46,0,-46
14977,1,0,1,0,-1
14978,0,0,198,0,-198
14979,0,0,17,0,-17
14980,1,0,121,0,-121
14981,1,0,97,0,-97
14982,0,0,14,0,-14
14983,0,0,92,0,-92
14984,0,0,169,0,-169
14985,1,1,477,1470,993
14986,1,0,70,0,-70
14987,0,0,116,0,-116
14988,0,0,36,0,-36
14989,0,0,121,0,-121
14990,0,0,30,0,-30
14991,1,1,698,1244,546
14992,1,1,543,1344,801
14993,0,0,104,0,-104
14994,0,0,237,0,-237
14995,1,0,243,0,-243
14996,1,1,831,1467,636
14997,0,0,49,0,-49
14998,1,1,221,1257,1036
14999,1,0,3,0,-3
15000,1,1,51,1351,1300
15001,1,0,47,0,-47
15002,1,1,2127,1472,-655
15003,0,0,71,0,-71
15004,1,0,69,0,-69
15005,0,0,92,0,-92
15006,0,0,64,0,-64
15007,1,1,446,2752,2306
15008,0,0,109,0,-109
15009,1,1,375,1262,887
15010,1,1,971,1578,607
15011,1,0,33,0,-33
15012,1,0,5,0,-5
15013,0,0,136,0,-136
15014,0,0,30,0,-30
15015,1,1,57,1609,1552
15016,0,0,177,0,-177
15017,1,1,486,1260,774
15018,0,0,6,0,-6
15019,1,1,624,1490,866
15020,1,1,403,4161,3758
15021,0,0,149,0,-149
15022,0,0,96,0,-96
15023,1,0,24,0,-24
15024,1,1,1488,1713,225
15025,1,1,126,1726,1600
15026,0,0,4,0,-4
15027,0,0,2,0,-2
15028,1,0,21,0,-21
15029,1,1,957,2979,2022
15030,0,0,155,0,-155
15031,1,0,115,0,-115
15032,0,0,31,0,-31
15033,1,0,23,0,-23
15034,1,0,122,0,-122
15035,1,1,1147,1766,619
15036,1,1,958,1275,317
15037,1,1,888,1440,552
15038,1,1,53,1554,1501
15039,1,0,82,0,-82
15040,0,0,47,0,-47
15041,1,0,81,0,-81
15042,1,0,5,0,-5
15043,1,0,0,0,0
15044,1,1,799,1399,600
15045,1,0,25,0,-25
15046,0,0,18,0,-18
15047,1,0,51,0,-51
15048,1,1,304,2518,2214
15049,1,0,26,0,-26
15050,0,0,71,0,-71
15051,0,0,53,0,-53
15052,1,1,331,1879,1548
15053,0,0,5,0,-5
15054,1,1,233,1717,1484
15055,0,0,94,0,-94
15056,1,1,1073,5037,3964
15057,1,1,160,1423,1263
15058,0,0,26,0,-26
15059,1,0,5,0,-5
15060,1,1,361,1279,918
15061,0,0,2,0,-2
15062,0,0,12,0,-12
15063,0,0,7,0,-7
15064,1,0,67,0,-67
15065,0,0,15,0,-15
15066,1,1,118,1241,1123
15067,1,1,725,1359,634
15068,0,0,59,0,-59
15069,0,0,76,0,-76
15070,1,0,59,0,-59
15071,1,1,383,1254,871
15072,1,1,1466,1251,-215
15073,0,0,34,0,-34
15074,0,0,139,0,-139
15075,0,0,72,0,-72
15076,0,0,8,0,-8
15077,0,0,107,0,-107
15078,1,0,29,0,-29
15079,0,0,11,0,-11
15080,0,0,113,0,-113
15081,0,0,56,0,-56
15082,1,0,83,0,-83
15083,1,0,17,0,-17
15084,0,0,30,0,-30
15085,1,1,1080,1811,731
15086,1,0,412,0,-412
15087,1,0,19,0,-19
15088,0,0,57,0,-57
15089,0,0,12,0,-12
15090,1,1,219,1392,1173
15091,0,0,82,0,-82
15092,1,0,47,0,-47
15093,0,0,151,0,-151
15094,0,0,4,0,-4
15095,1,1,172,1418,1246
15096,1,1,208,1802,1594
15097,0,0,208,0,-208
15098,1,1,1769,1646,-123
15099,0,0,10,0,-10
15100,1,1,530,1929,1399
15101,1,0,52,0,-52
15102,1,1,120,1630,1510
15103,1,0,22,0,-22
15104,1,1,1313,1381,68
15105,0,0,5,0,-5
15106,1,1,26,3412,3386
15107,0,0,28,0,-28
15108,1,0,34,0,-34
15109,1,0,22,0,-22
15110,0,0,29,0,-29
15111,1,0,14,0,-14
15112,0,0,37,0,-37
15113,1,0,19,0,-19
15114,1,0,54,0,-54
15115,0,0,39,0,-39
15116,1,0,2,0,-2
15117,1,1,262,1309,1047
15118,0,0,112,0,-112
15119,0,0,32,0,-32
15120,0,0,17,0,-17
15121,1,0,10,0,-10
15122,0,0,100,0,-100
15123,0,0,69,0,-69
15124,0,0,106,0,-106
15125,1,0,60,0,-60
15126,0,0,67,0,-67
15127,1,0,143,0,-143
15128,1,0,21,0,-21
15129,0,0,68,0,-68
15130,1,1,444,1572,1128
15131,1,0,78,0,-78
15132,1,0,15,0,-15
15133,0,0,182,0,-182
15134,0,0,130,0,-130
15135,0,0,13,0,-13
15136,1,1,609,1295,686
15137,1,0,8,0,-8
15138,0,0,1,0,-1
15139,1,1,468,1458,990
15140,0,0,188,0,-188
15141,1,0,81,0,-81
15142,1,0,59,0,-59
15143,0,0,8,0,-8
15144,1,1,944,2589,1645
15145,1,0,23,0,-23
15146,1,1,52,1347,1295
15147,1,0,105,0,-105
15148,1,1,252,1736,1484
15149,1,1,138,1259,1121
15150,0,0,249,0,-249
15151,1,1,403,1241,838
15152,1,0,36,0,-36
15153,0,0,4,0,-4
15154,0,0,37,0,-37
15155,1,1,413,1622,1209
15156,1,0,135,0,-135
15157,1,1,293,2292,1999
15158,1,1,442,1441,999
15159,0,0,92,0,-92
15160,1,1,402,1315,913
15161,1,0,14,0,-14
15162,0,0,25,0,-25
15163,0,0,39,0,-39
15164,1,0,31,0,-31
15165,1,0,11,0,-11
15166,1,0,68,0,-68
15167,0,0,32,0,-32
15168,1,0,137,0,-137
15169,0,0,20,0,-20
15170,0,0,49,0,-49
15171,1,0,15,0,-15
15172,1,0,11,0,-11
15173,0,0,81,0,-81
15174,1,0,19,0,-19
15175,1,1,388,1296,908
15176,0,0,32,0,-32
15177,0,0,69,0,-69
15178,1,0,87,0,-87
15179,1,0,18,0,-18
15180,1,1,544,1419,875
15181,1,1,466,1366,900
15182,1,1,159,1511,1352
15183,0,0,103,0,-103
15184,1,1,555,1388,833
15185,0,0,31,0,-31
15186,1,0,92,0,-92
15187,1,1,124,1483,1359
15188,1,1,358,1990,1632
15189,1,1,471,1498,1027
15190,1,1,495,2987,2492
15191,1,1,67,3222,3155
15192,0,0,24,0,-24
15193,0,0,14,0,-14
15194,1,1,167,3009,2842
15195,0,0,52,0,-52
15196,0,0,33,0,-33
15197,0,0,29,0,-29
15198,1,0,59,0,-59
15199,0,0,48,0,-48
15200,1,0,0,0,0
15201,0,0,96,0,-96
15202,1,1,1229,1622,393
15203,1,0,34,0,-34
15204,0,0,28,0,-28
15205,1,0,19,0,-19
15206,1,0,7,0,-7
15207,1,0,22,0,-22
15208,1,1,242,1574,1332
15209,1,0,13,0,-13
15210,0,0,24,0,-24
15211,1,0,46,0,-46
15212,1,0,28,0,-28
15213,0,0,85,0,-85
15214,1,1,236,1340,1104
15215,1,0,44,0,-44
15216,0,0,4,0,-4
15217,1,1,84,1470,1386
15218,0,0,8,0,-8
15219,1,0,36,0,-36
15220,1,0,5,0,-5
15221,0,0,12,0,-12
15222,0,0,26,0,-26
15223,1,0,57,0,-57
15224,1,1,966,1261,295
15225,0,0,32,0,-32
15226,1,1,71,1936,1865
15227,1,1,1100,1997,897
15228,0,0,1,0,-1
15229,1,1,347,1243,896
15230,0,0,13,0,-13
15231,1,1,235,2587,2352
15232,0,0,61,0,-61
15233,0,0,24,0,-24
15234,0,0,23,0,-23
15235,1,0,111,0,-111
15236,0,0,27,0,-27
15237,0,0,24,0,-24
15238,0,0,57,0,-57
15239,1,0,18,0,-18
15240,0,0,1,0,-1
15241,1,0,24,0,-24
15242,1,0,57,0,-57
15243,0,0,213,0,-213
15244,0,0,127,0,-127
15245,1,1,1150,3464,2314
15246,1,0,254,0,-254
15247,1,0,2,0,-2
15248,1,0,126,0,-126
15249,1,0,2,0,-2
15250,0,0,46,0,-46
15251,1,1,272,1820,1548
15252,1,0,75,0,-75
15253,0,0,3,0,-3
15254,1,0,140,0,-140
15255,1,1,1099,1596,497
15256,1,0,47,0,-47
15257,1,1,749,1442,693
15258,0,0,53,0,-53
15259,1,0,27,0,-27
15260,0,0,3,0,-3
15261,0,0,14,0,-14
15262,0,0,45,0,-45
15263,1,0,39,0,-39
15264,0,0,25,0,-25
15265,1,0,8,0,-8
15266,1,0,9,0,-9
15267,1,0,1,0,-1
15268,0,0,71,0,-71
15269,1,1,2116,1321,-795
15270,1,1,429,1248,819
15271,0,0,17,0,-17
15272,1,0,16,0,-16
15273,1,0,40,0,-40
15274,1,1,174,2792,2618
15275,1,1,249,1259,1010
15276,0,0,33,0,-33
15277,0,0,73,0,-73
15278,0,0,1,0,-1
15279,0,0,3,0,-3
15280,1,1,303,1276,973
15281,1,0,8,0,-8
15282,1,0,25,0,-25
15283,1,0,20,0,-20
15284,0,0,14,0,-14
15285,1,1,125,1761,1636
15286,0,0,97,0,-97
15287,1,1,1424,1343,-81
15288,1,1,416,1575,1159
15289,1,0,15,0,-15
15290,1,1,309,1336,1027
15291,1,1,130,1266,1136
15292,0,0,130,0,-130
15293,1,1,215,1439,1224
15294,1,0,27,0,-27
15295,0,0,27,0,-27
15296,1,0,39,0,-39
15297,0,0,22,0,-22
15298,1,0,18,0,-18
15299,0,0,0,0,0
15300,0,0,70,0,-70
15301,0,0,18,0,-18
15302,1,1,738,1606,868
15303,1,1,988,1500,512
15304,0,0,0,0,0
15305,1,0,17,0,-17
15306,1,1,561,1603,1042
15307,1,0,53,0,-53
15308,0,0,35,0,-35
15309,1,1,1370,1386,16
15310,1,0,1,0,-1
15311,1,1,248,1653,1405
15312,1,1,259,1378,1119
15313,0,0,21,0,-21
15314,1,0,176,0,-176
15315,0,0,41,0,-41
15316,0,0,67,0,-67
15317,1,0,61,0,-61
15318,1,1,1260,1273,13
15319,0,0,43,0,-43
15320,1,0,18,0,-18
15321,1,1,247,1237,990
15322,1,0,2,0,-2
15323,0,0,50,0,-50
15324,0,0,8,0,-8
15325,1,1,1099,2068,969
15326,0,0,9,0,-9
15327,1,0,54,0,-54
15328,1,0,12,0,-12
15329,1,1,349,1810,1461
15330,1,0,11,0,-11
15331,1,0,15,0,-15
15332,0,0,46,0,-46
15333,1,0,122,0,-122
15334,1,0,20,0,-20
15335,0,0,203,0,-203
15336,1,0,11,0,-11
15337,0,0,29,0,-29
15338,1,0,132,0,-132
15339,1,0,170,0,-170
15340,1,1,421,1282,861
15341,0,0,13,0,-13
15342,1,0,56,0,-56
15343,1,0,121,0,-121
15344,0,0,13,0,-13
15345,0,0,1,0,-1
15346,0,0,73,0,-73
15347,0,0,53,0,-53
15348,1,1,1104,1624,520
15349,1,0,7,0,-7
15350,0,0,18,0,-18
15351,1,1,424,1380,956
15352,1,0,1,0,-1
15353,1,1,830,1790,960
15354,0,0,32,0,-32
15355,1,1,119,2744,2625
15356,1,0,60,0,-60
15357,1,1,392,1409,1017
15358,0,0,19,0,-19
15359,0,0,18,0,-18
15360,0,0,138,0,-138
15361,1,0,47,0,-47
15362,1,1,1266,2238,972
15363,1,0,25,0,-25
15364,1,1,755,1304,549
15365,1,0,8,0,-8
15366,0,0,45,0,-45
15367,1,1,1013,1276,263
15368,0,0,155,0,-155
15369,0,0,96,0,-96
15370,0,0,202,0,-202
15371,0,0,83,0,-83
15372,1,1,102,1712,1610
15373,0,0,15,0,-15
15374,1,1,200,1258,1058
15375,1,0,14,0,-14
15376,0,0,6,0,-6
15377,1,1,72,1341,1269
15378,1,1,346,2251,1905
15379,1,1,82,1587,1505
15380,0,0,31,0,-31
15381,1,0,33,0,-33
15382,0,0,13,0,-13
15383,1,0,27,0,-27
15384,1,0,13,0,-13
15385,0,0,77,0,-77
15386,1,1,884,1360,476
15387,1,0,130,0,-130
15388,1,0,67,0,-67
15389,1,0,57,0,-57
15390,0,0,6,0,-6
15391,1,1,86,1603,1517
15392,1,0,95,0,-95
15393,0,0,137,0,-137
15394,0,0,49,0,-49
15395,1,0,12,0,-12
15396,1,1,375,1340,965
15397,1,1,359,1311,952
15398,0,0,25,0,-25
15399,1,1,198,1413,1215
15400,0,0,21,0,-21
15401,0,0,1,0,-1
15402,0,0,88,0,-88
15403,1,1,690,1460,770
15404,0,0,0,0,0
15405,1,0,2,0,-2
15406,1,1,897,1382,485
15407,1,0,47,0,-47
15408,0,0,56,0,-56
15409,0,0,128,0,-128
15410,1,1,469,1246,777
15411,1,1,407,1404,997
15412,1,1,213,1708,1495
15413,0,0,28,0,-28
15414,0,0,58,0,-58
15415,0,0,27,0,-27
15416,1,0,87,0,-87
15417,1,0,55,0,-55
15418,0,0,10,0,-10
15419,1,1,2186,1236,-950
15420,1,1,260,1377,1117
15421,1,1,1051,1273,222
15422,0,0,2,0,-2
15423,1,1,1748,1423,-325
15424,1,0,97,0,-97
15425,1,0,2,0,-2
15426,1,0,67,0,-67
15427,0,0,150,0,-150
15428,1,0,1,0,-1
15429,1,1,222,1380,1158
15430,0,0,11,0,-11
15431,1,1,773,1419,646
15432,1,1,452,1244,792
15433,0,0,51,0,-51
15434,0,0,66,0,-66
15435,1,1,808,1251,443
15436,0,0,23,0,-23
15437,1,1,208,1641,1433
15438,1,0,161,0,-161
15439,1,0,15,0,-15
15440,1,0,107,0,-107
15441,0,0,3,0,-3
15442,0,0,39,0,-39
15443,0,0,181,0,-181
15444,0,0,8,0,-8
15445,1,1,506,5832,5326
15446,1,0,48,0,-48
15447,1,1,1330,1304,-26
15448,1,1,1402,1427,25
15449,0,0,107,0,-107
15450,0,0,163,0,-163
15451,1,0,120,0,-120
15452,1,0,71,0,-71
15453,0,0,23,0,-23
15454,0,0,31,0,-31
15455,0,0,36,0,-36
15456,1,1,456,1415,959
15457,0,0,71,0,-71
15458,0,0,15,0,-15
15459,1,0,8,0,-8
15460,0,0,162,0,-162
15461,0,0,43,0,-43
15462,0,0,9,0,-9
15463,0,0,38,0,-38
15464,1,0,5,0,-5
15465,1,0,9,0,-9
15466,1,1,190,1543,1353
15467,0,0,93,0,-93
15468,1,0,121,0,-121
15469,0,0,39,0,-39
15470,1,0,7,0,-7
15471,0,0,88,0,-88
15472,1,0,123,0,-123
15473,0,0,10,0,-10
15474,1,0,46,0,-46
15475,1,1,333,1319,986
15476,1,0,29,0,-29
15477,1,1,893,1265,372
15478,1,0,0,0,0
15479,0,0,122,0,-122
15480,1,0,5,0,-5
15481,1,0,8,0,-8
15482,0,0,62,0,-62
15483,0,0,64,0,-64
15484,0,0,10,0,-10
15485,0,0,43,0,-43
15486,1,1,477,1257,780
15487,1,1,875,2565,1690
15488,1,1,168,1480,1312
15489,1,1,213,1237,1024
15490,1,0,5,0,-5
15491,1,1,588,2021,1433
15492,0,0,12,0,-12
15493,1,1,1156,1357,201
15494,1,0,48,0,-48
15495,1,1,682,1450,768
15496,1,0,6,0,-6
15497,0,0,65,0,-65
15498,0,0,14,0,-14
15499,0,0,0,0,0
15500,0,0,34,0,-34
15501,0,0,5,0,-5
15502,1,0,38,0,-38
15503,1,0,46,0,-46
15504,1,0,24,0,-24
15505,1,0,3,0,-3
15506,0,0,53,0,-53
15507,1,1,541,1378,837
15508,0,0,36,0,-36
15509,1,1,293,1406,1113
15510,1,0,119,0,-119
15511,1,0,7,0,-7
15512,0,0,21,0,-21
15513,0,0,46,0,-46
15514,1,1,335,1394,1059
15515,1,0,22,0,-22
15516,0,0,2,0,-2
15517,1,1,23,1277,1254
15518,1,0,54,0,-54
15519,0,0,233,0,-233
15520,0,0,6,0,-6
15521,0,0,20,0,-20
15522,0,0,152,0,-152
15523,1,0,9,0,-9
15524,1,1,135,1242,1107
15525,1,0,119,0,-119
15526,1,1,501,2531,2030
15527,1,1,257,1494,1237
15528,1,0,87,0,-87
15529,1,1,1055,1362,307
15530,0,0,29,0,-29
15531,1,0,20,0,-20
15532,0,0,44,0,-44
15533,1,1,391,1371,980
15534,1,1,1356,1616,260
15535,1,1,69,1243,1174
15536,1,0,133,0,-133
15537,0,0,42,0,-42
15538,1,0,28,0,-28
15539,1,1,688,1684,996
15540,1,1,1993,1510,-483
15541,1,0,70,0,-70
15542,1,0,122,0,-122
15543,0,0,37,0,-37
15544,0,0,30,0,-30
15545,1,1,600,2039,1439
15546,1,0,140,0,-140
15547,1,1,579,1828,1249
15548,1,0,46,0,-46
15549,1,0,70,0,-70
15550,0,0,229,0,-229
15551,0,0,97,0,-97
15552,1,1,453,2872,2419
15553,0,0,126,0,-126
15554,1,0,22,0,-22
15555,1,0,119,0,-119
15556,1,0,72,0,-72
15557,1,1,73,1658,1585
15558,0,0,38,0,-38
15559,1,1,1307,1364,57
15560,1,0,20,0,-20
15561,1,0,65,0,-65
15562,1,1,1374,1286,-88
15563,0,0,38,0,-38
15564,1,0,90,0,-90
15565,1,0,22,0,-22
15566,0,0,4,0,-4
15567,1,0,30,0,-30
15568,0,0,82,0,-82
15569,0,0,29,0,-29
15570,1,0,4,0,-4
15571,0,0,44,0,-44
15572,1,1,684,2087,1403
15573,0,0,142,0,-142
15574,1,0,9,0,-9
15575,0,0,2,0,-2
15576,0,0,112,0,-112
15577,0,0,2,0,-2
15578,1,1,639,1298,659
15579,1,0,30,0,-30
15580,0,0,46,0,-46
15581,0,0,19,0,-19
15582,1,0,52,0,-52
15583,0,0,8,0,-8
15584,0,0,33,0,-33
15585,1,0,9,0,-9
15586,0,0,55,0,-55
15587,1,1,832,1338,506
15588,0,0,16,0,-16
15589,0,0,48,0,-48
15590,0,0,22,0,-22
15591,0,0,16,0,-16
15592,0,0,2,0,-2
15593,1,1,270,1264,994
15594,0,0,11,0,-11
15595,1,0,29,0,-29
15596,0,0,75,0,-75
15597,1,1,275,1808,1533
15598,1,1,258,1301,1043
15599,1,1,253,1306,1053
15600,1,1,129,1532,1403
15601,0,0,27,0,-27
15602,0,0,75,0,-75
15603,0,0,19,0,-19
15604,1,1,142,1353,1211
15605,0,0,48,0,-48
15606,0,0,97,0,-97
15607,0,0,4,0,-4
15608,1,0,23,0,-23
15609,1,0,16,0,-16
15610,1,1,212,1833,1621
15611,0,0,54,0,-54
15612,1,1,624,1414,790
15613,0,0,49,0,-49
15614,1,0,23,0,-23
15615,0,0,57,0,-57
15616,1,0,8,0,-8
15617,1,0,42,0,-42
15618,0,0,68,0,-68
15619,1,0,1,0,-1
15620,1,1,15,1261,1246
15621,1,1,160,1388,1228
15622,1,1,475,1856,1381
15623,0,0,25,0,-25
15624,0,0,7,0,-7
15625,0,0,38,0,-38
15626,1,0,81,0,-81
15627,1,1,855,1325,470
15628,0,0,53,0,-53
15629,1,1,236,2968,2732
15630,0,0,130,0,-130
15631,1,1,1702,1428,-274
15632,1,1,481,1247,766
15633,0,0,46,0,-46
15634,0,0,9,0,-9
15635,0,0,12,0,-12
15636,1,1,727,2093,1366
15637,0,0,75,0,-75
15638,1,1,94,1466,1372
15639,1,0,3,0,-3
15640,1,1,123,3716,3593
15641,0,0,8,0,-8
15642,1,1,1669,1282,-387
15643,1,0,122,0,-122
15644,0,0,75,0,-75
15645,0,0,27,0,-27
15646,0,0,101,0,-101
15647,1,0,54,0,-54
15648,0,0,64,0,-64
15649,1,0,38,0,-38
15650,0,0,10,0,-10
15651,0,0,45,0,-45
15652,1,1,759,1522,763
15653,1,1,720,2105,1385
15654,1,0,52,0,-52
15655,0,0,3,0,-3
15656,0,0,84,0,-84
15657,0,0,146,0,-146
15658,1,0,0,0,0
15659,1,1,2444,1403,-1041
15660,1,0,29,0,-29
15661,1,0,32,0,-32
15662,1,0,27,0,-27
15663,1,1,116,1300,1184
15664,0,0,80,0,-80
15665,0,0,4,0,-4
15666,1,0,0,0,0
15667,0,0,23,0,-23
15668,0,0,182,0,-182
15669,1,0,1,0,-1
15670,1,0,39,0,-39
15671,0,0,26,0,-26
15672,0,0,35,0,-35
15673,0,0,19,0,-19
15674,1,1,148,1241,1093
15675,1,1,160,1335,1175
15676,1,0,52,0,-52
15677,1,1,119,1635,1516
15678,0,0,19,0,-19
15679,0,0,14,0,-14
15680,1,0,38,0,-38
15681,1,0,41,0,-41
15682,1,0,25,0,-25
15683,1,0,83,0,-83
15684,0,0,66,0,-66
15685,0,0,53,0,-53
15686,0,0,76,0,-76
15687,1,0,8,0,-8
15688,1,0,194,0,-194
15689,0,0,17,0,-17
15690,1,0,3,0,-3
15691,1,0,6,0,-6
15692,1,0,33,0,-33
15693,0,0,33,0,-33
15694,1,1,2659,1397,-1262
15695,1,1,81,1401,1320
15696,1,0,164,0,-164
15697,1,0,30,0,-30
15698,0,0,81,0,-81
15699,1,0,13,0,-13
15700,0,0,21,0,-21
15701,0,0,49,0,-49
15702,1,1,722,1276,554
15703,1,0,42,0,-42
15704,1,1,157,1246,1089
15705,0,0,41,0,-41
15706,1,0,12,0,-12
15707,0,0,156,0,-156
15708,0,0,36,0,-36
15709,0,0,109,0,-109
15710,1,0,147,0,-147
15711,1,0,32,0,-32
15712,0,0,49,0,-49
15713,0,0,65,0,-65
15714,0,0,89,0,-89
15715,1,1,162,1451,1289
15716,1,0,12,0,-12
15717,0,0,21,0,-21
15718,0,0,50,0,-50
15719,0,0,53,0,-53
15720,0,0,21,0,-21
15721,1,1,533,1238,705
15722,1,1,1856,1555,-301
15723,0,0,69,0,-69
15724,1,0,18,0,-18
15725,1,0,8,0,-8
15726,1,0,21,0,-21
15727,1,0,72,0,-72
15728,1,0,8,0,-8
15729,1,1,587,1389,802
15730,1,1,61,2012,1951
15731,1,0,22,0,-22
15732,0,0,101,0,-101
15733,0,0,18,0,-18
15734,1,1,186,1572,1386
15735,1,0,33,0,-33
15736,1,1,699,2412,1713
15737,1,1,1472,1587,115
15738,0,0,1,0,-1
15739,1,0,42,0,-42
15740,0,0,4,0,-4
15741,1,0,61,0,-61
15742,1,1,1153,1431,278
15743,0,0,14,0,-14
15744,0,0,22,0,-22
15745,1,0,117,0,-117
15746,0,0,19,0,-19
15747,0,0,3,0,-3
15748,1,1,517,1275,758
15749,0,0,14,0,-14
15750,0,0,15,0,-15
15751,0,0,26,0,-26
15752,0,0,1,0,-1
15753,0,0,33,0,-33
15754,0,0,18,0,-18
15755,1,0,52,0,-52
15756,0,0,11,0,-11
15757,1,1,77,1535,1458
15758,0,0,12,0,-12
15759,1,0,28,0,-28
15760,1,1,471,1260,789
15761,0,0,4,0,-4
15762,1,1,283,1521,1238
15763,0,0,16,0,-16
15764,1,1,713,1476,763
15765,1,1,767,1824,1057
15766,1,0,22,0,-22
15767,0,0,1,0,-1
15768,0,0,77,0,-77
15769,1,0,14,0,-14
15770,1,1,125,1546,1421
15771,1,1,382,1597,1215
15772,0,0,24,0,-24
15773,1,1,99,1589,1490
15774,0,0,14,0,-14
15775,1,0,47,0,-47
15776,0,0,1,0,-1
15777,1,0,21,0,-21
15778,1,1,1924,1387,-537
15779,1,0,125,0,-125
15780,1,0,104,0,-104
15781,0,0,6,0,-6
15782,1,0,36,0,-36
15783,0,0,58,0,-58
15784,1,1,148,1295,1147
15785,0,0,92,0,-92
15786,1,1,171,1421,1250
15787,0,0,39,0,-39
15788,1,1,822,1278,456
15789,0,0,86,0,-86
15790,0,0,18,0,-18
15791,0,0,15,0,-15
15792,1,0,51,0,-51
15793,1,0,28,0,-28
15794,1,0,16,0,-16
15795,1,1,234,2247,2013
15796,1,1,59,5413,5354
15797,0,0,46,0,-46
15798,1,0,3,0,-3
15799,0,0,43,0,-43
15800,1,1,175,1425,1250
15801,1,0,145,0,-145
15802,1,1,1427,1452,25
15803,0,0,36,0,-36
15804,1,1,442,1595,1153
15805,1,1,1347,3077,1730
15806,0,0,196,0,-196
15807,1,0,0,0,0
15808,1,0,86,0,-86
15809,1,0,34,0,-34
15810,1,1,245,1427,1182
15811,1,1,37,1251,1214
15812,1,1,369,1288,919
15813,1,0,42,0,-42
15814,1,0,23,0,-23
15815,1,0,32,0,-32
15816,1,0,5,0,-5
15817,1,0,4,0,-4
15818,0,0,34,0,-34
15819,1,1,1524,1727,203
15820,0,0,103,0,-103
15821,1,1,166,2392,2226
15822,0,0,88,0,-88
15823,0,0,18,0,-18
15824,1,1,263,1473,1210
15825,1,0,13,0,-13
15826,1,1,302,1452,1150
15827,0,0,38,0,-38
15828,1,0,13,0,-13
15829,0,0,87,0,-87
15830,1,0,30,0,-30
15831,0,0,17,0,-17
15832,0,0,155,0,-155
15833,1,1,130,2286,2156
15834,1,0,63,0,-63
15835,0,0,231,0,-231
15836,0,0,183,0,-183
15837,1,1,404,1741,1337
15838,1,0,117,0,-117
15839,1,0,27,0,-27
15840,1,1,931,1354,423
15841,0,0,57,0,-57
15842,0,0,118,0,-118
15843,1,0,13,0,-13
15844,1,0,4,0,-4
15845,1,0,32,0,-32
15846,1,1,559,1319,760
15847,0,0,53,0,-53
15848,1,1,507,1516,1009
15849,1,1,576,1577,1001
15850,0,0,29,0,-29
15851,1,1,2616,1871,-745
15852,1,0,32,0,-32
15853,1,0,12,0,-12
15854,1,0,86,0,-86
15855,1,0,60,0,-60
15856,1,0,13,0,-13
15857,0,0,8,0,-8
15858,1,0,9,0,-9
15859,1,0,168,0,-168
15860,0,0,58,0,-58
15861,1,0,30,0,-30
15862,1,0,91,0,-91
15863,1,1,423,1568,1145
15864,1,1,407,1277,870
15865,0,0,1,0,-1
15866,1,0,15,0,-15
15867,0,0,6,0,-6
15868,1,1,458,2010,1552
15869,0,0,0,0,0
15870,0,0,54,0,-54
15871,1,1,1236,1499,263
15872,1,1,1214,1684,470
15873,0,0,78,0,-78
15874,0,0,16,0,-16
15875,1,0,2,0,-2
15876,1,0,15,0,-15
15877,1,1,745,1252,507
15878,0,0,118,0,-118
15879,0,0,16,0,-16
15880,1,1,237,1653,1416
15881,1,0,23,0,-23
15882,1,1,1056,2012,956
15883,1,1,1488,3656,2168
15884,1,0,69,0,-69
15885,1,1,282,1379,1097
15886,0,0,88,0,-88
15887,0,0,92,0,-92
15888,1,0,5,0,-5
15889,1,1,331,1828,1497
15890,0,0,67,0,-67
15891,1,1,285,1348,1063
15892,0,0,74,0,-74
15893,0,0,67,0,-67
15894,0,0,116,0,-116
15895,1,0,8,0,-8
15896,1,1,880,1304,424
15897,1,1,603,1340,737
15898,1,1,147,1350,1203
15899,1,0,10,0,-10
15900,1,1,1440,1279,-161
15901,0,0,19,0,-19
15902,1,1,512,1568,1056
15903,0,0,21,0,-21
15904,0,0,126,0,-126
15905,1,1,557,1281,724
15906,0,0,27,0,-27
15907,0,0,50,0,-50
15908,0,0,44,0,-44
15909,0,0,41,0,-41
15910,0,0,17,0,-17
15911,1,0,134,0,-134
15912,0,0,16,0,-16
15913,0,0,77,0,-77
15914,1,1,139,1246,1107
15915,1,1,39,1689,1650
15916,1,0,117,0,-117
15917,0,0,30,0,-30
15918,1,1,440,1417,977
15919,1,1,354,4433,4079
15920,0,0,3,0,-3
15921,1,0,28,0,-28
15922,1,0,4,0,-4
15923,1,0,8,0,-8
15924,0,0,50,0,-50
15925,0,0,38,0,-38
15926,1,1,614,1442,828
15927,0,0,107,0,-107
15928,0,0,46,0,-46
15929,1,1,1267,1386,119
15930,1,0,24,0,-24
15931,1,1,715,2513,1798
15932,0,0,67,0,-67
15933,1,0,179,0,-179
15934,1,1,125,1655,1530
15935,1,0,76,0,-76
15936,0,0,9,0,-9
15937,1,1,1233,1237,4
15938,1,1,466,2003,1537
15939,1,1,138,1434,1296
15940,0,0,19,0,-19
15941,1,1,88,1722,1634
15942,1,0,30,0,-30
15943,1,0,9,0,-9
15944,1,1,1237,1382,145
15945,1,1,805,1316,511
15946,1,0,67,0,-67
15947,1,0,13,0,-13
15948,1,0,7,0,-7
15949,0,0,103,0,-103
15950,1,0,93,0,-93
15951,1,1,1181,1719,538
15952,0,0,30,0,-30
15953,0,0,41,0,-41
15954,0,0,90,0,-90
15955,0,0,27,0,-27
15956,1,0,2,0,-2
15957,1,0,76,0,-76
15958,1,0,91,0,-91
15959,1,1,83,1434,1351
15960,1,0,112,0,-112
15961,0,0,203,0,-203
15962,1,0,15,0,-15
15963,1,0,21,0,-21
15964,0,0,25,0,-25
15965,1,1,108,1630,1522
15966,0,0,9,0,-9
15967,0,0,46,0,-46
15968,0,0,17,0,-17
15969,0,0,80,0,-80
15970,1,1,124,1779,1655
15971,0,0,51,0,-51
15972,0,0,2,0,-2
15973,1,0,24,0,-24
15974,0,0,36,0,-36
15975,1,0,12,0,-12
15976,1,1,44,1252,1208
15977,1,1,311,1264,953
15978,1,1,276,1349,1073
15979,0,0,0,0,0
15980,0,0,5,0,-5
15981,0,0,4,0,-4
15982,1,1,544,1302,758
15983,0,0,74,0,-74
15984,0,0,82,0,-82
15985,1,0,81,0,-81
15986,0,0,51,0,-51
15987,1,1,754,1248,494
15988,1,1,74,1249,1175
15989,1,0,27,0,-27
15990,1,0,50,0,-50
15991,1,0,102,0,-102
15992,0,0,117,0,-117
15993,0,0,5,0,-5
15994,1,0,215,0,-215
15995,1,0,4,0,-4
15996,0,0,12,0,-12
15997,0,0,24,0,-24
15998,1,1,203,1320,1117
15999,1,0,1,0,-1
16000,1,0,65,0,-65
16001,1,1,352,1401,1049
16002,1,0,45,0,-45
16003,0,0,7,0,-7
16004,0,0,17,0,-17
16005,1,1,74,3099,3025
16006,0,0,121,0,-121
16007,1,1,233,1302,1069
16008,0,0,13,0,-13
16009,0,0,5,0,-5
16010,0,0,33,0,-33
16011,0,0,73,0,-73
16012,0,0,117,0,-117
16013,1,1,870,2480,1610
16014,1,0,1,0,-1
16015,0,0,128,0,-128
16016,1,1,373,1489,1116
16017,1,1,25,1708,1683
16018,0,0,42,0,-42
16019,0,0,25,0,-25
16020,1,1,887,1648,761
16021,0,0,6,0,-6
16022,1,0,10,0,-10
16023,0,0,11,0,-11
16024,0,0,65,0,-65
16025,1,0,202,0,-202
16026,1,0,69,0,-69
16027,1,0,9,0,-9
16028,1,1,291,1906,1615
16029,1,1,694,1389,695
16030,1,1,1300,2490,1190
16031,1,0,60,0,-60
16032,0,0,13,0,-13
16033,1,1,126,1470,1344
16034,0,0,58,0,-58
16035,0,0,101,0,-101
16036,0,0,30,0,-30
16037,1,1,1673,1430,-243
16038,1,1,198,1284,1086
16039,1,0,5,0,-5
16040,1,0,117,0,-117
16041,1,1,619,1258,639
16042,1,0,285,0,-285
16043,1,0,48,0,-48
16044,1,0,10,0,-10
16045,1,1,671,1426,755
16046,1,0,24,0,-24
16047,1,0,18,0,-18
16048,1,1,646,1500,854
16049,1,1,1324,1246,-78
16050,0,0,50,0,-50
16051,0,0,66,0,-66
16052,1,0,19,0,-19
16053,1,0,20,0,-20
16054,1,0,8,0,-8
16055,1,0,99,0,-99
16056,0,0,18,0,-18
16057,0,0,192,0,-192
16058,1,0,31,0,-31
16059,1,1,161,1269,1108
16060,0,0,5,0,-5
16061,1,0,5,0,-5
16062,0,0,30,0,-30
16063,1,0,56,0,-56
16064,0,0,2,0,-2
16065,1,0,40,0,-40
16066,0,0,184,0,-184
16067,0,0,106,0,-106
16068,0,0,29,0,-29
16069,0,0,7,0,-7
16070,0,0,114,0,-114
16071,1,1,685,1526,841
16072,1,1,575,2016,1441
16073,1,0,50,0,-50
16074,1,0,0,0,0
16075,1,0,42,0,-42
16076,0,0,232,0,-232
16077,0,0,1,0,-1
16078,1,1,1882,1295,-587
16079,1,1,42,1727,1685
16080,1,1,160,1404,1244
16081,1,0,186,0,-186
16082,1,0,34,0,-34
16083,1,0,60,0,-60
16084,1,0,69,0,-69
16085,1,1,1423,1638,215
16086,1,0,31,0,-31
16087,0,0,125,0,-125
16088,1,0,15,0,-15
16089,1,0,91,0,-91
16090,1,1,259,1283,1024
16091,1,1,1179,1415,236
16092,1,1,273,1728,1455
16093,0,0,37,0,-37
16094,0,0,71,0,-71
16095,0,0,0,0,0
16096,1,1,411,1503,1092
16097,1,0,40,0,-40
16098,0,0,25,0,-25
16099,1,0,28,0,-28
16100,1,0,192,0,-192
16101,1,1,201,2115,1914
16102,1,1,195,1367,1172
16103,0,0,12,0,-12
16104,1,1,86,1352,1266
16105,1,0,4,0,-4
16106,1,1,188,1856,1668
16107,0,0,84,0,-84
16108,0,0,51,0,-51
16109,0,0,5,0,-5
16110,0,0,131,0,-131
16111,1,0,23,0,-23
16112,1,0,12,0,-12
16113,1,0,9,0,-9
16114,1,1,476,1342,866
16115,0,0,105,0,-105
16116,1,0,20,0,-20
16117,1,1,137,2990,2853
16118,0,0,13,0,-13
16119,1,0,21,0,-21
16120,0,0,69,0,-69
16121,0,0,73,0,-73
16122,0,0,130,0,-130
16123,1,1,709,1290,581
16124,1,0,24,0,-24
16125,1,1,210,1609,1399
16126,1,0,164,0,-164
16127,1,0,102,0,-102
16128,0,0,67,0,-67
16129,1,1,118,1273,1155
16130,1,0,8,0,-8
16131,1,1,628,1343,715
16132,1,0,69,0,-69
16133,1,1,920,1737,817
16134,0,0,19,0,-19
16135,1,1,1248,1581,333
16136,1,0,0,0,0
16137,1,1,182,1284,1102
16138,0,0,109,0,-109
16139,1,1,79,1269,1190
16140,1,1,1338,1240,-98
16141,0,0,14,0,-14
16142,1,1,425,1518,1093
16143,0,0,166,0,-166
16144,0,0,32,0,-32
16145,1,1,267,1811,1544
16146,0,0,55,0,-55
16147,0,0,14,0,-14
16148,1,1,343,1304,961
16149,0,0,3,0,-3
16150,1,1,317,1385,1068
16151,1,1,96,1257,1161
16152,0,0,17,0,-17
16153,1,1,358,1252,894
16154,0,0,12,0,-12
16155,0,0,7,0,-7
16156,1,0,48,0,-48
16157,1,1,559,1779,1220
16158,0,0,7,0,-7
16159,0,0,22,0,-22
16160,1,0,6,0,-6
16161,0,0,53,0,-53
16162,1,1,524,1399,875
16163,1,0,171,0,-171
16164,0,0,8,0,-8
16165,0,0,34,0,-34
16166,1,0,27,0,-27
16167,1,1,315,1305,990
16168,0,0,31,0,-31
16169,1,0,157,0,-157
16170,0,0,46,0,-46
16171,0,0,16,0,-16
16172,1,1,436,1555,1119
16173,1,0,66,0,-66
16174,1,1,118,1540,1422
16175,1,0,51,0,-51
16176,0,0,19,0,-19
16177,1,1,125,1358,1233
16178,0,0,25,0,-25
16179,1,1,175,1249,1074
16180,1,1,365,2555,2190
16181,0,0,74,0,-74
16182,1,1,930,1714,784
16183,1,1,484,1330,846
16184,0,0,48,0,-48
16185,0,0,18,0,-18
16186,1,0,171,0,-171
16187,1,0,3,0,-3
16188,0,0,65,0,-65
16189,0,0,41,0,-41
16190,1,0,0,0,0
16191,1,0,35,0,-35
16192,1,1,35,1535,1500
16193,1,0,7,0,-7
16194,1,0,26,0,-26
16195,0,0,42,0,-42
16196,0,0,34,0,-34
16197,1,0,5,0,-5
16198,1,0,60,0,-60
16199,0,0,0,0,0
16200,1,1,193,1260,1067
16201,0,0,5,0,-5
16202,0,0,11,0,-11
16203,1,0,36,0,-36
16204,1,1,456,1239,783
16205,1,1,1959,1446,-513
16206,1,0,10,0,-10
16207,0,0,6,0,-6
16208,0,0,21,0,-21
16209,1,0,1,0,-1
16210,1,0,163,0,-163
16211,0,0,37,0,-37
16212,1,0,105,0,-105
16213,1,0,74,0,-74
16214,0,0,66,0,-66
16215,1,1,101,1725,1624
16216,1,0,84,0,-84
16217,1,0,154,0,-154
16218,1,1,902,1331,429
16219,0,0,101,0,-101
16220,1,0,44,0,-44
16221,1,1,409,1286,877
16222,1,1,517,1574,1057
16223,1,1,119,1449,1330
16224,0,0,249,0,-249
16225,0,0,39,0,-39
16226,1,1,864,1447,583
16227,0,0,163,0,-163
16228,0,0,134,0,-134
16229,1,1,1841,1240,-601
16230,0,0,53,0,-53
16231,1,0,9,0,-9
16232,0,0,13,0,-13
16233,1,0,74,0,-74
16234,1,1,1933,1533,-400
16235,1,1,861,2856,1995
16236,1,0,76,0,-76
16237,0,0,6,0,-6
16238,1,0,7,0,-7
16239,1,1,332,1462,1130
16240,0,0,39,0,-39
16241,0,0,21,0,-21
16242,0,0,38,0,-38
16243,1,1,344,1331,987
16244,1,1,124,1318,1194
16245,0,0,61,0,-61
16246,1,1,695,1372,677
16247,1,0,16,0,-16
16248,0,0,28,0,-28
16249,0,0,116,0,-116
16250,0,0,67,0,-67
16251,1,1,375,1360,985
16252,1,1,160,1486,1326
16253,0,0,88,0,-88
16254,1,0,14,0,-14
16255,0,0,84,0,-84
16256,0,0,214,0,-214
16257,0,0,54,0,-54
16258,1,0,48,0,-48
16259,1,0,0,0,0
16260,1,1,434,1236,802
16261,0,0,26,0,-26
16262,1,1,215,1741,1526
16263,0,0,23,0,-23
16264,1,1,126,1748,1622
16265,0,0,39,0,-39
16266,0,0,48,0,-48
16267,1,0,7,0,-7
16268,1,1,328,1655,1327
16269,1,1,448,1499,1051
16270,0,0,53,0,-53
16271,1,0,47,0,-47
16272,0,0,9,0,-9
16273,1,0,31,0,-31
16274,1,0,89,0,-89
16275,0,0,38,0,-38
16276,1,1,166,1647,1481
16277,1,0,1,0,-1
16278,0,0,45,0,-45
16279,1,0,122,0,-122
16280,1,1,642,1474,832
16281,1,0,103,0,-103
16282,0,0,21,0,-21
16283,0,0,31,0,-31
16284,1,0,100,0,-100
16285,0,0,32,0,-32
16286,1,0,21,0,-21
16287,0,0,83,0,-83
16288,0,0,261,0,-261
16289,1,0,14,0,-14
16290,0,0,7,0,-7
16291,0,0,7,0,-7
16292,1,0,35,0,-35
16293,0,0,0,0,0
16294,0,0,44,0,-44
16295,1,1,123,2807,2684
16296,1,0,14,0,-14
16297,1,1,809,1868,1059
16298,1,0,4,0,-4
16299,0,0,61,0,-61
16300,0,0,19,0,-19
16301,1,0,56,0,-56
16302,1,1,604,1297,693
16303,1,1,939,1250,311
16304,1,1,230,1735,1505
16305,1,0,33,0,-33
16306,1,1,1924,1816,-108
16307,1,1,636,1482,846
16308,0,0,31,0,-31
16309,0,0,58,0,-58
16310,0,0,98,0,-98
16311,0,0,16,0,-16
16312,0,0,18,0,-18
16313,1,0,104,0,-104
16314,0,0,52,0,-52
16315,1,0,43,0,-43
16316,1,0,10,0,-10
16317,0,0,1,0,-1
16318,1,0,18,0,-18
16319,1,1,173,1900,1727
16320,1,0,79,0,-79
16321,0,0,15,0,-15
16322,1,0,136,0,-136
16323,1,0,45,0,-45
16324,1,0,90,0,-90
16325,1,0,7,0,-7
16326,0,0,2,0,-2
16327,1,0,26,0,-26
16328,0,0,18,0,-18
16329,1,1,51,1638,1587
16330,1,1,467,1257,790
16331,1,0,20,0,-20
16332,0,0,53,0,-53
16333,1,0,60,0,-60
16334,1,1,160,1547,1387
16335,0,0,35,0,-35
16336,1,0,35,0,-35
16337,1,1,1321,1356,35
16338,0,0,66,0,-66
16339,1,0,24,0,-24
16340,1,1,26,1495,1469
16341,0,0,58,0,-58
16342,1,0,64,0,-64
16343,1,1,260,1307,1047
16344,0,0,53,0,-53
16345,0,0,30,0,-30
16346,1,1,291,2252,1961
16347,1,1,600,1774,1174
16348,0,0,95,0,-95
16349,1,1,438,1689,1251
16350,1,0,61,0,-61
16351,1,1,235,1284,1049
16352,1,1,299,1329,1030
16353,1,1,99,1618,1519
16354,0,0,46,0,-46
16355,1,1,279,1338,1059
16356,0,0,45,0,-45
16357,1,1,113,1271,1158
16358,1,0,47,0,-47
16359,1,0,10,0,-10
16360,1,0,86,0,-86
16361,1,0,48,0,-48
16362,1,1,1119,1471,352
16363,0,0,0,0,0
16364,0,0,6,0,-6
16365,1,0,102,0,-102
16366,1,1,247,1480,1233
16367,1,0,33,0,-33
16368,1,0,5,0,-5
16369,1,1,135,2451,2316
16370,1,1,190,1780,1590
16371,1,1,1035,1285,250
16372,0,0,28,0,-28
16373,1,1,281,1960,1679
16374,1,1,117,1526,1409
16375,1,1,64,1567,1503
16376,1,1,1549,1515,-34
16377,0,0,39,0,-39
16378,0,0,50,0,-50
16379,0,0,8,0,-8
16380,1,0,9,0,-9
16381,0,0,11,0,-11
16382,0,0,21,0,-21
16383,1,0,30,0,-30
16384,1,1,82,2293,2211
16385,0,0,23,0,-23
16386,0,0,16,0,-16
16387,0,0,35,0,-35
16388,1,0,4,0,-4
16389,1,1,584,1337,753
16390,1,0,10,0,-10
16391,1,0,91,0,-91
16392,1,0,31,0,-31
16393,1,1,342,1927,1585
16394,1,1,44,1534,1490
16395,0,0,104,0,-104
16396,0,0,73,0,-73
16397,1,0,42,0,-42
16398,0,0,435,0,-435
16399,1,1,165,1301,1136
16400,1,0,22,0,-22
16401,1,0,74,0,-74
16402,1,1,269,1460,1191
16403,0,0,70,0,-70
16404,0,0,87,0,-87
16405,0,0,37,0,-37
16406,1,0,21,0,-21
16407,1,1,188,1826,1638
16408,1,0,95,0,-95
16409,1,0,35,0,-35
16410,1,1,256,1442,1186
16411,1,1,135,1823,1688
16412,0,0,0,0,0
16413,1,0,40,0,-40
16414,1,1,159,1283,1124
16415,1,0,15,0,-15
16416,1,0,38,0,-38
16417,1,1,90,1624,1534
16418,1,1,16,2899,2883
16419,0,0,38,0,-38
16420,0,0,36,0,-36
16421,0,0,26,0,-26
16422,1,0,12,0,-12
16423,1,0,26,0,-26
16424,0,0,28,0,-28
16425,0,0,19,0,-19
16426,0,0,12,0,-12
16427,1,1,491,1465,974
16428,1,0,25,0,-25
16429,1,1,331,1315,984
16430,1,0,150,0,-150
16431,1,0,183,0,-183
16432,0,0,84,0,-84
16433,1,1,76,1301,1225
16434,1,0,31,0,-31
16435,1,1,208,1394,1186
16436,1,0,240,0,-240
16437,1,0,50,0,-50
16438,1,0,18,0,-18
16439,1,1,151,1295,1144
16440,0,0,29,0,-29
16441,1,0,43,0,-43
16442,0,0,15,0,-15
16443,1,0,74,0,-74
16444,1,1,1553,1931,378
16445,1,0,4,0,-4
16446,1,0,96,0,-96
16447,1,0,90,0,-90
16448,1,0,59,0,-59
16449,1,0,12,0,-12
16450,1,0,96,0,-96
16451,1,1,169,1394,1225
16452,0,0,30,0,-30
16453,1,0,19,0,-19
16454,0,0,58,0,-58
16455,1,1,1365,1287,-78
16456,1,0,2,0,-2
16457,0,0,27,0,-27
16458,0,0,80,0,-80
16459,1,1,130,1725,1595
16460,1,1,1315,1259,-56
16461,1,1,753,1317,564
16462,1,1,712,1393,681
16463,1,1,58,1399,1341
16464,0,0,114,0,-114
16465,1,1,305,1238,933
16466,0,0,37,0,-37
16467,0,0,150,0,-150
16468,1,1,296,1450,1154
16469,1,0,41,0,-41
16470,0,0,11,0,-11
16471,0,0,193,0,-193
16472,1,1,110,1578,1468
16473,0,0,71,0,-71
16474,1,1,50,1823,1773
16475,0,0,14,0,-14
16476,1,0,32,0,-32
16477,1,1,117,1445,1328
16478,1,0,41,0,-41
16479,1,1,1487,1268,-219
16480,0,0,0,0,0
16481,1,0,16,0,-16
16482,1,1,790,1415,625
16483,0,0,56,0,-56
16484,1,0,58,0,-58
16485,0,0,8,0,-8
16486,0,0,42,0,-42
16487,1,1,946,1975,1029
16488,0,0,51,0,-51
16489,0,0,78,0,-78
16490,1,0,0,0,0
16491,1,1,465,1361,896
16492,1,0,54,0,-54
16493,1,0,47,0,-47
16494,1,0,4,0,-4
16495,0,0,194,0,-194
16496,0,0,36,0,-36
16497,0,0,21,0,-21
16498,1,0,72,0,-72
16499,1,1,531,1340,809
16500,0,0,8,0,-8
16501,0,0,59,0,-59
16502,0,0,14,0,-14
16503,1,1,38,1493,1455
16504,0,0,38,0,-38
16505,1,1,1653,1959,306
16506,0,0,14,0,-14
16507,0,0,6,0,-6
16508,0,0,0,0,0
16509,0,0,165,0,-165
16510,1,0,2,0,-2
16511,0,0,0,0,0
16512,1,0,59,0,-59
16513,1,1,297,1261,964
16514,0,0,8,0,-8
16515,1,0,39,0,-39
16516,1,1,177,2522,2345
16517,0,0,48,0,-48
16518,1,1,738,1359,621
16519,0,0,102,0,-102
16520,1,0,13,0,-13
16521,0,0,37,0,-37
16522,1,1,335,1440,1105
16523,0,0,183,0,-183
16524,1,1,1141,1258,117
16525,1,0,82,0,-82
16526,1,0,15,0,-15
16527,0,0,55,0,-55
16528,0,0,54,0,-54
16529,1,0,10,0,-10
16530,1,1,178,1580,1402
16531,1,1,711,1315,604
16532,1,0,129,0,-129
16533,0,0,2,0,-2
16534,1,0,92,0,-92
16535,1,1,321,1244,923
16536,1,0,41,0,-41
16537,1,0,44,0,-44
16538,0,0,6,0,-6
16539,0,0,31,0,-31
16540,1,1,90,2094,2004
16541,0,0,12,0,-12
16542,1,0,62,0,-62
16543,0,0,0,0,0
16544,0,0,40,0,-40
16545,0,0,212,0,-212
16546,1,1,626,1274,648
16547,1,1,653,1337,684
16548,0,0,36,0,-36
16549,0,0,57,0,-57
16550,1,1,379,3219,2840
16551,1,1,98,1329,1231
16552,0,0,0,0,0
16553,0,0,252,0,-252
16554,1,0,48,0,-48
16555,0,0,26,0,-26
16556,0,0,29,0,-29
16557,1,1,845,1269,424
16558,1,1,327,1335,1008
16559,1,1,164,1238,1074
16560,1,0,33,0,-33
16561,1,0,6,0,-6
16562,0,0,110,0,-110
16563,1,1,500,1235,735
16564,1,1,548,2304,1756
16565,0,0,90,0,-90
16566,1,1,35,2120,2085
16567,1,0,63,0,-63
16568,1,0,64,0,-64
16569,0,0,9,0,-9
16570,1,1,331,1763,1432
16571,1,0,29,0,-29
16572,1,0,87,0,-87
16573,1,1,190,3129,2939
16574,1,1,249,2805,2556
16575,0,0,76,0,-76
16576,0,0,16,0,-16
16577,1,0,17,0,-17
16578,1,1,269,1336,1067
16579,0,0,184,0,-184
16580,0,0,11,0,-11
16581,1,1,232,1814,1582
16582,0,0,15,0,-15
16583,1,1,51,1416,1365
16584,1,0,6,0,-6
16585,1,1,145,1469,1324
16586,1,0,47,0,-47
16587,1,0,6,0,-6
16588,0,0,33,0,-33
16589,0,0,41,0,-41
16590,1,1,333,1287,954
16591,1,1,991,1423,432
16592,1,1,289,1365,1076
16593,0,0,6,0,-6
16594,1,0,66,0,-66
16595,0,0,44,0,-44
16596,1,1,242,1562,1320
16597,1,0,161,0,-161
16598,1,0,5,0,-5
16599,0,0,10,0,-10
16600,1,1,1447,1388,-59
16601,0,0,11,0,-11
16602,0,0,0,0,0
16603,0,0,0,0,0
16604,0,0,9,0,-9
16605,1,0,11,0,-11
16606,0,0,88,0,-88
16607,0,0,52,0,-52
16608,0,0,68,0,-68
16609,0,0,23,0,-23
16610,1,0,21,0,-21
16611,1,0,117,0,-117
16612,0,0,0,0,0
16613,0,0,14,0,-14
16614,1,1,958,1256,298
16615,1,0,2,0,-2
16616,0,0,65,0,-65
16617,1,0,58,0,-58
16618,1,1,236,1819,1583
16619,1,0,7,0,-7
16620,0,0,91,0,-91
16621,0,0,39,0,-39
16622,1,1,639,1307,668
16623,1,0,61,0,-61
16624,1,1,712,1311,599
16625,1,0,30,0,-30
16626,1,1,32,1522,1490
16627,1,0,60,0,-60
16628,1,0,51,0,-51
16629,1,0,3,0,-3
16630,0,0,101,0,-101
16631,0,0,22,0,-22
16632,1,1,535,1767,1232
16633,1,1,675,1499,824
16634,1,0,42,0,-42
16635,0,0,43,0,-43
16636,0,0,9,0,-9
16637,1,1,842,1736,894
16638,1,0,5,0,-5
16639,0,0,26,0,-26
16640,0,0,27,0,-27
16641,0,0,70,0,-70
16642,1,0,1,0,-1
16643,1,0,26,0,-26
16644,1,0,6,0,-6
16645,1,1,848,1571,723
16646,0,0,23,0,-23
16647,1,1,245,1382,1137
16648,0,0,89,0,-89
16649,1,1,1514,1351,-163
16650,1,0,46,0,-46
16651,1,1,134,1895,1761
16652,0,0,18,0,-18
16653,1,1,616,2687,2071
16654,0,0,8,0,-8
16655,1,1,408,1493,1085
16656,1,1,300,1244,944
16657,1,1,71,3146,3075
16658,1,0,101,0,-101
16659,0,0,23,0,-23
16660,0,0,8,0,-8
16661,0,0,78,0,-78
16662,1,0,22,0,-22
16663,0,0,17,0,-17
16664,1,1,325,1361,1036
16665,1,0,26,0,-26
16666,1,1,195,1267,1072
16667,0,0,3,0,-3
16668,0,0,46,0,-46
16669,0,0,94,0,-94
16670,0,0,6,0,-6
16671,1,1,300,2043,1743
16672,1,0,47,0,-47
16673,0,0,58,0,-58
16674,1,1,344,1477,1133
16675,0,0,61,0,-61
16676,1,0,11,0,-11
16677,0,0,28,0,-28
16678,1,0,31,0,-31
16679,1,1,593,1636,1043
16680,0,0,304,0,-304
16681,0,0,33,0,-33
16682,0,0,29,0,-29
16683,1,1,702,2501,1799
16684,1,0,44,0,-44
16685,1,1,174,1782,1608
16686,1,0,21,0,-21
16687,0,0,110,0,-110
16688,0,0,27,0,-27
16689,1,1,736,1467,731
16690,0,0,61,0,-61
16691,0,0,4,0,-4
16692,1,0,2,0,-2
16693,1,0,61,0,-61
16694,1,0,19,0,-19
16695,0,0,16,0,-16
16696,1,1,1620,1489,-131
16697,1,1,690,1896,1206
16698,1,1,433,1329,896
16699,1,0,22,0,-22
16700,0,0,1,0,-1
16701,0,0,15,0,-15
16702,1,1,400,1359,959
16703,0,0,227,0,-227
16704,0,0,25,0,-25
16705,0,0,46,0,-46
16706,1,0,21,0,-21
16707,1,1,66,1241,1175
16708,1,0,54,0,-54
16709,0,0,46,0,-46
16710,1,0,39,0,-39
16711,1,0,46,0,-46
16712,1,0,102,0,-102
16713,0,0,303,0,-303
16714,1,0,17,0,-17
16715,1,0,9,0,-9
16716,0,0,28,0,-28
16717,1,1,140,1270,1130
16718,0,0,44,0,-44
16719,1,0,46,0,-46
16720,1,0,1,0,-1
16721,1,0,21,0,-21
16722,0,0,7,0,-7
16723,0,0,39,0,-39
16724,1,1,40,2624,2584
16725,1,0,8,0,-8
16726,1,1,1064,1584,520
16727,1,1,559,2193,1634
16728,1,1,190,1355,1165
16729,1,0,12,0,-12
16730,1,0,266,0,-266
16731,1,1,1375,1661,286
16732,0,0,29,0,-29
16733,1,1,207,1844,1637
16734,1,0,50,0,-50
16735,1,0,19,0,-19
16736,1,0,5,0,-5
16737,1,0,7,0,-7
16738,1,0,26,0,-26
16739,1,1,1627,1302,-325
16740,0,0,59,0,-59
16741,1,1,372,1593,1221
16742,0,0,4,0,-4
16743,1,0,11,0,-11
16744,0,0,104,0,-104
16745,1,1,471,1733,1262
16746,0,0,18,0,-18
16747,1,0,215,0,-215
16748,0,0,25,0,-25
16749,1,0,22,0,-22
16750,1,0,58,0,-58
16751,1,0,10,0,-10
16752,1,1,1371,1275,-96
16753,1,0,21,0,-21
16754,1,0,40,0,-40
16755,1,0,17,0,-17
16756,1,0,77,0,-77
16757,1,0,0,0,0
16758,1,0,107,0,-107
16759,1,0,32,0,-32
16760,1,0,16,0,-16
16761,1,0,52,0,-52
16762,0,0,67,0,-67
16763,0,0,36,0,-36
16764,1,1,3530,2530,-1000
16765,1,0,13,0,-13
16766,0,0,15,0,-15
16767,1,0,25,0,-25
16768,1,0,41,0,-41
16769,0,0,137,0,-137
16770,0,0,36,0,-36
16771,0,0,2,0,-2
16772,0,0,1,0,-1
16773,0,0,20,0,-20
16774,1,0,15,0,-15
16775,0,0,53,0,-53
16776,0,0,45,0,-45
16777,0,0,62,0,-62
16778,0,0,50,0,-50
16779,0,0,98,0,-98
16780,0,0,25,0,-25
16781,1,1,1840,1247,-593
16782,0,0,44,0,-44
16783,0,0,39,0,-39
16784,0,0,12,0,-12
16785,0,0,106,0,-106
16786,0,0,110,0,-110
16787,1,1,156,2394,2238
16788,1,0,193,0,-193
16789,1,0,45,0,-45
16790,1,0,22,0,-22
16791,1,1,98,1533,1435
16792,1,1,470,1240,770
16793,1,0,2,0,-2
16794,0,0,55,0,-55
16795,0,0,36,0,-36
16796,0,0,58,0,-58
16797,0,0,42,0,-42
16798,1,1,392,1763,1371
16799,1,0,15,0,-15
16800,1,1,205,6328,6123
16801,0,0,52,0,-52
16802,0,0,14,0,-14
16803,0,0,55,0,-55
16804,1,1,177,1247,1070
16805,1,0,108,0,-108
16806,1,0,135,0,-135
16807,0,0,103,0,-103
16808,1,0,37,0,-37
16809,0,0,12,0,-12
16810,1,1,244,1312,1068
16811,1,0,67,0,-67
16812,1,0,24,0,-24
16813,0,0,11,0,-11
16814,1,0,20,0,-20
16815,0,0,7,0,-7
16816,1,1,236,1719,1483
16817,0,0,42,0,-42
16818,0,0,148,0,-148
16819,0,0,106,0,-106
16820,0,0,65,0,-65
16821,1,0,22,0,-22
16822,1,0,83,0,-83
16823,0,0,157,0,-157
16824,1,0,26,0,-26
16825,1,1,1501,3676,2175
16826,0,0,49,0,-49
16827,0,0,41,0,-41
16828,1,1,633,3402,2769
16829,1,0,1,0,-1
16830,0,0,68,0,-68
16831,1,1,131,1441,1310
16832,0,0,41,0,-41
16833,0,0,30,0,-30
16834,0,0,105,0,-105
16835,1,0,20,0,-20
16836,1,1,700,1275,575
16837,0,0,3,0,-3
16838,1,1,607,1467,860
16839,1,0,19,0,-19
16840,1,0,33,0,-33
16841,1,0,7,0,-7
16842,1,1,194,2201,2007
16843,1,1,369,2393,2024
16844,1,0,13,0,-13
16845,1,0,62,0,-62
16846,1,1,127,1421,1294
16847,0,0,60,0,-60
16848,0,0,12,0,-12
16849,1,1,119,1796,1677
16850,1,1,754,1296,542
16851,1,0,53,0,-53
16852,1,0,34,0,-34
16853,0,0,55,0,-55
16854,1,1,1578,1373,-205
16855,0,0,6,0,-6
16856,1,1,286,1352,1066
16857,0,0,11,0,-11
16858,1,0,34,0,-34
16859,0,0,73,0,-73
16860,0,0,191,0,-191
16861,1,1,500,1750,1250
16862,1,0,76,0,-76
16863,1,1,93,6048,5955
16864,1,1,333,1579,1246
16865,1,0,74,0,-74
16866,0,0,51,0,-51
16867,1,1,521,2934,2413
16868,1,1,71,1359,1288
16869,0,0,9,0,-9
16870,0,0,10,0,-10
16871,0,0,44,0,-44
16872,0,0,14,0,-14
16873,1,0,17,0,-17
16874,1,1,859,2686,1827
16875,1,1,600,1621,1021
16876,0,0,20,0,-20
16877,1,1,219,1476,1257
16878,1,1,1843,1517,-326
16879,1,0,13,0,-13
16880,0,0,27,0,-27
16881,1,1,779,1365,586
16882,0,0,37,0,-37
16883,0,0,130,0,-130
16884,0,0,8,0,-8
16885,0,0,3,0,-3
16886,0,0,35,0,-35
16887,0,0,8,0,-8
16888,1,1,169,1306,1137
16889,1,1,1565,5183,3618
16890,0,0,15,0,-15
16891,0,0,56,0,-56
16892,1,1,140,1641,1501
16893,1,1,136,1312,1176
16894,1,1,1453,1840,387
16895,0,0,209,0,-209
16896,1,1,234,2727,2493
16897,1,0,56,0,-56
16898,1,0,9,0,-9
16899,0,0,31,0,-31
16900,1,1,79,1302,1223
16901,1,1,191,1311,1120
16902,0,0,55,0,-55
16903,0,0,22,0,-22
16904,1,1,212,1388,1176
16905,1,1,343,1959,1616
16906,1,1,200,1266,1066
16907,1,1,773,1881,1108
16908,0,0,161,0,-161
16909,1,0,16,0,-16
16910,1,0,40,0,-40
16911,1,0,4,0,-4
16912,1,1,433,1829,1396
16913,1,0,65,0,-65
16914,1,1,636,1455,819
16915,0,0,0,0,0
16916,1,1,378,1430,1052
16917,1,0,11,0,-11
16918,1,0,27,0,-27
16919,1,0,59,0,-59
16920,1,1,122,1454,1332
16921,0,0,9,0,-9
16922,1,0,50,0,-50
16923,1,1,522,1447,925
16924,1,0,107,0,-107
16925,0,0,37,0,-37
16926,0,0,33,0,-33
16927,1,0,14,0,-14
16928,1,1,110,1269,1159
16929,1,1,203,1426,1223
16930,0,0,137,0,-137
16931,0,0,105,0,-105
16932,1,1,18,1561,1543
16933,0,0,141,0,-141
16934,0,0,21,0,-21
16935,1,1,911,1323,412
16936,1,0,105,0,-105
16937,1,1,102,1745,1643
16938,1,0,20,0,-20
16939,1,0,196,0,-196
16940,1,0,37,0,-37
16941,1,0,22,0,-22
16942,1,0,81,0,-81
16943,0,0,74,0,-74
16944,1,0,27,0,-27
16945,1,1,364,1277,913
16946,1,1,494,1323,829
16947,1,0,29,0,-29
16948,1,0,4,0,-4
16949,1,0,10,0,-10
16950,1,0,0,0,0
16951,1,1,957,1374,417
16952,1,1,362,1523,1161
16953,1,1,125,1295,1170
16954,1,0,130,0,-130
16955,0,0,35,0,-35
16956,1,0,37,0,-37
16957,0,0,82,0,-82
16958,0,0,122,0,-122
16959,1,1,592,1412,820
16960,1,1,376,1302,926
16961,1,0,42,0,-42
16962,0,0,139,0,-139
16963,0,0,28,0,-28
16964,1,1,1807,1271,-536
16965,1,1,150,1579,1429
16966,1,0,44,0,-44
16967,1,1,374,1398,1024
16968,1,0,10,0,-10
16969,1,1,379,1818,1439
16970,0,0,24,0,-24
16971,1,0,21,0,-21
16972,0,0,10,0,-10
16973,1,0,31,0,-31
16974,0,0,74,0,-74
16975,1,0,125,0,-125
16976,0,0,180,0,-180
16977,0,0,32,0,-32
16978,1,0,47,0,-47
16979,0,0,91,0,-91
16980,1,0,26,0,-26
16981,0,0,45,0,-45
16982,0,0,2,0,-2
16983,0,0,101,0,-101
16984,0,0,138,0,-138
16985,1,1,175,1411,1236
16986,0,0,6,0,-6
16987,0,0,78,0,-78
16988,1,0,4,0,-4
16989,1,0,28,0,-28
16990,1,1,1133,1823,690
16991,1,0,50,0,-50
16992,1,1,1723,1243,-480
16993,0,0,119,0,-119
16994,1,0,106,0,-106
16995,1,0,82,0,-82
16996,1,1,314,1669,1355
16997,0,0,215,0,-215
16998,0,0,24,0,-24
16999,1,1,519,1328,809
17000,1,0,15,0,-15
17001,1,1,102,1468,1366
17002,0,0,91,0,-91
17003,1,1,1294,1365,71
17004,0,0,27,0,-27
17005,0,0,104,0,-104
17006,1,1,383,1782,1399
17007,0,0,89,0,-89
17008,0,0,117,0,-117
17009,0,0,85,0,-85
17010,1,1,858,2377,1519
17011,1,1,934,2617,1683
17012,0,0,9,0,-9
17013,0,0,5,0,-5
17014,0,0,4,0,-4
17015,1,1,48,1523,1475
17016,1,0,53,0,-53
17017,1,1,167,1616,1449
17018,1,0,48,0,-48
17019,0,0,83,0,-83
17020,1,0,46,0,-46
17021,1,1,589,1416,827
17022,1,1,12,1351,1339
17023,1,1,2152,2442,290
17024,1,1,1219,3360,2141
17025,1,1,142,1368,1226
17026,1,1,355,1256,901
17027,0,0,128,0,-128
17028,0,0,99,0,-99
17029,1,0,129,0,-129
17030,0,0,101,0,-101
17031,1,0,19,0,-19
17032,1,0,30,0,-30
17033,0,0,96,0,-96
17034,1,0,8,0,-8
17035,0,0,1,0,-1
17036,0,0,46,0,-46
17037,1,1,334,1290,956
17038,1,1,359,1525,1166
17039,1,0,163,0,-163
17040,1,1,485,1318,833
17041,0,0,251,0,-251
17042,0,0,34,0,-34
17043,1,1,880,1621,741
17044,0,0,83,0,-83
17045,1,1,318,1241,923
17046,1,1,138,1293,1155
17047,1,0,16,0,-16
17048,1,0,4,0,-4
17049,0,0,125,0,-125
17050,0,0,190,0,-190
17051,1,1,321,1470,1149
17052,0,0,14,0,-14
17053,0,0,97,0,-97
17054,1,0,34,0,-34
17055,1,0,10,0,-10
17056,1,1,175,1831,1656
17057,0,0,88,0,-88
17058,1,0,82,0,-82
17059,0,0,1,0,-1
17060,0,0,22,0,-22
17061,1,0,53,0,-53
17062,0,0,19,0,-19
17063,1,1,868,2004,1136
17064,0,0,20,0,-20
17065,1,0,0,0,0
17066,1,1,377,1333,956
17067,1,1,349,3782,3433
17068,1,1,660,1585,925
17069,1,0,79,0,-79
17070,1,1,265,1612,1347
17071,1,1,361,2095,1734
17072,1,1,1009,1374,365
17073,0,0,72,0,-72
17074,1,1,268,1454,1186
17075,1,0,17,0,-17
17076,0,0,9,0,-9
17077,0,0,105,0,-105
17078,1,0,43,0,-43
17079,1,1,68,1912,1844
17080,1,0,73,0,-73
17081,0,0,8,0,-8
17082,1,1,912,1297,385
17083,1,0,21,0,-21
17084,0,0,117,0,-117
17085,1,1,268,1624,1356
17086,1,1,86,1713,1627
17087,1,1,304,1382,1078
17088,1,0,0,0,0
17089,0,0,7,0,-7
17090,0,0,19,0,-19
17091,0,0,38,0,-38
17092,1,1,249,1658,1409
17093,0,0,11,0,-11
17094,1,0,12,0,-12
17095,0,0,91,0,-91
17096,1,0,9,0,-9
17097,0,0,4,0,-4
17098,1,0,16,0,-16
17099,1,0,133,0,-133
17100,0,0,50,0,-50
17101,0,0,6,0,-6
17102,0,0,33,0,-33
17103,0,0,171,0,-171
17104,0,0,30,0,-30
17105,1,0,78,0,-78
17106,1,0,64,0,-64
17107,0,0,74,0,-74
17108,1,1,602,1679,1077
17109,0,0,62,0,-62
17110,0,0,81,0,-81
17111,1,0,79,0,-79
17112,1,1,353,3258,2905
17113,1,0,24,0,-24
17114,0,0,146,0,-146
17115,1,0,50,0,-50
17116,1,0,232,0,-232
17117,1,0,5,0,-5
17118,0,0,5,0,-5
17119,1,1,452,1316,864
17120,0,0,98,0,-98
17121,1,0,3,0,-3
17122,1,1,532,1420,888
17123,0,0,11,0,-11
17124,0,0,17,0,-17
17125,0,0,27,0,-27
17126,1,0,43,0,-43
17127,1,0,20,0,-20
17128,0,0,29,0,-29
17129,0,0,47,0,-47
17130,1,1,85,1490,1405
17131,1,1,932,1675,743
17132,1,1,486,1298,812
17133,1,0,48,0,-48
17134,1,0,45,0,-45
17135,0,0,79,0,-79
17136,1,1,176,1316,1140
17137,0,0,15,0,-15
17138,1,0,4,0,-4
17139,1,0,29,0,-29
17140,0,0,22,0,-22
17141,0,0,74,0,-74
17142,1,1,254,1330,1076
17143,1,0,34,0,-34
17144,1,1,131,1430,1299
17145,1,1,834,2082,1248
17146,1,1,1117,1428,311
17147,0,0,61,0,-61
17148,0,0,41,0,-41
17149,1,0,105,0,-105
17150,1,1,194,1760,1566
17151,0,0,3,0,-3
17152,1,1,529,1274,745
17153,1,1,528,1240,712
17154,0,0,11,0,-11
17155,1,0,117,0,-117
17156,1,1,833,1301,468
17157,0,0,78,0,-78
17158,0,0,44,0,-44
17159,0,0,3,0,-3
17160,1,0,6,0,-6
17161,1,1,298,1552,1254
17162,1,1,153,1254,1101
17163,1,1,562,1709,1147
17164,0,0,4,0,-4
17165,1,0,139,0,-139
17166,0,0,14,0,-14
17167,1,1,896,1689,793
17168,0,0,125,0,-125
17169,0,0,61,0,-61
17170,0,0,132,0,-132
17171,1,1,452,1923,1471
17172,1,0,31,0,-31
17173,0,0,59,0,-59
17174,1,1,667,1829,1162
17175,0,0,34,0,-34
17176,0,0,35,0,-35
17177,0,0,14,0,-14
17178,1,0,99,0,-99
17179,1,1,1090,1532,442
17180,1,0,93,0,-93
17181,0,0,10,0,-10
17182,1,0,60,0,-60
17183,1,1,577,1381,804
17184,1,1,361,1564,1203
17185,1,0,13,0,-13
17186,1,1,332,1302,970
17187,1,1,443,1311,868
17188,0,0,59,0,-59
17189,1,0,24,0,-24
17190,0,0,34,0,-34
17191,1,1,150,1278,1128
17192,1,1,29,1840,1811
17193,0,0,113,0,-113
17194,1,0,121,0,-121
17195,0,0,101,0,-101
17196,1,1,425,1893,1468
17197,1,1,54,1464,1410
17198,1,0,73,0,-73
17199,1,1,144,2877,2733
17200,0,0,138,0,-138
17201,1,1,116,1267,1151
17202,0,0,128,0,-128
17203,0,0,36,0,-36
17204,1,0,4,0,-4
17205,1,1,785,1236,451
17206,0,0,20,0,-20
17207,1,0,36,0,-36
17208,0,0,2,0,-2
17209,0,0,62,0,-62
17210,0,0,95,0,-95
17211,1,1,289,1628,1339
17212,1,0,56,0,-56
17213,0,0,216,0,-216
17214,1,1,105,1834,1729
17215,0,0,7,0,-7
17216,0,0,89,0,-89
17217,0,0,26,0,-26
17218,1,0,41,0,-41
17219,0,0,114,0,-114
17220,0,0,1,0,-1
17221,1,0,32,0,-32
17222,0,0,35,0,-35
17223,0,0,46,0,-46
17224,0,0,95,0,-95
17225,1,1,564,1356,792
17226,1,1,379,1528,1149
17227,0,0,194,0,-194
17228,1,0,15,0,-15
17229,0,0,16,0,-16
17230,1,1,487,2048,1561
17231,0,0,62,0,-62
17232,0,0,117,0,-117
17233,1,1,85,1285,1200
17234,0,0,41,0,-41
17235,1,0,46,0,-46
17236,0,0,13,0,-13
17237,1,1,478,1322,844
17238,0,0,36,0,-36
17239,0,0,12,0,-12
17240,0,0,14,0,-14
17241,1,0,5,0,-5
17242,0,0,37,0,-37
17243,0,0,17,0,-17
17244,1,1,1030,2489,1459
17245,0,0,68,0,-68
17246,0,0,24,0,-24
17247,0,0,17,0,-17
17248,1,1,1260,1332,72
17249,0,0,7,0,-7
17250,0,0,15,0,-15
17251,0,0,2,0,-2
17252,0,0,48,0,-48
17253,1,0,0,0,0
17254,1,0,16,0,-16
17255,1,0,72,0,-72
17256,0,0,16,0,-16
17257,1,0,82,0,-82
17258,1,1,588,1735,1147
17259,1,1,593,1909,1316
17260,0,0,67,0,-67
17261,1,1,41,1257,1216
17262,0,0,18,0,-18
17263,0,0,52,0,-52
17264,0,0,41,0,-41
17265,0,0,3,0,-3
17266,1,0,4,0,-4
17267,1,1,142,1239,1097
17268,0,0,156,0,-156
17269,1,0,40,0,-40
17270,1,0,56,0,-56
17271,0,0,10,0,-10
17272,0,0,54,0,-54
17273,0,0,13,0,-13
17274,0,0,166,0,-166
17275,1,0,7,0,-7
17276,1,0,4,0,-4
17277,1,1,415,1269,854
17278,1,1,690,1416,726
17279,1,0,66,0,-66
17280,0,0,109,0,-109
17281,0,0,37,0,-37
17282,1,0,23,0,-23
17283,1,1,255,1265,1010
17284,1,0,25,0,-25
17285,0,0,123,0,-123
17286,1,1,1384,1653,269
17287,1,1,1156,1266,110
17288,1,0,47,0,-47
17289,1,0,53,0,-53
17290,0,0,38,0,-38
17291,1,1,247,1618,1371
17292,0,0,14,0,-14
17293,0,0,4,0,-4
17294,0,0,76,0,-76
17295,1,1,499,1301,802
17296,1,1,271,1244,973
17297,1,0,113,0,-113
17298,1,1,967,1865,898
17299,0,0,49,0,-49
17300,1,1,1284,1718,434
17301,1,0,0,0,0
17302,0,0,5,0,-5
17303,1,0,38,0,-38
17304,1,0,71,0,-71
17305,1,1,1490,2295,805
17306,0,0,10,0,-10
17307,1,0,192,0,-192
17308,1,1,1260,1318,58
17309,0,0,20,0,-20
17310,0,0,2,0,-2
17311,1,1,666,1954,1288
17312,1,0,34,0,-34
17313,1,0,26,0,-26
17314,1,1,530,1592,1062
17315,0,0,86,0,-86
17316,1,1,555,1291,736
17317,0,0,51,0,-51
17318,1,1,1748,1267,-481
17319,1,1,54,1493,1439
17320,1,1,656,1300,644
17321,0,0,13,0,-13
17322,1,1,2734,1907,-827
17323,0,0,52,0,-52
17324,0,0,28,0,-28
17325,1,0,16,0,-16
17326,1,1,819,1662,843
17327,1,1,1212,1518,306
17328,0,0,113,0,-113
17329,0,0,42,0,-42
17330,0,0,8,0,-8
17331,1,0,188,0,-188
17332,1,1,872,2088,1216
17333,1,1,697,1364,667
17334,0,0,54,0,-54
17335,0,0,17,0,-17
17336,0,0,22,0,-22
17337,0,0,125,0,-125
17338,1,0,2,0,-2
17339,0,0,74,0,-74
17340,0,0,21,0,-21
17341,0,0,78,0,-78
17342,1,1,99,1398,1299
17343,0,0,31,0,-31
17344,1,1,514,1435,921
17345,0,0,14,0,-14
17346,0,0,131,0,-131
17347,0,0,54,0,-54
17348,0,0,80,0,-80
17349,0,0,40,0,-40
17350,0,0,3,0,-3
17351,1,1,18,2116,2098
17352,0,0,33,0,-33
17353,1,0,39,0,-39
17354,0,0,28,0,-28
17355,1,1,1600,1788,188
17356,1,0,5,0,-5
17357,1,1,244,1546,1302
17358,0,0,28,0,-28
17359,1,0,42,0,-42
17360,1,0,160,0,-160
17361,1,1,232,1440,1208
17362,0,0,49,0,-49
17363,0,0,43,0,-43
17364,1,0,10,0,-10
17365,0,0,177,0,-177
17366,0,0,35,0,-35
17367,0,0,160,0,-160
17368,1,1,513,1862,1349
17369,1,0,47,0,-47
17370,1,0,10,0,-10
17371,1,0,77,0,-77
17372,1,0,43,0,-43
17373,1,1,1144,1294,150
17374,1,0,35,0,-35
17375,1,1,12,1526,1514
17376,0,0,45,0,-45
17377,1,1,841,2100,1259
17378,1,1,261,1407,1146
17379,0,0,43,0,-43
17380,0,0,17,0,-17
17381,1,1,434,1753,1319
17382,0,0,114,0,-114
17383,1,0,128,0,-128
17384,1,1,2072,1280,-792
17385,1,1,490,1341,851
17386,0,0,6,0,-6
17387,1,0,9,0,-9
17388,0,0,157,0,-157
17389,1,0,27,0,-27
17390,0,0,33,0,-33
17391,1,1,689,1658,969
17392,1,0,92,0,-92
17393,1,1,719,1489,770
17394,1,0,26,0,-26
17395,1,1,1067,1988,921
17396,1,0,33,0,-33
17397,1,0,135,0,-135
17398,0,0,7,0,-7
17399,0,0,40,0,-40
17400,1,0,147,0,-147
17401,0,0,44,0,-44
17402,0,0,120,0,-120
17403,1,1,277,1787,1510
17404,0,0,41,0,-41
17405,1,1,458,2007,1549
17406,1,1,735,2663,1928
17407,0,0,68,0,-68
17408,1,0,1,0,-1
17409,1,0,12,0,-12
17410,0,0,121,0,-121
17411,1,1,371,2980,2609
17412,0,0,13,0,-13
17413,1,1,900,2205,1305
17414,0,0,44,0,-44
17415,0,0,139,0,-139
17416,1,1,70,1275,1205
17417,1,0,3,0,-3
17418,1,0,123,0,-123
17419,1,1,639,1334,695
17420,1,0,70,0,-70
17421,1,1,349,5125,4776
17422,1,1,1121,1280,159
17423,0,0,14,0,-14
17424,1,0,25,0,-25
17425,0,0,225,0,-225
17426,1,1,337,1776,1439
17427,0,0,0,0,0
17428,1,1,2672,1375,-1297
17429,1,0,3,0,-3
17430,1,0,6,0,-6
17431,0,0,41,0,-41
17432,1,1,1110,1680,570
17433,0,0,2,0,-2
17434,1,1,1794,1377,-417
17435,1,1,429,1581,1152
17436,0,0,10,0,-10
17437,0,0,7,0,-7
17438,1,0,112,0,-112
17439,1,0,11,0,-11
17440,0,0,13,0,-13
17441,0,0,32,0,-32
17442,0,0,22,0,-22
17443,0,0,63,0,-63
17444,1,1,377,1250,873
17445,0,0,168,0,-168
17446,1,0,8,0,-8
17447,1,1,1007,1342,335
17448,0,0,57,0,-57
17449,1,1,525,1369,844
17450,1,0,0,0,0
17451,0,0,33,0,-33
17452,0,0,92,0,-92
17453,1,1,1245,1351,106
17454,1,0,207,0,-207
17455,0,0,10,0,-10
17456,1,0,110,0,-110
17457,0,0,22,0,-22
17458,0,0,18,0,-18
17459,1,0,44,0,-44
17460,0,0,34,0,-34
17461,0,0,14,0,-14
17462,0,0,21,0,-21
17463,1,0,28,0,-28
17464,1,0,31,0,-31
17465,1,0,4,0,-4
17466,0,0,48,0,-48
17467,0,0,76,0,-76
17468,1,1,495,1724,1229
17469,1,0,108,0,-108
17470,1,1,634,2166,1532
17471,1,1,255,2007,1752
17472,1,0,25,0,-25
17473,0,0,8,0,-8
17474,1,0,10,0,-10
17475,1,1,401,1409,1008
17476,0,0,9,0,-9
17477,1,1,78,1687,1609
17478,1,0,58,0,-58
17479,1,0,30,0,-30
17480,0,0,154,0,-154
17481,1,1,212,1445,1233
17482,0,0,96,0,-96
17483,1,0,153,0,-153
17484,1,1,199,1660,1461
17485,1,0,6,0,-6
17486,0,0,81,0,-81
17487,0,0,53,0,-53
17488,0,0,13,0,-13
17489,1,1,319,1344,1025
17490,0,0,278,0,-278
17491,1,0,80,0,-80
17492,1,1,570,1882,1312
17493,0,0,10,0,-10
17494,1,0,87,0,-87
17495,0,0,1,0,-1
17496,1,1,1213,1882,669
17497,0,0,20,0,-20
17498,1,0,59,0,-59
17499,0,0,64,0,-64
17500,1,1,949,1630,681
17501,0,0,8,0,-8
17502,1,0,1,0,-1
17503,0,0,23,0,-23
17504,1,1,371,1443,1072
17505,1,1,200,1283,1083
17506,1,0,7,0,-7
17507,1,0,93,0,-93
17508,0,0,119,0,-119
17509,1,0,79,0,-79
17510,1,0,0,0,0
17511,0,0,9,0,-9
17512,1,1,742,1283,541
17513,1,1,808,1340,532
17514,0,0,28,0,-28
17515,1,0,28,0,-28
17516,1,0,78,0,-78
17517,1,1,68,1489,1421
17518,1,0,43,0,-43
17519,0,0,23,0,-23
17520,1,1,1100,1411,311
17521,1,1,963,1891,928
17522,1,1,202,1496,1294
17523,1,0,7,0,-7
17524,1,0,84,0,-84
17525,1,0,137,0,-137
17526,0,0,25,0,-25
17527,0,0,27,0,-27
17528,1,1,744,1928,1184
17529,1,1,403,3443,3040
17530,0,0,22,0,-22
17531,0,0,33,0,-33
17532,1,1,65,3274,3209
17533,1,0,118,0,-118
17534,1,1,586,1651,1065
17535,1,0,78,0,-78
17536,0,0,5,0,-5
17537,0,0,198,0,-198
17538,0,0,7,0,-7
17539,1,0,166,0,-166
17540,0,0,10,0,-10
17541,0,0,37,0,-37
17542,1,1,647,1365,718
17543,0,0,16,0,-16
17544,1,0,2,0,-2
17545,1,0,34,0,-34
17546,1,0,2,0,-2
17547,1,0,114,0,-114
17548,1,1,128,3189,3061
17549,0,0,64,0,-64
17550,1,0,139,0,-139
17551,0,0,36,0,-36
17552,1,1,1587,1845,258
17553,1,0,59,0,-59
17554,1,0,44,0,-44
17555,1,1,654,1314,660
17556,1,0,24,0,-24
17557,1,1,17,1422,1405
17558,0,0,84,0,-84
17559,0,0,51,0,-51
17560,0,0,25,0,-25
17561,1,0,300,0,-300
17562,0,0,98,0,-98
17563,0,0,125,0,-125
17564,0,0,5,0,-5
17565,0,0,92,0,-92
17566,1,0,52,0,-52
17567,1,0,24,0,-24
17568,0,0,43,0,-43
17569,1,0,11,0,-11
17570,1,0,47,0,-47
17571,0,0,151,0,-151
17572,0,0,32,0,-32
17573,1,1,765,1362,597
17574,0,0,0,0,0
17575,1,0,42,0,-42
17576,0,0,2,0,-2
17577,1,0,137,0,-137
17578,1,0,35,0,-35
17579,0,0,60,0,-60
17580,0,0,19,0,-19
17581,0,0,70,0,-70
17582,1,0,63,0,-63
17583,1,0,49,0,-49
17584,1,0,79,0,-79
17585,1,1,1211,1786,575
17586,1,0,48,0,-48
17587,1,0,6,0,-6
17588,0,0,26,0,-26
17589,0,0,4,0,-4
17590,0,0,43,0,-43
17591,0,0,60,0,-60
17592,0,0,20,0,-20
17593,0,0,4,0,-4
17594,1,1,928,1546,618
17595,0,0,45,0,-45
17596,0,0,76,0,-76
17597,0,0,5,0,-5
17598,0,0,156,0,-156
17599,1,1,141,2224,2083
17600,0,0,64,0,-64
17601,1,0,151,0,-151
17602,0,0,3,0,-3
17603,1,1,47,5615,5568
17604,1,0,8,0,-8
17605,0,0,12,0,-12
17606,0,0,4,0,-4
17607,1,1,283,1607,1324
17608,0,0,18,0,-18
17609,0,0,11,0,-11
17610,0,0,139,0,-139
17611,1,1,248,1427,1179
17612,1,1,34,1470,1436
17613,0,0,131,0,-131
17614,1,0,48,0,-48
17615,0,0,123,0,-123
17616,1,0,7,0,-7
17617,0,0,18,0,-18
17618,1,0,10,0,-10
17619,0,0,111,0,-111
17620,1,1,332,2696,2364
17621,0,0,75,0,-75
17622,1,0,0,0,0
17623,1,1,458,4400,3942
17624,1,1,1299,1303,4
17625,0,0,25,0,-25
17626,0,0,108,0,-108
17627,1,1,611,1999,1388
17628,0,0,65,0,-65
17629,1,1,1655,1490,-165
17630,0,0,17,0,-17
17631,0,0,3,0,-3
17632,0,0,65,0,-65
17633,1,1,414,1372,958
17634,0,0,58,0,-58
17635,1,1,709,1457,748
17636,1,1,500,1385,885
17637,1,1,160,1274,1114
17638,1,0,24,0,-24
17639,0,0,24,0,-24
17640,0,0,12,0,-12
17641,1,1,739,1450,711
17642,1,0,31,0,-31
17643,1,1,880,1890,1010
17644,1,0,30,0,-30
17645,1,1,1560,2160,600
17646,1,0,211,0,-211
17647,1,1,77,1426,1349
17648,1,1,254,1303,1049
17649,0,0,40,0,-40
17650,0,0,0,0,0
17651,1,1,284,1322,1038
17652,1,0,6,0,-6
17653,0,0,78,0,-78
17654,1,1,243,1709,1466
17655,0,0,108,0,-108
17656,1,0,18,0,-18
17657,0,0,32,0,-32
17658,0,0,154,0,-154
17659,1,0,177,0,-177
17660,0,0,10,0,-10
17661,1,0,14,0,-14
17662,1,0,47,0,-47
17663,1,0,7,0,-7
17664,1,0,62,0,-62
17665,1,0,153,0,-153
17666,0,0,97,0,-97
17667,0,0,25,0,-25
17668,0,0,29,0,-29
17669,0,0,9,0,-9
17670,0,0,4,0,-4
17671,0,0,47,0,-47
17672,0,0,59,0,-59
17673,1,0,78,0,-78
17674,0,0,111,0,-111
17675,1,1,267,1436,1169
17676,0,0,26,0,-26
17677,0,0,4,0,-4
17678,0,0,70,0,-70
17679,0,0,94,0,-94
17680,1,1,1985,1873,-112
17681,1,1,1398,1773,375
17682,1,0,51,0,-51
17683,0,0,1,0,-1
17684,1,1,748,1352,604
17685,1,1,891,1746,855
17686,0,0,2,0,-2
17687,0,0,115,0,-115
17688,0,0,5,0,-5
17689,0,0,143,0,-143
17690,0,0,114,0,-114
17691,1,0,2,0,-2
17692,1,0,3,0,-3
17693,1,1,571,1538,967
17694,1,1,234,1388,1154
17695,0,0,26,0,-26
17696,0,0,124,0,-124
17697,0,0,101,0,-101
17698,0,0,30,0,-30
17699,1,1,1313,1324,11
17700,1,0,15,0,-15
17701,0,0,143,0,-143
17702,0,0,20,0,-20
17703,1,0,15,0,-15
17704,1,1,1633,1642,9
17705,1,0,156,0,-156
17706,1,0,58,0,-58
17707,1,0,98,0,-98
17708,0,0,10,0,-10
17709,1,1,750,1576,826
17710,0,0,96,0,-96
17711,1,0,4,0,-4
17712,0,0,164,0,-164
17713,0,0,36,0,-36
17714,1,0,11,0,-11
17715,1,1,542,1920,1378
17716,0,0,57,0,-57
17717,1,0,52,0,-52
17718,0,0,90,0,-90
17719,1,0,20,0,-20
17720,1,0,56,0,-56
17721,1,0,62,0,-62
17722,0,0,6,0,-6
17723,1,0,22,0,-22
17724,1,0,67,0,-67
17725,1,0,86,0,-86
17726,0,0,1,0,-1
17727,0,0,57,0,-57
17728,1,1,1871,1657,-214
17729,1,0,23,0,-23
17730,1,1,1141,1345,204
17731,0,0,43,0,-43
17732,0,0,91,0,-91
17733,0,0,48,0,-48
17734,1,0,111,0,-111
17735,0,0,73,0,-73
17736,0,0,12,0,-12
17737,1,1,434,1573,1139
17738,1,0,33,0,-33
17739,1,0,50,0,-50
17740,0,0,48,0,-48
17741,1,1,186,2170,1984
17742,1,1,587,2809,2222
17743,0,0,32,0,-32
17744,1,1,542,1600,1058
17745,0,0,1,0,-1
17746,1,0,5,0,-5
17747,0,0,29,0,-29
17748,1,1,137,1686,1549
17749,0,0,81,0,-81
17750,1,1,178,1317,1139
17751,1,0,4,0,-4
17752,0,0,45,0,-45
17753,0,0,10,0,-10
17754,0,0,35,0,-35
17755,0,0,123,0,-123
17756,1,0,18,0,-18
17757,1,1,305,2155,1850
17758,0,0,150,0,-150
17759,1,1,235,1456,1221
17760,0,0,148,0,-148
17761,1,0,16,0,-16
17762,1,0,66,0,-66
17763,1,1,161,1497,1336
17764,0,0,39,0,-39
17765,1,1,260,1256,996
17766,1,1,122,1272,1150
17767,0,0,4,0,-4
17768,1,1,1670,1492,-178
17769,1,1,558,3279,2721
17770,1,1,239,1348,1109
17771,1,1,188,1420,1232
17772,1,1,116,1966,1850
17773,0,0,9,0,-9
17774,1,0,16,0,-16
17775,0,0,41,0,-41
17776,1,1,237,1240,1003
17777,1,0,42,0,-42
17778,0,0,17,0,-17
17779,0,0,111,0,-111
17780,0,0,14,0,-14
17781,1,0,16,0,-16
17782,0,0,82,0,-82
17783,1,0,63,0,-63
17784,0,0,28,0,-28
17785,0,0,0,0,0
17786,1,0,34,0,-34
17787,1,0,91,0,-91
17788,1,1,1946,1452,-494
17789,0,0,22,0,-22
17790,0,0,58,0,-58
17791,0,0,6,0,-6
17792,0,0,49,0,-49
17793,1,0,67,0,-67
17794,1,0,18,0,-18
17795,1,0,25,0,-25
17796,0,0,255,0,-255
17797,1,0,129,0,-129
17798,0,0,48,0,-48
17799,0,0,4,0,-4
17800,1,1,1326,1951,625
17801,1,1,218,1999,1781
17802,1,1,570,1469,899
17803,0,0,108,0,-108
17804,1,1,126,1252,1126
17805,1,1,284,1418,1134
17806,0,0,38,0,-38
17807,1,1,715,1511,796
17808,1,1,1172,1337,165
17809,0,0,29,0,-29
17810,0,0,63,0,-63
17811,1,1,463,1268,805
17812,0,0,45,0,-45
17813,0,0,16,0,-16
17814,0,0,81,0,-81
17815,1,0,15,0,-15
17816,1,0,20,0,-20
17817,1,0,45,0,-45
17818,1,0,55,0,-55
17819,1,1,1072,1360,288
17820,1,1,762,1384,622
17821,0,0,12,0,-12
17822,1,1,303,1270,967
17823,1,0,19,0,-19
17824,0,0,5,0,-5
17825,1,1,94,1237,1143
17826,0,0,88,0,-88
17827,1,0,7,0,-7
17828,1,1,213,1497,1284
17829,0,0,49,0,-49
17830,1,1,193,1418,1225
17831,1,0,83,0,-83
17832,1,1,445,1275,830
17833,0,0,24,0,-24
17834,0,0,77,0,-77
17835,1,1,402,2522,2120
17836,0,0,9,0,-9
17837,1,1,2665,3965,1300
17838,0,0,50,0,-50
17839,1,1,849,1256,407
17840,1,0,72,0,-72
17841,1,1,112,1789,1677
17842,0,0,219,0,-219
17843,1,1,72,4885,4813
17844,0,0,6,0,-6
17845,1,0,1,0,-1
17846,1,1,523,1453,930
17847,0,0,73,0,-73
17848,0,0,249,0,-249
17849,0,0,8,0,-8
17850,0,0,8,0,-8
17851,1,0,66,0,-66
17852,1,0,42,0,-42
17853,1,1,296,1252,956
17854,1,1,112,1790,1678
17855,0,0,74,0,-74
17856,1,0,35,0,-35
17857,0,0,32,0,-32
17858,1,1,79,1243,1164
17859,1,1,709,2682,1973
17860,1,1,1254,1328,74
17861,1,0,22,0,-22
17862,1,1,145,1363,1218
17863,0,0,84,0,-84
17864,0,0,26,0,-26
17865,1,0,25,0,-25
17866,1,1,529,1350,821
17867,0,0,114,0,-114
17868,1,1,828,1391,563
17869,0,0,25,0,-25
17870,0,0,68,0,-68
17871,1,0,45,0,-45
17872,1,1,155,1524,1369
17873,1,0,49,0,-49
17874,1,0,6,0,-6
17875,1,1,329,1323,994
17876,1,1,218,1252,1034
17877,1,1,210,1560,1350
17878,1,1,42,1319,1277
17879,1,0,80,0,-80
17880,0,0,8,0,-8
17881,0,0,66,0,-66
17882,1,1,211,1608,1397
17883,0,0,329,0,-329
17884,1,0,23,0,-23
17885,0,0,2,0,-2
17886,0,0,14,0,-14
17887,1,0,26,0,-26
17888,0,0,4,0,-4
17889,1,1,186,1769,1583
17890,1,1,1180,1276,96
17891,1,0,74,0,-74
17892,1,1,988,1385,397
17893,0,0,18,0,-18
17894,1,0,171,0,-171
17895,0,0,10,0,-10
17896,0,0,157,0,-157
17897,0,0,13,0,-13
17898,1,0,151,0,-151
17899,1,0,69,0,-69
17900,1,0,73,0,-73
17901,0,0,45,0,-45
17902,0,0,17,0,-17
17903,1,0,55,0,-55
17904,0,0,80,0,-80
17905,1,0,57,0,-57
17906,1,1,949,1547,598
17907,1,0,13,0,-13
17908,0,0,22,0,-22
17909,1,0,50,0,-50
17910,1,1,162,1511,1349
17911,1,0,2,0,-2
17912,1,1,686,1344,658
17913,0,0,62,0,-62
17914,1,0,6,0,-6
17915,1,1,776,1326,550
17916,0,0,8,0,-8
17917,1,0,91,0,-91
17918,1,0,7,0,-7
17919,1,0,0,0,0
17920,0,0,108,0,-108
17921,0,0,5,0,-5
17922,1,1,273,1371,1098
17923,1,0,2,0,-2
17924,1,1,187,5679,5492
17925,1,1,363,1266,903
17926,1,1,431,1576,1145
17927,0,0,21,0,-21
17928,1,0,276,0,-276
17929,1,0,83,0,-83
17930,1,1,1241,1381,140
17931,1,0,124,0,-124
17932,0,0,31,0,-31
17933,1,1,546,1352,806
17934,1,0,4,0,-4
17935,1,0,12,0,-12
17936,1,0,38,0,-38
17937,1,0,13,0,-13
17938,1,0,27,0,-27
17939,1,0,13,0,-13
17940,1,1,628,1496,868
17941,0,0,2,0,-2
17942,0,0,45,0,-45
17943,1,0,9,0,-9
17944,0,0,313,0,-313
17945,0,0,59,0,-59
17946,1,1,253,1597,1344
17947,1,0,38,0,-38
17948,1,1,186,1776,1590
17949,1,1,353,1499,1146
17950,0,0,3,0,-3
17951,1,1,568,1449,881
17952,0,0,11,0,-11
17953,0,0,75,0,-75
17954,1,1,408,2610,2202
17955,0,0,154,0,-154
17956,0,0,7,0,-7
17957,0,0,44,0,-44
17958,1,0,21,0,-21
17959,1,0,0,0,0
17960,1,0,36,0,-36
17961,1,1,1001,1742,741
17962,0,0,18,0,-18
17963,1,0,55,0,-55
17964,1,0,92,0,-92
17965,0,0,52,0,-52
17966,0,0,34,0,-34
17967,1,0,49,0,-49
17968,1,0,201,0,-201
17969,1,0,30,0,-30
17970,0,0,51,0,-51
17971,0,0,4,0,-4
17972,0,0,87,0,-87
17973,1,0,84,0,-84
17974,0,0,11,0,-11
17975,0,0,32,0,-32
17976,0,0,66,0,-66
17977,1,1,41,1480,1439
17978,1,0,15,0,-15
17979,1,0,39,0,-39
17980,0,0,91,0,-91
17981,0,0,50,0,-50
17982,1,0,62,0,-62
17983,1,0,46,0,-46
17984,0,0,55,0,-55
17985,1,0,198,0,-198
17986,0,0,5,0,-5
17987,1,1,133,1289,1156
17988,1,0,55,0,-55
17989,0,0,154,0,-154
17990,1,0,41,0,-41
17991,1,0,87,0,-87
17992,1,1,952,1480,528
17993,1,1,388,1472,1084
17994,1,0,50,0,-50
17995,1,0,43,0,-43
17996,0,0,39,0,-39
17997,0,0,26,0,-26
17998,1,1,1116,1360,244
17999,1,0,117,0,-117
18000,0,0,75,0,-75
18001,1,1,426,1407,981
18002,1,0,47,0,-47
18003,1,0,33,0,-33
18004,1,0,91,0,-91
18005,0,0,158,0,-158
18006,1,1,309,2484,2175
18007,0,0,4,0,-4
18008,1,0,26,0,-26
18009,0,0,1,0,-1
18010,0,0,27,0,-27
18011,0,0,15,0,-15
18012,0,0,3,0,-3
18013,0,0,57,0,-57
18014,1,1,538,1353,815
18015,0,0,83,0,-83
18016,1,0,86,0,-86
18017,1,0,35,0,-35
18018,0,0,9,0,-9
18019,1,0,12,0,-12
18020,1,0,39,0,-39
18021,1,0,10,0,-10
18022,1,0,1,0,-1
18023,1,0,14,0,-14
18024,1,0,0,0,0
18025,1,1,99,2917,2818
18026,1,0,63,0,-63
18027,1,0,28,0,-28
18028,0,0,7,0,-7
18029,1,1,50,1407,1357
18030,1,0,33,0,-33
18031,0,0,61,0,-61
18032,1,1,317,1715,1398
18033,0,0,154,0,-154
18034,0,0,126,0,-126
18035,0,0,77,0,-77
18036,1,1,908,1757,849
18037,0,0,8,0,-8
18038,1,1,146,2135,1989
18039,1,0,77,0,-77
18040,1,0,131,0,-131
18041,1,0,15,0,-15
18042,0,0,33,0,-33
18043,1,1,283,1724,1441
18044,1,0,202,0,-202
18045,0,0,136,0,-136
18046,1,0,27,0,-27
18047,0,0,60,0,-60
18048,1,0,156,0,-156
18049,1,1,679,1265,586
18050,1,1,860,1502,642
18051,1,1,1207,1427,220
18052,1,0,56,0,-56
18053,1,1,231,1426,1195
18054,1,0,24,0,-24
18055,1,1,698,1299,601
18056,1,1,589,1359,770
18057,0,0,18,0,-18
18058,0,0,2,0,-2
18059,1,0,40,0,-40
18060,0,0,24,0,-24
18061,0,0,31,0,-31
18062,1,1,33,1576,1543
18063,1,0,27,0,-27
18064,0,0,50,0,-50
18065,1,1,1809,2040,231
18066,1,1,406,1305,899
18067,1,0,41,0,-41
18068,1,0,19,0,-19
18069,1,1,370,1459,1089
18070,1,1,257,1647,1390
18071,1,0,5,0,-5
18072,0,0,149,0,-149
18073,1,1,289,1356,1067
18074,1,0,35,0,-35
18075,0,0,8,0,-8
18076,1,0,35,0,-35
18077,1,1,446,1366,920
18078,0,0,49,0,-49
18079,0,0,13,0,-13
18080,1,0,84,0,-84
18081,0,0,65,0,-65
18082,1,1,189,1521,1332
18083,1,0,90,0,-90
18084,1,1,786,1474,688
18085,0,0,38,0,-38
18086,1,1,1383,1428,45
18087,0,0,1,0,-1
18088,1,1,287,1409,1122
18089,0,0,5,0,-5
18090,0,0,116,0,-116
18091,1,1,96,1513,1417
18092,1,1,547,1436,889
18093,1,0,16,0,-16
18094,1,0,82,0,-82
18095,1,0,93,0,-93
18096,1,0,16,0,-16
18097,1,0,55,0,-55
18098,0,0,43,0,-43
18099,0,0,55,0,-55
18100,0,0,249,0,-249
18101,1,1,816,4895,4079
18102,1,0,91,0,-91
18103,0,0,2,0,-2
18104,0,0,115,0,-115
18105,1,1,345,1462,1117
18106,0,0,145,0,-145
18107,1,0,53,0,-53
18108,0,0,85,0,-85
18109,1,0,19,0,-19
18110,1,0,70,0,-70
18111,1,0,45,0,-45
18112,0,0,34,0,-34
18113,1,0,10,0,-10
18114,0,0,15,0,-15
18115,1,0,14,0,-14
18116,0,0,8,0,-8
18117,0,0,40,0,-40
18118,1,1,464,2235,1771
18119,1,0,6,0,-6
18120,1,1,704,1241,537
18121,1,1,472,1325,853
18122,0,0,86,0,-86
18123,0,0,3,0,-3
18124,0,0,35,0,-35
18125,1,0,68,0,-68
18126,1,1,494,2019,1525
18127,1,0,132,0,-132
18128,1,1,823,2535,1712
18129,1,0,10,0,-10
18130,1,0,34,0,-34
18131,1,1,1262,1485,223
18132,0,0,21,0,-21
18133,1,1,91,1489,1398
18134,1,0,126,0,-126
18135,0,0,64,0,-64
18136,1,1,789,1757,968
18137,1,0,36,0,-36
18138,1,0,36,0,-36
18139,0,0,24,0,-24
18140,0,0,36,0,-36
18141,1,0,12,0,-12
18142,1,1,141,1388,1247
18143,1,1,152,1448,1296
18144,0,0,84,0,-84
18145,1,0,8,0,-8
18146,0,0,176,0,-176
18147,0,0,18,0,-18
18148,0,0,12,0,-12
18149,1,0,74,0,-74
18150,0,0,76,0,-76
18151,1,0,46,0,-46
18152,1,1,42,1646,1604
18153,1,0,36,0,-36
18154,0,0,10,0,-10
18155,1,0,77,0,-77
18156,1,1,78,1632,1554
18157,0,0,12,0,-12
18158,0,0,142,0,-142
18159,0,0,27,0,-27
18160,0,0,82,0,-82
18161,1,0,17,0,-17
18162,1,0,120,0,-120
18163,1,1,16,1494,1478
18164,0,0,48,0,-48
18165,1,0,95,0,-95
18166,1,0,17,0,-17
18167,1,0,74,0,-74
18168,0,0,37,0,-37
18169,0,0,65,0,-65
18170,1,1,170,2268,2098
18171,1,0,185,0,-185
18172,1,1,573,1448,875
18173,0,0,10,0,-10
18174,0,0,78,0,-78
18175,0,0,6,0,-6
18176,1,1,80,1257,1177
18177,0,0,79,0,-79
18178,1,0,106,0,-106
18179,1,1,1342,2172,830
18180,1,0,0,0,0
18181,0,0,2,0,-2
18182,1,1,881,1962,1081
18183,0,0,49,0,-49
18184,1,1,122,1248,1126
18185,1,0,19,0,-19
18186,1,0,1,0,-1
18187,1,1,949,1306,357
18188,1,1,250,1682,1432
18189,0,0,106,0,-106
18190,1,0,159,0,-159
18191,1,1,730,1277,547
18192,0,0,69,0,-69
18193,0,0,33,0,-33
18194,0,0,80,0,-80
18195,0,0,8,0,-8
18196,0,0,6,0,-6
18197,1,0,36,0,-36
18198,1,0,0,0,0
18199,1,1,437,2237,1800
18200,1,1,638,1576,938
18201,0,0,25,0,-25
18202,0,0,149,0,-149
18203,1,0,12,0,-12
18204,0,0,71,0,-71
18205,1,0,96,0,-96
18206,1,0,14,0,-14
18207,1,0,123,0,-123
18208,0,0,44,0,-44
18209,1,1,522,1376,854
18210,0,0,16,0,-16
18211,1,0,19,0,-19
18212,0,0,116,0,-116
18213,0,0,12,0,-12
18214,1,1,52,1379,1327
18215,1,1,754,1769,1015
18216,1,1,363,1256,893
18217,0,0,10,0,-10
18218,1,0,47,0,-47
18219,0,0,45,0,-45
18220,0,0,39,0,-39
18221,1,0,5,0,-5
18222,0,0,18,0,-18
18223,0,0,7,0,-7
18224,1,1,1692,1264,-428
18225,0,0,159,0,-159
18226,0,0,28,0,-28
18227,0,0,3,0,-3
18228,0,0,28,0,-28
18229,0,0,54,0,-54
18230,1,1,81,2109,2028
18231,1,1,175,1337,1162
18232,1,0,36,0,-36
18233,1,0,44,0,-44
18234,0,0,23,0,-23
18235,0,0,13,0,-13
18236,1,1,721,2448,1727
18237,1,1,1644,1302,-342
18238,0,0,29,0,-29
18239,0,0,112,0,-112
18240,0,0,41,0,-41
18241,1,0,19,0,-19
18242,1,0,136,0,-136
18243,0,0,17,0,-17
18244,0,0,41,0,-41
18245,0,0,30,0,-30
18246,0,0,2,0,-2
18247,1,0,23,0,-23
18248,1,1,267,1438,1171
18249,1,1,600,1522,922
18250,0,0,13,0,-13
18251,0,0,34,0,-34
18252,1,1,135,1488,1353
18253,1,0,27,0,-27
18254,1,1,1022,1615,593
18255,0,0,79,0,-79
18256,0,0,100,0,-100
18257,1,0,16,0,-16
18258,0,0,45,0,-45
18259,1,0,49,0,-49
18260,0,0,11,0,-11
18261,0,0,205,0,-205
18262,0,0,11,0,-11
18263,1,0,14,0,-14
18264,0,0,21,0,-21
18265,1,0,8,0,-8
18266,1,0,36,0,-36
18267,1,0,83,0,-83
18268,1,1,383,1461,1078
18269,0,0,9,0,-9
18270,1,1,1294,1398,104
18271,0,0,43,0,-43
18272,1,0,82,0,-82
18273,0,0,5,0,-5
18274,1,1,138,1299,1161
18275,1,1,139,1401,1262
18276,1,1,361,1377,1016
18277,0,0,107,0,-107
18278,0,0,120,0,-120
18279,0,0,2,0,-2
18280,0,0,178,0,-178
18281,1,1,822,1773,951
18282,0,0,106,0,-106
18283,0,0,354,0,-354
18284,0,0,10,0,-10
18285,1,0,77,0,-77
18286,0,0,18,0,-18
18287,1,0,11,0,-11
18288,0,0,4,0,-4
18289,1,0,1,0,-1
18290,0,0,97,0,-97
18291,1,1,228,1337,1109
18292,1,0,27,0,-27
18293,0,0,2,0,-2
18294,0,0,21,0,-21
18295,1,0,54,0,-54
18296,1,1,837,2128,1291
18297,1,0,235,0,-235
18298,1,1,765,1242,477
18299,0,0,8,0,-8
18300,1,1,339,1573,1234
18301,1,0,52,0,-52
18302,1,1,53,1408,1355
18303,0,0,0,0,0
18304,1,0,14,0,-14
18305,1,1,88,2445,2357
18306,1,1,72,1852,1780
18307,0,0,5,0,-5
18308,0,0,125,0,-125
18309,0,0,22,0,-22
18310,1,1,1065,1283,218
18311,1,1,208,1240,1032
18312,1,1,1192,3046,1854
18313,1,1,77,1571,1494
18314,0,0,23,0,-23
18315,1,0,35,0,-35
18316,1,1,397,1957,1560
18317,1,1,840,1280,440
18318,1,0,6,0,-6
18319,0,0,73,0,-73
18320,1,1,516,1433,917
18321,0,0,65,0,-65
18322,1,0,55,0,-55
18323,1,0,2,0,-2
18324,1,1,351,1480,1129
18325,1,1,189,1610,1421
18326,0,0,67,0,-67
18327,0,0,21,0,-21
18328,0,0,40,0,-40
18329,0,0,9,0,-9
18330,0,0,8,0,-8
18331,0,0,59,0,-59
18332,0,0,14,0,-14
18333,0,0,12,0,-12
18334,0,0,209,0,-209
18335,0,0,41,0,-41
18336,1,0,27,0,-27
18337,1,0,50,0,-50
18338,1,1,125,2211,2086
18339,1,1,608,1252,644
18340,1,0,57,0,-57
18341,0,0,0,0,0
18342,0,0,80,0,-80
18343,0,0,1,0,-1
18344,1,0,141,0,-141
18345,1,1,171,1483,1312
18346,0,0,2,0,-2
18347,0,0,81,0,-81
18348,0,0,7,0,-7
18349,0,0,17,0,-17
18350,1,1,222,1353,1131
18351,1,0,28,0,-28
18352,0,0,43,0,-43
18353,0,0,11,0,-11
18354,1,1,945,2975,2030
18355,1,0,253,0,-253
18356,1,1,71,1755,1684
18357,1,1,228,2223,1995
18358,1,0,10,0,-10
18359,1,1,43,1573,1530
18360,0,0,131,0,-131
18361,1,1,182,1625,1443
18362,1,1,66,1313,1247
18363,1,1,182,1432,1250
18364,1,0,108,0,-108
18365,1,1,58,1328,1270
18366,1,1,82,1365,1283
18367,0,0,119,0,-119
18368,1,1,114,1507,1393
18369,1,1,404,1376,972
18370,1,1,1340,2008,668
18371,1,1,770,1367,597
18372,1,0,5,0,-5
18373,1,0,46,0,-46
18374,0,0,51,0,-51
18375,0,0,70,0,-70
18376,1,1,796,2120,1324
18377,0,0,6,0,-6
18378,0,0,46,0,-46
18379,0,0,82,0,-82
18380,0,0,127,0,-127
18381,1,0,25,0,-25
18382,1,0,60,0,-60
18383,1,0,4,0,-4
18384,1,1,1518,1293,-225
18385,0,0,145,0,-145
18386,1,0,0,0,0
18387,0,0,107,0,-107
18388,1,1,268,1526,1258
18389,0,0,4,0,-4
18390,1,1,707,1640,933
18391,1,1,85,1619,1534
18392,1,1,102,1831,1729
18393,1,0,110,0,-110
18394,0,0,15,0,-15
18395,0,0,6,0,-6
18396,1,0,5,0,-5
18397,1,0,8,0,-8
18398,0,0,32,0,-32
18399,1,1,884,2527,1643
18400,1,1,1377,1675,298
18401,1,0,11,0,-11
18402,1,1,775,1246,471
18403,1,0,14,0,-14
18404,1,0,15,0,-15
18405,1,0,0,0,0
18406,1,0,29,0,-29
18407,0,0,38,0,-38
18408,1,1,95,2492,2397
18409,1,0,6,0,-6
18410,1,0,144,0,-144
18411,1,0,3,0,-3
18412,0,0,3,0,-3
18413,1,1,150,1576,1426
18414,1,1,44,2148,2104
18415,1,1,347,1741,1394
18416,1,0,31,0,-31
18417,1,0,24,0,-24
18418,1,1,629,1895,1266
18419,0,0,42,0,-42
18420,1,1,106,1444,1338
18421,0,0,129,0,-129
18422,1,1,206,1423,1217
18423,1,1,79,1939,1860
18424,0,0,14,0,-14
18425,1,1,261,1838,1577
18426,1,0,22,0,-22
18427,0,0,60,0,-60
18428,1,0,10,0,-10
18429,1,1,158,1792,1634
18430,1,1,39,1583,1544
18431,1,0,7,0,-7
18432,1,0,58,0,-58
18433,0,0,16,0,-16
18434,0,0,118,0,-118
18435,1,1,144,1576,1432
18436,0,0,44,0,-44
18437,1,0,4,0,-4
18438,1,1,79,1447,1368
18439,1,1,782,1460,678
18440,1,0,228,0,-228
18441,1,0,69,0,-69
18442,1,0,105,0,-105
18443,1,1,755,3824,3069
18444,0,0,8,0,-8
18445,1,0,78,0,-78
18446,1,0,20,0,-20
18447,1,1,564,1426,862
18448,0,0,33,0,-33
18449,0,0,37,0,-37
18450,1,1,183,1552,1369
18451,1,0,110,0,-110
18452,0,0,90,0,-90
18453,1,1,352,2034,1682
18454,0,0,8,0,-8
18455,1,1,522,1573,1051
18456,1,0,19,0,-19
18457,1,1,193,1370,1177
18458,1,0,318,0,-318
18459,1,1,545,1440,895
18460,1,1,334,1421,1087
18461,0,0,14,0,-14
18462,0,0,11,0,-11
18463,1,0,19,0,-19
18464,1,1,191,1339,1148
18465,1,0,25,0,-25
18466,1,1,309,1258,949
18467,0,0,83,0,-83
18468,0,0,63,0,-63
18469,1,0,17,0,-17
18470,0,0,40,0,-40
18471,1,0,92,0,-92
18472,1,0,28,0,-28
18473,1,0,17,0,-17
18474,1,1,132,4437,4305
18475,1,0,61,0,-61
18476,0,0,2,0,-2
18477,1,1,314,1290,976
18478,1,1,751,1256,505
18479,1,0,31,0,-31
18480,0,0,81,0,-81
18481,0,0,95,0,-95
18482,1,1,1253,1700,447
18483,1,1,94,2383,2289
18484,0,0,8,0,-8
18485,1,1,696,1411,715
18486,0,0,19,0,-19
18487,1,0,26,0,-26
18488,1,0,93,0,-93
18489,1,1,347,3000,2653
18490,1,0,103,0,-103
18491,1,0,19,0,-19
18492,0,0,94,0,-94
18493,0,0,104,0,-104
18494,0,0,5,0,-5
18495,0,0,40,0,-40
18496,1,1,503,1484,981
18497,1,1,644,1736,1092
18498,0,0,61,0,-61
18499,1,1,431,1426,995
18500,0,0,4,0,-4
18501,0,0,58,0,-58
18502,1,1,1979,2310,331
18503,0,0,76,0,-76
18504,1,0,70,0,-70
18505,0,0,92,0,-92
18506,1,1,806,1421,615
18507,1,1,405,1455,1050
18508,0,0,47,0,-47
18509,1,0,23,0,-23
18510,1,0,12,0,-12
18511,0,0,151,0,-151
18512,1,1,251,1418,1167
18513,1,1,32,2127,2095
18514,0,0,16,0,-16
18515,1,0,6,0,-6
18516,0,0,128,0,-128
18517,0,0,12,0,-12
18518,0,0,1,0,-1
18519,1,0,71,0,-71
18520,1,1,744,1772,1028
18521,0,0,16,0,-16
18522,1,0,84,0,-84
18523,0,0,71,0,-71
18524,0,0,132,0,-132
18525,0,0,70,0,-70
18526,1,0,3,0,-3
18527,0,0,12,0,-12
18528,1,1,259,4752,4493
18529,1,0,35,0,-35
18530,0,0,28,0,-28
18531,0,0,25,0,-25
18532,1,1,16,1350,1334
18533,1,1,53,1581,1528
18534,0,0,1,0,-1
18535,0,0,83,0,-83
18536,0,0,6,0,-6
18537,1,1,112,1995,1883
18538,0,0,21,0,-21
18539,1,0,20,0,-20
18540,0,0,6,0,-6
18541,0,0,15,0,-15
18542,1,0,184,0,-184
18543,1,0,9,0,-9
18544,0,0,1,0,-1
18545,1,1,80,1566,1486
18546,1,0,40,0,-40
18547,1,1,403,1440,1037
18548,1,1,323,1951,1628
18549,0,0,105,0,-105
18550,0,0,43,0,-43
18551,1,0,36,0,-36
18552,1,0,9,0,-9
18553,1,1,246,1960,1714
18554,1,1,245,1594,1349
18555,0,0,102,0,-102
18556,0,0,110,0,-110
18557,0,0,67,0,-67
18558,0,0,41,0,-41
18559,1,0,19,0,-19
18560,1,0,78,0,-78
18561,0,0,90,0,-90
18562,0,0,68,0,-68
18563,1,0,28,0,-28
18564,0,0,73,0,-73
18565,0,0,62,0,-62
18566,1,1,1007,2390,1383
18567,1,1,830,1601,771
18568,0,0,29,0,-29
18569,1,0,10,0,-10
18570,1,0,48,0,-48
18571,0,0,142,0,-142
18572,1,1,645,1440,795
18573,0,0,142,0,-142
18574,1,0,9,0,-9
18575,0,0,16,0,-16
18576,0,0,17,0,-17
18577,1,0,9,0,-9
18578,0,0,49,0,-49
18579,1,1,1223,2413,1190
18580,1,0,1,0,-1
18581,0,0,39,0,-39
18582,1,0,10,0,-10
18583,0,0,52,0,-52
18584,1,0,24,0,-24
18585,1,0,37,0,-37
18586,0,0,108,0,-108
18587,1,0,50,0,-50
18588,1,0,19,0,-19
18589,0,0,9,0,-9
18590,0,0,2,0,-2
18591,1,1,2341,1337,-1004
18592,1,0,13,0,-13
18593,1,1,456,1575,1119
18594,0,0,93,0,-93
18595,1,0,20,0,-20
18596,0,0,29,0,-29
18597,1,0,16,0,-16
18598,1,0,13,0,-13
18599,1,0,176,0,-176
18600,1,0,85,0,-85
18601,1,0,227,0,-227
18602,0,0,17,0,-17
18603,0,0,91,0,-91
18604,1,0,73,0,-73
18605,1,1,557,1361,804
18606,0,0,29,0,-29
18607,1,1,279,1256,977
18608,0,0,22,0,-22
18609,1,0,44,0,-44
18610,1,0,28,0,-28
18611,0,0,44,0,-44
18612,0,0,19,0,-19
18613,0,0,128,0,-128
18614,0,0,24,0,-24
18615,0,0,78,0,-78
18616,0,0,24,0,-24
18617,1,1,237,1536,1299
18618,1,0,69,0,-69
18619,1,0,7,0,-7
18620,0,0,35,0,-35
18621,1,1,362,1359,997
18622,1,1,607,2289,1682
18623,1,0,15,0,-15
18624,1,0,46,0,-46
18625,1,0,7,0,-7
18626,0,0,8,0,-8
18627,1,1,145,1827,1682
18628,1,1,576,1491,915
18629,0,0,10,0,-10
18630,0,0,142,0,-142
18631,1,0,7,0,-7
18632,1,0,31,0,-31
18633,1,0,58,0,-58
18634,1,0,47,0,-47
18635,1,0,31,0,-31
18636,1,0,72,0,-72
18637,1,0,12,0,-12
18638,1,1,99,2127,2028
18639,0,0,150,0,-150
18640,0,0,86,0,-86
18641,0,0,374,0,-374
18642,0,0,249,0,-249
18643,1,0,4,0,-4
18644,1,0,55,0,-55
18645,1,0,0,0,0
18646,1,1,635,1296,661
18647,1,0,37,0,-37
18648,1,1,178,1471,1293
18649,0,0,54,0,-54
18650,1,1,259,1452,1193
18651,1,1,566,1321,755
18652,0,0,25,0,-25
18653,1,0,163,0,-163
18654,0,0,19,0,-19
18655,0,0,63,0,-63
18656,0,0,15,0,-15
18657,1,1,157,1396,1239
18658,1,0,44,0,-44
18659,1,0,55,0,-55
18660,1,0,22,0,-22
18661,1,1,946,1299,353
18662,1,1,1146,1413,267
18663,1,0,61,0,-61
18664,0,0,29,0,-29
18665,1,1,186,2256,2070
18666,1,1,307,1572,1265
18667,0,0,41,0,-41
18668,0,0,166,0,-166
18669,1,0,36,0,-36
18670,1,0,34,0,-34
18671,1,0,29,0,-29
18672,0,0,13,0,-13
18673,0,0,3,0,-3
18674,1,0,1,0,-1
18675,1,1,459,1308,849
18676,0,0,25,0,-25
18677,1,0,28,0,-28
18678,1,0,50,0,-50
18679,1,1,614,1296,682
18680,0,0,104,0,-104
18681,1,1,854,1548,694
18682,1,0,133,0,-133
18683,1,1,84,1717,1633
18684,0,0,3,0,-3
18685,1,1,204,1243,1039
18686,1,0,4,0,-4
18687,0,0,36,0,-36
18688,0,0,15,0,-15
18689,1,0,48,0,-48
18690,0,0,59,0,-59
18691,0,0,70,0,-70
18692,0,0,105,0,-105
18693,0,0,34,0,-34
18694,1,0,49,0,-49
18695,0,0,22,0,-22
18696,1,0,91,0,-91
18697,1,0,18,0,-18
18698,0,0,35,0,-35
18699,1,1,1008,1287,279
18700,1,1,30,1284,1254
18701,1,0,20,0,-20
18702,0,0,26,0,-26
18703,1,0,55,0,-55
18704,1,1,497,1374,877
18705,1,0,168,0,-168
18706,1,1,348,3620,3272
18707,0,0,31,0,-31
18708,1,0,58,0,-58
18709,1,1,421,1360,939
18710,1,0,6,0,-6
18711,1,1,551,1621,1070
18712,0,0,7,0,-7
18713,0,0,91,0,-91
18714,1,1,582,1558,976
18715,1,0,118,0,-118
18716,1,1,524,1979,1455
18717,1,1,562,9132,8570
18718,1,1,499,1975,1476
18719,1,1,120,1560,1440
18720,0,0,73,0,-73
18721,1,1,311,1680,1369
18722,0,0,3,0,-3
18723,0,0,50,0,-50
18724,1,0,144,0,-144
18725,1,0,141,0,-141
18726,1,1,602,1341,739
18727,1,0,0,0,0
18728,1,0,40,0,-40
18729,0,0,14,0,-14
18730,1,1,168,5663,5495
18731,1,0,13,0,-13
18732,1,0,106,0,-106
18733,0,0,127,0,-127
18734,1,1,309,1788,1479
18735,0,0,44,0,-44
18736,1,0,181,0,-181
18737,0,0,29,0,-29
18738,0,0,29,0,-29
18739,1,1,1387,1259,-128
18740,1,0,45,0,-45
18741,0,0,23,0,-23
18742,0,0,5,0,-5
18743,0,0,2,0,-2
18744,0,0,14,0,-14
18745,1,0,50,0,-50
18746,0,0,43,0,-43
18747,1,1,1378,1382,4
18748,0,0,23,0,-23
18749,0,0,19,0,-19
18750,1,1,335,1285,950
18751,0,0,58,0,-58
18752,0,0,23,0,-23
18753,0,0,17,0,-17
18754,1,1,444,1720,1276
18755,1,0,82,0,-82
18756,1,0,185,0,-185
18757,1,0,78,0,-78
18758,0,0,4,0,-4
18759,1,1,638,1299,661
18760,1,1,488,1582,1094
18761,1,0,9,0,-9
18762,0,0,19,0,-19
18763,0,0,61,0,-61
18764,1,1,412,1268,856
18765,0,0,19,0,-19
18766,1,0,191,0,-191
18767,0,0,22,0,-22
18768,0,0,26,0,-26
18769,1,0,0,0,0
18770,1,1,143,1403,1260
18771,1,1,883,1257,374
18772,1,0,19,0,-19
18773,1,1,179,1569,1390
18774,0,0,1,0,-1
18775,1,0,46,0,-46
18776,1,1,668,1272,604
18777,1,0,62,0,-62
18778,0,0,13,0,-13
18779,0,0,45,0,-45
18780,1,1,3060,1408,-1652
18781,1,0,32,0,-32
18782,1,1,409,2953,2544
18783,0,0,11,0,-11
18784,1,0,20,0,-20
18785,1,1,201,1336,1135
18786,0,0,112,0,-112
18787,1,0,73,0,-73
18788,1,1,78,1367,1289
18789,0,0,47,0,-47
18790,0,0,75,0,-75
18791,1,1,214,2980,2766
18792,1,1,209,1467,1258
18793,0,0,46,0,-46
18794,1,0,10,0,-10
18795,1,0,139,0,-139
18796,1,0,27,0,-27
18797,1,1,103,2076,1973
18798,1,1,506,1263,757
18799,1,0,30,0,-30
18800,0,0,153,0,-153
18801,1,1,69,1276,1207
18802,1,1,100,1290,1190
18803,1,0,32,0,-32
18804,1,1,150,1379,1229
18805,1,0,25,0,-25
18806,0,0,26,0,-26
18807,1,0,55,0,-55
18808,1,0,40,0,-40
18809,1,1,733,1319,586
18810,1,0,192,0,-192
18811,1,0,22,0,-22
18812,1,0,26,0,-26
18813,1,0,30,0,-30
18814,0,0,16,0,-16
18815,1,0,101,0,-101
18816,1,1,46,1513,1467
18817,0,0,33,0,-33
18818,1,0,16,0,-16
18819,1,0,152,0,-152
18820,1,1,1499,1567,68
18821,0,0,20,0,-20
18822,1,0,29,0,-29
18823,1,0,38,0,-38
18824,1,0,5,0,-5
18825,1,0,129,0,-129
18826,0,0,3,0,-3
18827,1,1,319,1463,1144
18828,1,1,707,1819,1112
18829,1,1,571,1851,1280
18830,1,0,161,0,-161
18831,1,1,613,1466,853
18832,0,0,29,0,-29
18833,0,0,81,0,-81
18834,1,1,337,1661,1324
18835,1,0,83,0,-83
18836,1,1,1256,1280,24
18837,1,1,529,1282,753
18838,0,0,41,0,-41
18839,1,0,62,0,-62
18840,1,1,496,2091,1595
18841,1,0,3,0,-3
18842,0,0,70,0,-70
18843,1,1,319,1398,1079
18844,1,0,66,0,-66
18845,0,0,27,0,-27
18846,1,1,251,1679,1428
18847,0,0,11,0,-11
18848,1,1,905,1450,545
18849,1,1,138,1351,1213
18850,0,0,48,0,-48
18851,1,1,1143,1439,296
18852,0,0,60,0,-60
18853,1,0,12,0,-12
18854,0,0,280,0,-280
18855,0,0,76,0,-76
18856,0,0,40,0,-40
18857,1,1,431,1536,1105
18858,0,0,13,0,-13
18859,0,0,6,0,-6
18860,1,1,124,2342,2218
18861,1,1,889,1306,417
18862,0,0,69,0,-69
18863,1,1,269,1279,1010
18864,0,0,18,0,-18
18865,1,1,418,2376,1958
18866,0,0,223,0,-223
18867,1,0,91,0,-91
18868,1,1,376,1524,1148
18869,0,0,41,0,-41
18870,1,0,6,0,-6
18871,1,0,51,0,-51
18872,1,1,619,1520,901
18873,1,0,16,0,-16
18874,1,0,0,0,0
18875,1,0,84,0,-84
18876,1,1,218,1773,1555
18877,1,1,371,1674,1303
18878,1,1,708,1328,620
18879,0,0,34,0,-34
18880,0,0,52,0,-52
18881,1,1,586,1356,770
18882,0,0,82,0,-82
18883,1,0,72,0,-72
18884,0,0,106,0,-106
18885,0,0,143,0,-143
18886,1,1,107,1516,1409
18887,1,0,24,0,-24
18888,0,0,9,0,-9
18889,0,0,68,0,-68
18890,1,0,74,0,-74
18891,1,1,305,2872,2567
18892,1,0,14,0,-14
18893,1,0,15,0,-15
18894,0,0,56,0,-56
18895,0,0,13,0,-13
18896,1,1,382,1867,1485
18897,1,1,615,1377,762
18898,1,1,182,1476,1294
18899,1,0,173,0,-173
18900,0,0,97,0,-97
18901,1,1,430,1410,980
18902,0,0,19,0,-19
18903,1,1,221,1510,1289
18904,1,1,356,1352,996
18905,1,0,87,0,-87
18906,1,1,468,1617,1149
18907,1,0,126,0,-126
18908,1,0,103,0,-103
18909,1,0,34,0,-34
18910,0,0,31,0,-31
18911,1,0,24,0,-24
18912,1,0,4,0,-4
18913,1,1,136,1682,1546
18914,1,1,256,1326,1070
18915,1,1,70,1246,1176
18916,0,0,13,0,-13
18917,0,0,6,0,-6
18918,0,0,49,0,-49
18919,0,0,16,0,-16
18920,1,0,23,0,-23
18921,1,1,483,1341,858
18922,0,0,49,0,-49
18923,1,0,25,0,-25
18924,0,0,115,0,-115
18925,0,0,51,0,-51
18926,1,1,422,1243,821
18927,1,0,37,0,-37
18928,1,0,40,0,-40
18929,0,0,40,0,-40
18930,1,0,0,0,0
18931,1,1,726,1838,1112
18932,0,0,89,0,-89
18933,1,0,93,0,-93
18934,0,0,62,0,-62
18935,0,0,77,0,-77
18936,1,1,354,2042,1688
18937,0,0,27,0,-27
18938,1,0,7,0,-7
18939,0,0,45,0,-45
18940,0,0,14,0,-14
18941,1,0,86,0,-86
18942,1,0,2,0,-2
18943,1,1,321,1321,1000
18944,1,0,3,0,-3
18945,0,0,7,0,-7
18946,1,0,65,0,-65
18947,0,0,10,0,-10
18948,0,0,44,0,-44
18949,1,0,48,0,-48
18950,0,0,74,0,-74
18951,1,1,400,1271,871
18952,1,1,51,2189,2138
18953,0,0,104,0,-104
18954,0,0,58,0,-58
18955,0,0,6,0,-6
18956,1,0,80,0,-80
18957,1,1,74,1966,1892
18958,0,0,12,0,-12
18959,1,0,9,0,-9
18960,1,0,76,0,-76
18961,1,0,5,0,-5
18962,1,0,231,0,-231
18963,1,0,52,0,-52
18964,0,0,9,0,-9
18965,1,1,582,1313,731
18966,1,0,22,0,-22
18967,1,0,9,0,-9
18968,1,0,148,0,-148
18969,1,0,1,0,-1
18970,1,0,76,0,-76
18971,1,0,94,0,-94
18972,0,0,47,0,-47
18973,1,0,163,0,-163
18974,1,0,11,0,-11
18975,1,0,2,0,-2
18976,1,0,2,0,-2
18977,1,0,34,0,-34
18978,0,0,16,0,-16
18979,1,0,62,0,-62
18980,1,1,1906,1527,-379
18981,0,0,34,0,-34
18982,0,0,62,0,-62
18983,1,1,903,1462,559
18984,1,1,343,1299,956
18985,1,0,23,0,-23
18986,1,0,16,0,-16
18987,1,0,133,0,-133
18988,0,0,53,0,-53
18989,1,1,167,1402,1235
18990,1,0,15,0,-15
18991,0,0,0,0,0
18992,0,0,5,0,-5
18993,1,1,1094,1286,192
18994,1,1,64,1478,1414
18995,0,0,2,0,-2
18996,1,1,344,1280,936
18997,0,0,0,0,0
18998,1,0,6,0,-6
18999,1,0,12,0,-12
19000,0,0,10,0,-10
19001,1,1,609,1966,1357
19002,1,1,100,1383,1283
19003,1,1,475,1311,836
19004,1,0,39,0,-39
19005,1,0,69,0,-69
19006,0,0,23,0,-23
19007,1,1,819,1580,761
19008,0,0,38,0,-38
19009,0,0,52,0,-52
19010,0,0,20,0,-20
19011,1,0,118,0,-118
19012,0,0,70,0,-70
19013,1,1,478,1880,1402
19014,1,0,2,0,-2
19015,0,0,92,0,-92
19016,1,0,52,0,-52
19017,0,0,13,0,-13
19018,1,0,33,0,-33
19019,1,0,120,0,-120
19020,1,1,163,1538,1375
19021,0,0,168,0,-168
19022,0,0,7,0,-7
19023,1,0,6,0,-6
19024,0,0,34,0,-34
19025,0,0,24,0,-24
19026,0,0,68,0,-68
19027,0,0,28,0,-28
19028,1,0,0,0,0
19029,1,1,245,1484,1239
19030,1,0,169,0,-169
19031,1,0,95,0,-95
19032,1,1,1336,1751,415
19033,1,0,25,0,-25
19034,0,0,32,0,-32
19035,0,0,48,0,-48
19036,1,0,34,0,-34
19037,0,0,36,0,-36
19038,0,0,13,0,-13
19039,1,0,55,0,-55
19040,1,1,507,3735,3228
19041,0,0,123,0,-123
19042,1,0,55,0,-55
19043,1,1,572,1565,993
19044,1,0,6,0,-6
19045,1,0,102,0,-102
19046,1,1,466,1387,921
19047,1,0,164,0,-164
19048,1,1,924,1307,383
19049,0,0,1,0,-1
19050,1,1,263,1361,1098
19051,0,0,52,0,-52
19052,0,0,35,0,-35
19053,1,0,14,0,-14
19054,0,0,231,0,-231
19055,1,1,577,1257,680
19056,1,0,1,0,-1
19057,1,1,1058,1856,798
19058,0,0,28,0,-28
19059,1,1,1282,1454,172
19060,1,1,179,1274,1095
19061,0,0,0,0,0
19062,0,0,70,0,-70
19063,1,0,39,0,-39
19064,1,0,40,0,-40
19065,0,0,21,0,-21
19066,1,1,492,1292,800
19067,0,0,1,0,-1
19068,0,0,417,0,-417
19069,1,0,3,0,-3
19070,1,1,1325,1268,-57
19071,0,0,303,0,-303
19072,0,0,19,0,-19
19073,0,0,31,0,-31
19074,1,0,57,0,-57
19075,0,0,87,0,-87
19076,1,0,9,0,-9
19077,0,0,28,0,-28
19078,1,1,142,1519,1377
19079,1,0,90,0,-90
19080,1,1,621,1830,1209
19081,1,0,30,0,-30
19082,0,0,29,0,-29
19083,1,0,32,0,-32
19084,0,0,1,0,-1
19085,1,1,780,1782,1002
19086,0,0,113,0,-113
19087,1,1,398,1242,844
19088,0,0,24,0,-24
19089,0,0,15,0,-15
19090,0,0,16,0,-16
19091,1,0,93,0,-93
19092,1,1,406,1285,879
19093,0,0,2,0,-2
19094,1,0,4,0,-4
19095,1,0,23,0,-23
19096,0,0,7,0,-7
19097,1,0,26,0,-26
19098,0,0,168,0,-168
19099,1,0,21,0,-21
19100,1,1,523,1416,893
19101,1,1,79,1450,1371
19102,1,1,320,1592,1272
19103,0,0,39,0,-39
19104,1,1,184,1302,1118
19105,0,0,36,0,-36
19106,1,1,279,1347,1068
19107,0,0,104,0,-104
19108,0,0,8,0,-8
19109,0,0,2,0,-2
19110,0,0,22,0,-22
19111,1,1,902,1371,469
19112,0,0,23,0,-23
19113,1,0,112,0,-112
19114,1,1,186,1883,1697
19115,1,0,51,0,-51
19116,0,0,48,0,-48
19117,1,1,250,1940,1690
19118,1,0,14,0,-14
19119,1,1,1424,1288,-136
19120,0,0,27,0,-27
19121,0,0,29,0,-29
19122,1,1,387,1844,1457
19123,0,0,30,0,-30
19124,1,1,508,1898,1390
19125,1,1,52,1310,1258
19126,0,0,81,0,-81
19127,1,1,614,1302,688
19128,0,0,6,0,-6
19129,0,0,12,0,-12
19130,0,0,0,0,0
19131,0,0,32,0,-32
19132,1,0,14,0,-14
19133,1,0,58,0,-58
19134,1,1,150,1269,1119
19135,1,0,12,0,-12
19136,1,1,721,1657,936
19137,1,0,102,0,-102
19138,1,0,11,0,-11
19139,0,0,24,0,-24
19140,0,0,34,0,-34
19141,0,0,16,0,-16
19142,0,0,19,0,-19
19143,1,1,1355,1321,-34
19144,1,1,1494,4526,3032
19145,0,0,23,0,-23
19146,1,1,2059,1460,-599
19147,1,1,221,1767,1546
19148,1,0,165,0,-165
19149,1,1,782,1426,644
19150,0,0,97,0,-97
19151,0,0,8,0,-8
19152,1,0,51,0,-51
19153,1,0,30,0,-30
19154,0,0,27,0,-27
19155,0,0,41,0,-41
19156,1,1,9,1299,1290
19157,0,0,42,0,-42
19158,0,0,33,0,-33
19159,0,0,14,0,-14
19160,0,0,24,0,-24
19161,1,0,24,0,-24
19162,1,0,23,0,-23
19163,0,0,47,0,-47
19164,1,1,1426,1240,-186
19165,1,0,116,0,-116
19166,1,0,28,0,-28
19167,0,0,48,0,-48
19168,1,0,65,0,-65
19169,0,0,39,0,-39
19170,1,0,25,0,-25
19171,0,0,43,0,-43
19172,0,0,1,0,-1
19173,0,0,8,0,-8
19174,0,0,32,0,-32
19175,1,0,8,0,-8
19176,1,1,542,1534,992
19177,1,0,13,0,-13
19178,1,0,14,0,-14
19179,1,1,274,1515,1241
19180,0,0,120,0,-120
19181,0,0,0,0,0
19182,1,1,161,1352,1191
19183,1,1,1652,1728,76
19184,0,0,19,0,-19
19185,0,0,58,0,-58
19186,1,0,27,0,-27
19187,0,0,66,0,-66
19188,0,0,4,0,-4
19189,1,0,44,0,-44
19190,1,0,63,0,-63
19191,0,0,7,0,-7
19192,1,0,42,0,-42
19193,0,0,56,0,-56
19194,0,0,17,0,-17
19195,0,0,50,0,-50
19196,0,0,24,0,-24
19197,0,0,104,0,-104
19198,1,0,2,0,-2
19199,1,1,134,1718,1584
19200,1,1,243,1414,1171
19201,1,0,123,0,-123
19202,0,0,57,0,-57
19203,0,0,2,0,-2
19204,1,0,17,0,-17
19205,0,0,13,0,-13
19206,1,0,57,0,-57
19207,0,0,52,0,-52
19208,1,1,171,1733,1562
19209,1,1,138,1298,1160
19210,1,1,420,1517,1097
19211,0,0,26,0,-26
19212,1,1,98,1828,1730
19213,0,0,4,0,-4
19214,1,1,964,1462,498
19215,1,0,7,0,-7
19216,1,1,196,1735,1539
19217,0,0,22,0,-22
19218,1,1,394,1879,1485
19219,1,0,55,0,-55
19220,1,1,293,1670,1377
19221,1,1,779,2632,1853
19222,0,0,4,0,-4
19223,1,0,5,0,-5
19224,0,0,14,0,-14
19225,0,0,38,0,-38
19226,0,0,24,0,-24
19227,0,0,166,0,-166
19228,0,0,34,0,-34
19229,1,1,615,1417,802
19230,0,0,42,0,-42
19231,0,0,19,0,-19
19232,0,0,11,0,-11
19233,1,1,121,1245,1124
19234,0,0,11,0,-11
19235,0,0,50,0,-50
19236,0,0,3,0,-3
19237,1,0,38,0,-38
19238,0,0,7,0,-7
19239,1,0,224,0,-224
19240,0,0,15,0,-15
19241,0,0,56,0,-56
19242,0,0,34,0,-34
19243,1,1,1406,1321,-85
19244,1,0,130,0,-130
19245,1,1,893,1301,408
19246,0,0,3,0,-3
19247,1,1,199,1373,1174
19248,0,0,40,0,-40
19249,1,1,880,1518,638
19250,1,0,40,0,-40
19251,1,0,84,0,-84
19252,1,1,780,1290,510
19253,1,0,28,0,-28
19254,1,1,306,1469,1163
19255,1,1,1396,1491,95
19256,1,1,1114,1496,382
19257,0,0,83,0,-83
19258,1,0,178,0,-178
19259,1,1,23,2340,2317
19260,1,0,17,0,-17
19261,1,0,42,0,-42
19262,0,0,12,0,-12
19263,0,0,11,0,-11
19264,0,0,23,0,-23
19265,1,1,203,1420,1217
19266,0,0,69,0,-69
19267,1,1,428,1472,1044
19268,1,0,56,0,-56
19269,1,0,19,0,-19
19270,1,1,476,1520,1044
19271,1,0,1,0,-1
19272,1,1,1841,1388,-453
19273,1,1,400,1633,1233
19274,1,1,99,1517,1418
19275,0,0,48,0,-48
19276,1,1,227,1524,1297
19277,0,0,108,0,-108
19278,1,0,16,0,-16
19279,0,0,21,0,-21
19280,0,0,86,0,-86
19281,0,0,12,0,-12
19282,0,0,60,0,-60
19283,1,1,179,1324,1145
19284,1,0,121,0,-121
19285,0,0,61,0,-61
19286,1,0,23,0,-23
19287,1,1,163,1363,1200
19288,1,0,3,0,-3
19289,0,0,50,0,-50
19290,1,1,280,1274,994
19291,1,0,63,0,-63
19292,1,1,643,1741,1098
19293,1,1,116,1599,1483
19294,1,1,283,1413,1130
19295,0,0,25,0,-25
19296,1,1,1352,2125,773
19297,1,1,272,1417,1145
19298,1,1,467,1429,962
19299,0,0,15,0,-15
19300,1,1,486,2600,2114
19301,1,1,260,1325,1065
19302,1,0,7,0,-7
19303,1,0,33,0,-33
19304,1,0,2,0,-2
19305,1,1,201,1438,1237
19306,0,0,17,0,-17
19307,0,0,66,0,-66
19308,1,0,18,0,-18
19309,1,1,1487,1282,-205
19310,1,1,426,1429,1003
19311,1,1,463,2505,2042
19312,1,0,168,0,-168
19313,1,1,347,1589,1242
19314,1,0,44,0,-44
19315,0,0,144,0,-144
19316,1,1,882,1448,566
19317,0,0,35,0,-35
19318,0,0,23,0,-23
19319,0,0,121,0,-121
19320,1,1,853,1688,835
19321,1,0,53,0,-53
19322,1,0,46,0,-46
19323,0,0,61,0,-61
19324,0,0,88,0,-88
19325,1,1,1196,1290,94
19326,1,1,212,1532,1320
19327,1,1,1766,1403,-363
19328,1,0,41,0,-41
19329,0,0,11,0,-11
19330,0,0,28,0,-28
19331,0,0,53,0,-53
19332,0,0,28,0,-28
19333,1,0,91,0,-91
19334,1,1,299,2011,1712
19335,0,0,32,0,-32
19336,1,0,38,0,-38
19337,0,0,3,0,-3
19338,1,1,291,1293,1002
19339,1,1,20,1235,1215
19340,1,1,145,1970,1825
19341,1,1,187,1342,1155
19342,1,1,110,1731,1621
19343,1,0,34,0,-34
19344,1,1,1187,1512,325
19345,1,0,8,0,-8
19346,1,0,48,0,-48
19347,0,0,34,0,-34
19348,0,0,6,0,-6
19349,0,0,7,0,-7
19350,1,1,151,3136,2985
19351,1,0,62,0,-62
19352,1,1,511,1299,788
19353,1,0,14,0,-14
19354,1,0,84,0,-84
19355,1,0,0,0,0
19356,1,1,86,1561,1475
19357,1,0,3,0,-3
19358,1,0,62,0,-62
19359,0,0,10,0,-10
19360,1,1,278,1497,1219
19361,1,0,102,0,-102
19362,0,0,11,0,-11
19363,1,1,468,1893,1425
19364,1,1,953,1334,381
19365,0,0,139,0,-139
19366,0,0,33,0,-33
19367,1,1,1175,1734,559
19368,0,0,59,0,-59
19369,0,0,3,0,-3
19370,0,0,4,0,-4
19371,0,0,16,0,-16
19372,0,0,145,0,-145
19373,1,0,50,0,-50
19374,1,0,22,0,-22
19375,0,0,8,0,-8
19376,0,0,12,0,-12
19377,0,0,17,0,-17
19378,1,0,32,0,-32
19379,1,0,24,0,-24
19380,0,0,17,0,-17
19381,1,1,723,1351,628
19382,1,1,293,1238,945
19383,1,0,25,0,-25
19384,1,0,11,0,-11
19385,1,1,361,1792,1431
19386,0,0,32,0,-32
19387,1,1,641,1306,665
19388,0,0,2,0,-2
19389,0,0,12,0,-12
19390,0,0,45,0,-45
19391,0,0,51,0,-51
19392,0,0,5,0,-5
19393,0,0,42,0,-42
19394,1,0,11,0,-11
19395,0,0,8,0,-8
19396,1,1,484,1237,753
19397,1,0,17,0,-17
19398,0,0,42,0,-42
19399,0,0,43,0,-43
19400,1,1,666,1381,715
19401,1,1,1506,1242,-264
19402,0,0,62,0,-62
19403,0,0,5,0,-5
19404,1,1,1261,1837,576
19405,1,1,337,1395,1058
19406,0,0,14,0,-14
19407,1,0,110,0,-110
19408,0,0,72,0,-72
19409,0,0,90,0,-90
19410,1,1,16,1295,1279
19411,1,0,36,0,-36
19412,0,0,373,0,-373
19413,1,1,606,3206,2600
19414,0,0,46,0,-46
19415,1,1,231,1659,1428
19416,0,0,68,0,-68
19417,1,0,63,0,-63
19418,1,0,49,0,-49
19419,0,0,47,0,-47
19420,1,1,204,1257,1053
19421,0,0,78,0,-78
19422,0,0,51,0,-51
19423,1,1,1240,1530,290
19424,1,0,15,0,-15
19425,1,0,46,0,-46
19426,1,0,126,0,-126
19427,0,0,4,0,-4
19428,1,0,20,0,-20
19429,0,0,29,0,-29
19430,1,0,88,0,-88
19431,1,1,110,1467,1357
19432,1,0,18,0,-18
19433,1,1,346,2268,1922
19434,1,1,164,2094,1930
19435,1,0,68,0,-68
19436,0,0,81,0,-81
19437,1,1,555,1787,1232
19438,1,1,2243,1281,-962
19439,1,0,168,0,-168
19440,1,1,754,1331,577
19441,0,0,66,0,-66
19442,1,1,866,1335,469
19443,0,0,37,0,-37
19444,0,0,7,0,-7
19445,0,0,8,0,-8
19446,0,0,17,0,-17
19447,1,1,348,1298,950
19448,1,1,361,1345,984
19449,0,0,461,0,-461
19450,1,0,0,0,0
19451,0,0,19,0,-19
19452,1,1,386,1708,1322
19453,0,0,12,0,-12
19454,1,0,64,0,-64
19455,1,0,8,0,-8
19456,0,0,83,0,-83
19457,0,0,45,0,-45
19458,0,0,29,0,-29
19459,1,1,100,1430,1330
19460,0,0,18,0,-18
19461,1,0,19,0,-19
19462,1,1,299,1306,1007
19463,0,0,23,0,-23
19464,0,0,138,0,-138
19465,0,0,66,0,-66
19466,1,0,82,0,-82
19467,1,1,104,1250,1146
19468,1,1,222,2031,1809
19469,1,0,8,0,-8
19470,1,0,25,0,-25
19471,0,0,48,0,-48
19472,0,0,30,0,-30
19473,1,1,251,1286,1035
19474,0,0,12,0,-12
19475,1,1,324,1777,1453
19476,1,1,454,1466,1012
19477,0,0,34,0,-34
19478,1,1,430,1301,871
19479,1,1,135,1406,1271
19480,1,1,155,2522,2367
19481,1,1,469,1304,835
19482,1,1,2238,1254,-984
19483,0,0,71,0,-71
19484,1,0,104,0,-104
19485,1,0,38,0,-38
19486,0,0,87,0,-87
19487,0,0,3,0,-3
19488,1,1,743,1477,734
19489,1,0,11,0,-11
19490,0,0,45,0,-45
19491,1,1,355,1440,1085
19492,1,0,67,0,-67
19493,1,1,67,1414,1347
19494,0,0,10,0,-10
19495,0,0,70,0,-70
19496,1,1,457,1654,1197
19497,1,1,678,1276,598
19498,1,1,100,1362,1262
19499,1,0,18,0,-18
19500,0,0,107,0,-107
19501,1,1,392,1857,1465
19502,1,0,205,0,-205
19503,1,0,89,0,-89
19504,0,0,31,0,-31
19505,0,0,91,0,-91
19506,1,0,15,0,-15
19507,1,0,14,0,-14
19508,0,0,122,0,-122
19509,1,1,802,1348,546
19510,0,0,190,0,-190
19511,1,1,153,1877,1724
19512,0,0,8,0,-8
19513,0,0,74,0,-74
19514,0,0,102,0,-102
19515,0,0,67,0,-67
19516,1,0,23,0,-23
19517,1,1,354,1307,953
19518,1,1,769,1959,1190
19519,1,0,94,0,-94
19520,1,0,15,0,-15
19521,1,0,21,0,-21
19522,0,0,68,0,-68
19523,0,0,16,0,-16
19524,1,1,449,1534,1085
19525,0,0,106,0,-106
19526,1,1,2586,1492,-1094
19527,0,0,69,0,-69
19528,1,1,2904,2275,-629
19529,0,0,83,0,-83
19530,0,0,21,0,-21
19531,0,0,29,0,-29
19532,1,0,55,0,-55
19533,1,0,125,0,-125
19534,1,0,84,0,-84
19535,1,1,749,1339,590
19536,1,1,1013,1450,437
19537,1,1,331,1892,1561
19538,1,0,47,0,-47
19539,0,0,15,0,-15
19540,1,0,74,0,-74
19541,1,0,37,0,-37
19542,1,0,29,0,-29
19543,0,0,61,0,-61
19544,1,0,38,0,-38
19545,0,0,61,0,-61
19546,1,0,149,0,-149
19547,0,0,6,0,-6
19548,0,0,34,0,-34
19549,1,1,30,1732,1702
19550,1,0,17,0,-17
19551,0,0,8,0,-8
19552,1,0,29,0,-29
19553,1,1,158,1304,1146
19554,0,0,20,0,-20
19555,0,0,125,0,-125
19556,1,0,55,0,-55
19557,1,1,644,1626,982
19558,1,1,1479,1348,-131
19559,1,0,37,0,-37
19560,1,0,19,0,-19
19561,1,1,104,1248,1144
19562,0,0,18,0,-18
19563,1,0,58,0,-58
19564,0,0,10,0,-10
19565,0,0,98,0,-98
19566,1,0,5,0,-5
19567,0,0,137,0,-137
19568,1,1,170,1310,1140
19569,1,1,467,1425,958
19570,1,1,514,1293,779
19571,0,0,30,0,-30
19572,1,0,54,0,-54
19573,1,0,14,0,-14
19574,1,1,272,1764,1492
19575,0,0,66,0,-66
19576,0,0,32,0,-32
19577,1,0,5,0,-5
19578,0,0,9,0,-9
19579,1,0,2,0,-2
19580,0,0,3,0,-3
19581,1,0,8,0,-8
19582,1,0,103,0,-103
19583,1,0,15,0,-15
19584,1,1,13,1258,1245
19585,1,1,263,1554,1291
19586,1,1,1689,1273,-416
19587,0,0,71,0,-71
19588,1,0,2,0,-2
19589,1,1,124,2589,2465
19590,0,0,12,0,-12
19591,1,1,2620,5068,2448
19592,0,0,12,0,-12
19593,0,0,35,0,-35
19594,1,0,68,0,-68
19595,1,1,323,2196,1873
19596,0,0,2,0,-2
19597,0,0,2,0,-2
19598,1,0,21,0,-21
19599,1,1,57,1293,1236
19600,0,0,118,0,-118
19601,0,0,159,0,-159
19602,0,0,21,0,-21
19603,1,1,83,1492,1409
19604,1,0,6,0,-6
19605,1,0,13,0,-13
19606,0,0,63,0,-63
19607,1,0,32,0,-32
19608,0,0,6,0,-6
19609,1,0,24,0,-24
19610,1,0,14,0,-14
19611,1,0,65,0,-65
19612,1,1,705,2308,1603
19613,1,0,34,0,-34
19614,0,0,23,0,-23
19615,1,0,0,0,0
19616,1,0,36,0,-36
19617,0,0,15,0,-15
19618,1,1,226,3198,2972
19619,1,0,29,0,-29
19620,1,0,48,0,-48
19621,1,1,343,1340,997
19622,0,0,11,0,-11
19623,1,1,142,1332,1190
19624,1,0,18,0,-18
19625,1,1,420,1568,1148
19626,1,1,11,1914,1903
19627,1,1,167,1357,1190
19628,1,0,76,0,-76
19629,0,0,52,0,-52
19630,0,0,60,0,-60
19631,0,0,12,0,-12
19632,1,1,564,1382,818
19633,1,1,911,1621,710
19634,1,0,8,0,-8
19635,1,0,15,0,-15
19636,0,0,79,0,-79
19637,1,0,19,0,-19
19638,1,1,770,2077,1307
19639,1,1,59,1509,1450
19640,1,1,147,1700,1553
19641,0,0,57,0,-57
19642,1,0,238,0,-238
19643,0,0,17,0,-17
19644,1,0,45,0,-45
19645,1,0,88,0,-88
19646,0,0,53,0,-53
19647,1,1,212,1776,1564
19648,1,1,1473,1412,-61
19649,0,0,74,0,-74
19650,1,1,967,1452,485
19651,0,0,24,0,-24
19652,0,0,95,0,-95
19653,1,0,4,0,-4
19654,1,1,299,1728,1429
19655,0,0,3,0,-3
19656,1,1,381,1299,918
19657,0,0,23,0,-23
19658,0,0,7,0,-7
19659,0,0,47,0,-47
19660,1,0,10,0,-10
19661,0,0,7,0,-7
19662,0,0,92,0,-92
19663,1,1,1056,2189,1133
19664,0,0,19,0,-19
19665,0,0,81,0,-81
19666,0,0,4,0,-4
19667,0,0,44,0,-44
19668,0,0,2,0,-2
19669,1,1,729,1846,1117
19670,1,1,329,1774,1445
19671,1,1,232,1588,1356
19672,1,1,1357,1300,-57
19673,1,0,1,0,-1
19674,0,0,22,0,-22
19675,1,1,3100,1245,-1855
19676,1,0,43,0,-43
19677,1,0,18,0,-18
19678,1,1,191,1354,1163
19679,1,1,297,1336,1039
19680,1,0,92,0,-92
19681,1,1,777,1362,585
19682,1,1,160,1289,1129
19683,0,0,46,0,-46
19684,0,0,135,0,-135
19685,1,1,1374,1535,161
19686,1,1,608,1528,920
19687,0,0,68,0,-68
19688,0,0,52,0,-52
19689,0,0,7,0,-7
19690,0,0,8,0,-8
19691,0,0,28,0,-28
19692,0,0,0,0,0
19693,1,0,182,0,-182
19694,1,1,1128,1898,770
19695,1,0,22,0,-22
19696,1,0,1,0,-1
19697,1,0,17,0,-17
19698,0,0,35,0,-35
19699,1,1,178,1330,1152
19700,1,0,5,0,-5
19701,1,1,1290,1557,267
19702,1,0,94,0,-94
19703,0,0,13,0,-13
19704,1,0,17,0,-17
19705,1,1,1126,1237,111
19706,0,0,12,0,-12
19707,0,0,36,0,-36
19708,1,0,32,0,-32
19709,0,0,8,0,-8
19710,0,0,23,0,-23
19711,0,0,14,0,-14
19712,0,0,18,0,-18
19713,1,0,7,0,-7
19714,0,0,7,0,-7
19715,1,0,41,0,-41
19716,1,1,1728,1900,172
19717,1,1,107,1469,1362
19718,1,1,1379,1327,-52
19719,0,0,16,0,-16
19720,1,0,42,0,-42
19721,1,0,224,0,-224
19722,1,1,226,1846,1620
19723,1,0,4,0,-4
19724,0,0,41,0,-41
19725,1,0,51,0,-51
19726,1,0,44,0,-44
19727,1,1,453,2021,1568
19728,0,0,13,0,-13
19729,0,0,1,0,-1
19730,1,0,123,0,-123
19731,0,0,110,0,-110
19732,0,0,31,0,-31
19733,0,0,9,0,-9
19734,1,1,345,2063,1718
19735,0,0,18,0,-18
19736,0,0,10,0,-10
19737,1,0,8,0,-8
19738,1,1,471,3069,2598
19739,1,1,85,1561,1476
19740,0,0,1,0,-1
19741,1,1,739,1670,931
19742,1,1,459,1379,920
19743,1,0,41,0,-41
19744,0,0,49,0,-49
19745,1,1,528,1297,769
19746,1,0,6,0,-6
19747,1,0,41,0,-41
19748,1,1,660,1335,675
19749,0,0,23,0,-23
19750,0,0,118,0,-118
19751,0,0,8,0,-8
19752,1,1,691,1243,552
19753,1,0,73,0,-73
19754,1,1,655,1345,690
19755,0,0,64,0,-64
19756,1,1,1616,1731,115
19757,1,0,64,0,-64
19758,0,0,24,0,-24
19759,1,1,142,1821,1679
19760,0,0,101,0,-101
19761,1,1,1357,1558,201
19762,0,0,17,0,-17
19763,1,0,45,0,-45
19764,0,0,38,0,-38
19765,1,1,213,1513,1300
19766,1,1,486,1779,1293
19767,1,1,562,1336,774
19768,0,0,96,0,-96
19769,0,0,23,0,-23
19770,1,1,1442,1458,16
19771,1,1,810,1277,467
19772,1,1,1213,1481,268
19773,1,0,2,0,-2
19774,0,0,52,0,-52
19775,1,1,561,1623,1062
19776,1,1,492,1286,794
19777,1,0,13,0,-13
19778,1,1,889,1298,409
19779,0,0,1,0,-1
19780,1,1,259,1368,1109
19781,0,0,98,0,-98
19782,0,0,38,0,-38
19783,0,0,10,0,-10
19784,1,1,283,1833,1550
19785,0,0,2,0,-2
19786,1,0,11,0,-11
19787,0,0,8,0,-8
19788,1,1,460,1627,1167
19789,0,0,10,0,-10
19790,0,0,36,0,-36
19791,1,1,1853,1280,-573
19792,1,0,57,0,-57
19793,1,1,1470,1737,267
19794,0,0,10,0,-10
19795,1,0,37,0,-37
19796,0,0,55,0,-55
19797,1,1,315,1269,954
19798,0,0,15,0,-15
19799,0,0,38,0,-38
19800,1,1,110,1246,1136
19801,1,1,371,1554,1183
19802,1,1,28,1253,1225
19803,1,1,737,1520,783
19804,1,1,532,3580,3048
19805,1,0,0,0,0
19806,1,0,24,0,-24
19807,0,0,56,0,-56
19808,0,0,43,0,-43
19809,0,0,48,0,-48
19810,1,1,447,1404,957
19811,1,1,701,1445,744
19812,0,0,19,0,-19
19813,0,0,120,0,-120
19814,0,0,30,0,-30
19815,0,0,17,0,-17
19816,0,0,200,0,-200
19817,1,0,32,0,-32
19818,0,0,16,0,-16
19819,0,0,70,0,-70
19820,1,1,136,1372,1236
19821,0,0,65,0,-65
19822,1,0,7,0,-7
19823,0,0,83,0,-83
19824,0,0,3,0,-3
19825,1,1,726,1250,524
19826,1,1,294,1357,1063
19827,0,0,38,0,-38
19828,1,0,0,0,0
19829,0,0,243,0,-243
19830,0,0,54,0,-54
19831,0,0,41,0,-41
19832,0,0,5,0,-5
19833,0,0,21,0,-21
19834,1,0,9,0,-9
19835,0,0,24,0,-24
19836,1,1,1325,1738,413
19837,1,1,370,1334,964
19838,0,0,127,0,-127
19839,1,1,159,1308,1149
19840,1,0,124,0,-124
19841,0,0,35,0,-35
19842,1,0,16,0,-16
19843,1,0,7,0,-7
19844,1,1,179,1670,1491
19845,0,0,91,0,-91
19846,0,0,46,0,-46
19847,1,0,25,0,-25
19848,0,0,145,0,-145
19849,1,1,1826,1527,-299
19850,0,0,15,0,-15
19851,1,1,533,1632,1099
19852,1,1,237,1561,1324
19853,1,1,208,1236,1028
19854,1,1,69,1248,1179
19855,0,0,60,0,-60
19856,0,0,86,0,-86
19857,0,0,44,0,-44
19858,0,0,41,0,-41
19859,1,0,10,0,-10
19860,1,1,363,1286,923
19861,1,0,43,0,-43
19862,1,1,535,1332,797
19863,0,0,99,0,-99
19864,1,1,1643,1296,-347
19865,0,0,9,0,-9
19866,0,0,4,0,-4
19867,1,1,441,1864,1423
19868,1,0,82,0,-82
19869,0,0,14,0,-14
19870,0,0,10,0,-10
19871,1,1,766,1243,477
19872,1,1,92,1704,1612
19873,0,0,82,0,-82
19874,1,0,15,0,-15
19875,1,1,159,1541,1382
19876,0,0,33,0,-33
19877,1,1,232,1341,1109
19878,0,0,144,0,-144
19879,0,0,152,0,-152
19880,0,0,70,0,-70
19881,0,0,49,0,-49
19882,1,0,145,0,-145
19883,1,1,408,1632,1224
19884,1,1,990,1367,377
19885,0,0,55,0,-55
19886,1,0,126,0,-126
19887,0,0,12,0,-12
19888,0,0,94,0,-94
19889,1,1,140,1297,1157
19890,0,0,37,0,-37
19891,1,1,1372,1380,8
19892,1,1,179,1273,1094
19893,0,0,57,0,-57
19894,1,1,363,1270,907
19895,1,1,1018,1441,423
19896,1,1,1128,1749,621
19897,0,0,92,0,-92
19898,1,0,0,0,0
19899,1,0,25,0,-25
19900,0,0,16,0,-16
19901,0,0,206,0,-206
19902,0,0,3,0,-3
19903,1,0,1,0,-1
19904,1,0,81,0,-81
19905,1,1,265,1700,1435
19906,0,0,7,0,-7
19907,1,1,300,1701,1401
19908,0,0,79,0,-79
19909,0,0,21,0,-21
19910,1,0,63,0,-63
19911,1,1,52,1460,1408
19912,0,0,38,0,-38
19913,0,0,10,0,-10
19914,0,0,34,0,-34
19915,1,1,369,1559,1190
19916,1,0,68,0,-68
19917,0,0,0,0,0
19918,0,0,27,0,-27
19919,1,1,275,1453,1178
19920,1,1,336,1404,1068
19921,1,0,10,0,-10
19922,1,0,12,0,-12
19923,1,1,583,1525,942
19924,1,1,77,1670,1593
19925,0,0,113,0,-113
19926,0,0,182,0,-182
19927,1,0,58,0,-58
19928,1,0,101,0,-101
19929,1,1,632,1301,669
19930,1,0,160,0,-160
19931,1,1,563,1767,1204
19932,0,0,4,0,-4
19933,0,0,66,0,-66
19934,1,1,100,1945,1845
19935,1,1,574,1284,710
19936,0,0,40,0,-40
19937,0,0,28,0,-28
19938,1,1,651,1947,1296
19939,1,1,273,2100,1827
19940,1,0,9,0,-9
19941,0,0,88,0,-88
19942,1,0,13,0,-13
19943,0,0,17,0,-17
19944,0,0,74,0,-74
19945,1,1,389,1259,870
19946,1,0,63,0,-63
19947,1,0,66,0,-66
19948,1,1,408,2173,1765
19949,1,0,4,0,-4
19950,1,1,677,1363,686
19951,0,0,57,0,-57
19952,1,1,703,1378,675
19953,1,1,442,1290,848
19954,1,1,484,1501,1017
19955,0,0,31,0,-31
19956,0,0,103,0,-103
19957,0,0,25,0,-25
19958,0,0,8,0,-8
19959,1,0,36,0,-36
19960,0,0,119,0,-119
19961,1,1,347,1583,1236
19962,1,1,223,1449,1226
19963,0,0,56,0,-56
19964,1,0,22,0,-22
19965,1,0,51,0,-51
19966,1,0,22,0,-22
19967,0,0,40,0,-40
19968,0,0,6,0,-6
19969,1,0,14,0,-14
19970,1,0,58,0,-58
19971,0,0,57,0,-57
19972,0,0,25,0,-25
19973,1,1,578,1247,669
19974,1,0,7,0,-7
19975,1,0,119,0,-119
19976,0,0,17,0,-17
19977,0,0,29,0,-29
19978,0,0,69,0,-69
19979,1,1,309,1236,927
19980,0,0,10,0,-10
19981,1,0,87,0,-87
19982,0,0,0,0,0
19983,1,1,589,1241,652
19984,1,0,11,0,-11
19985,1,1,470,1456,986
19986,0,0,46,0,-46
19987,1,1,446,1280,834
19988,0,0,36,0,-36
19989,0,0,79,0,-79
19990,1,0,50,0,-50
19991,1,0,56,0,-56
19992,0,0,2,0,-2
19993,1,0,50,0,-50
19994,0,0,181,0,-181
19995,1,0,47,0,-47
19996,1,1,195,1603,1408
19997,1,1,515,1321,806
19998,1,1,1108,2651,1543
19999,0,0,3,0,-3
20000,0,0,41,0,-41
20001,0,0,33,0,-33
20002,1,1,2224,2265,41
20003,1,1,222,2272,2050
20004,1,0,184,0,-184
20005,0,0,15,0,-15
20006,1,1,401,1375,974
20007,0,0,69,0,-69
20008,0,0,21,0,-21
20009,0,0,36,0,-36
20010,1,0,99,0,-99
20011,1,0,79,0,-79
20012,0,0,12,0,-12
20013,1,1,333,1348,1015
20014,0,0,33,0,-33
20015,1,0,95,0,-95
20016,1,0,67,0,-67
20017,0,0,16,0,-16
20018,1,0,38,0,-38
20019,1,0,110,0,-110
20020,0,0,61,0,-61
20021,1,1,75,1536,1461
20022,1,0,10,0,-10
20023,1,0,20,0,-20
20024,1,1,353,1822,1469
20025,0,0,29,0,-29
20026,1,0,38,0,-38
20027,0,0,5,0,-5
20028,1,0,43,0,-43
20029,1,1,143,1757,1614
20030,0,0,85,0,-85
20031,0,0,34,0,-34
20032,1,0,6,0,-6
20033,0,0,35,0,-35
20034,0,0,240,0,-240
20035,0,0,91,0,-91
20036,0,0,82,0,-82
20037,1,0,18,0,-18
20038,1,0,39,0,-39
20039,1,0,25,0,-25
20040,1,0,3,0,-3
20041,0,0,35,0,-35
20042,1,0,41,0,-41
20043,1,0,199,0,-199
20044,1,1,883,1586,703
20045,1,0,31,0,-31
20046,1,0,4,0,-4
20047,1,0,7,0,-7
20048,1,1,537,2734,2197
20049,0,0,23,0,-23
20050,1,1,97,1352,1255
20051,0,0,47,0,-47
20052,0,0,12,0,-12
20053,0,0,83,0,-83
20054,1,1,1840,1263,-577
20055,1,0,59,0,-59
20056,1,0,38,0,-38
20057,1,0,89,0,-89
20058,1,1,453,1302,849
20059,1,0,117,0,-117
20060,0,0,6,0,-6
20061,0,0,47,0,-47
20062,1,1,76,1551,1475
20063,0,0,93,0,-93
20064,0,0,147,0,-147
20065,0,0,152,0,-152
20066,1,1,390,1351,961
20067,1,0,29,0,-29
20068,0,0,19,0,-19
20069,1,0,125,0,-125
20070,1,0,11,0,-11
20071,1,0,19,0,-19
20072,0,0,19,0,-19
20073,1,0,15,0,-15
20074,0,0,16,0,-16
20075,1,1,102,1270,1168
20076,0,0,60,0,-60
20077,0,0,21,0,-21
20078,1,0,85,0,-85
20079,0,0,15,0,-15
20080,0,0,36,0,-36
20081,1,1,507,1237,730
20082,0,0,48,0,-48
20083,0,0,24,0,-24
20084,1,1,115,1655,1540
20085,1,1,420,1261,841
20086,1,0,76,0,-76
20087,1,1,458,1415,957
20088,0,0,45,0,-45
20089,1,1,194,1355,1161
20090,1,0,103,0,-103
20091,0,0,50,0,-50
20092,0,0,65,0,-65
20093,1,0,188,0,-188
20094,1,0,137,0,-137
20095,1,0,23,0,-23
20096,0,0,15,0,-15
20097,1,1,351,1284,933
20098,1,1,280,1543,1263
20099,1,1,209,2644,2435
20100,1,1,334,2073,1739
20101,0,0,17,0,-17
20102,1,0,20,0,-20
20103,1,1,180,2128,1948
20104,0,0,63,0,-63
20105,0,0,12,0,-12
20106,1,1,403,2017,1614
20107,1,1,811,1360,549
20108,0,0,42,0,-42
20109,1,0,47,0,-47
20110,0,0,75,0,-75
20111,1,0,14,0,-14
20112,0,0,8,0,-8
20113,1,1,136,1442,1306
20114,0,0,31,0,-31
20115,0,0,3,0,-3
20116,1,1,541,1347,806
20117,1,1,607,1418,811
20118,1,1,650,1507,857
20119,1,1,1394,1372,-22
20120,1,1,1149,2289,1140
20121,1,1,2332,1671,-661
20122,1,1,528,1236,708
20123,1,0,14,0,-14
20124,1,1,502,1309,807
20125,0,0,20,0,-20
20126,1,1,1468,2231,763
20127,0,0,54,0,-54
20128,1,0,3,0,-3
20129,1,1,290,1475,1185
20130,0,0,149,0,-149
20131,0,0,33,0,-33
20132,1,0,14,0,-14
20133,1,1,870,1404,534
20134,1,0,75,0,-75
20135,0,0,65,0,-65
20136,0,0,77,0,-77
20137,1,1,286,1781,1495
20138,1,1,368,1667,1299
20139,1,1,259,1615,1356
20140,1,1,1205,1279,74
20141,1,0,67,0,-67
20142,1,0,6,0,-6
20143,0,0,31,0,-31
20144,1,0,2,0,-2
20145,1,1,251,1845,1594
20146,1,1,43,1636,1593
20147,0,0,23,0,-23
20148,0,0,17,0,-17
20149,1,0,12,0,-12
20150,1,1,23,1318,1295
20151,1,1,1291,1690,399
20152,1,1,137,1349,1212
20153,1,0,57,0,-57
20154,1,1,338,1310,972
20155,0,0,64,0,-64
20156,1,1,175,1235,1060
20157,1,1,669,1358,689
20158,0,0,101,0,-101
20159,1,0,70,0,-70
20160,0,0,3,0,-3
20161,1,0,25,0,-25
20162,0,0,55,0,-55
20163,0,0,4,0,-4
20164,1,0,54,0,-54
20165,0,0,46,0,-46
20166,1,1,162,1474,1312
20167,0,0,31,0,-31
20168,1,1,1069,1433,364
20169,0,0,45,0,-45
20170,1,0,5,0,-5
20171,0,0,36,0,-36
20172,1,1,167,1482,1315
20173,1,1,921,1988,1067
20174,1,1,1203,1366,163
20175,0,0,75,0,-75
20176,1,1,539,1527,988
20177,1,1,592,1932,1340
20178,1,0,58,0,-58
20179,0,0,17,0,-17
20180,0,0,3,0,-3
20181,0,0,17,0,-17
20182,1,0,59,0,-59
20183,0,0,173,0,-173
20184,0,0,0,0,0
20185,1,1,972,1281,309
20186,1,1,1467,1270,-197
20187,0,0,68,0,-68
20188,1,1,609,1807,1198
20189,1,1,588,1347,759
20190,1,0,21,0,-21
20191,1,0,5,0,-5
20192,0,0,106,0,-106
20193,0,0,48,0,-48
20194,0,0,37,0,-37
20195,1,1,863,2886,2023
20196,1,0,106,0,-106
20197,1,1,1244,1313,69
20198,1,1,218,2916,2698
20199,0,0,27,0,-27
20200,1,0,37,0,-37
20201,1,1,684,1424,740
20202,1,1,804,1344,540
20203,1,0,14,0,-14
20204,1,1,181,1267,1086
20205,1,1,902,1419,517
20206,0,0,7,0,-7
20207,1,0,68,0,-68
20208,1,1,180,1375,1195
20209,1,1,1083,1404,321
20210,1,1,1064,1982,918
20211,0,0,8,0,-8
20212,0,0,40,0,-40
20213,0,0,33,0,-33
20214,1,0,121,0,-121
20215,0,0,53,0,-53
20216,0,0,35,0,-35
20217,1,0,0,0,0
20218,1,0,24,0,-24
20219,1,0,80,0,-80
20220,1,0,3,0,-3
20221,1,0,30,0,-30
20222,0,0,6,0,-6
20223,0,0,22,0,-22
20224,1,0,29,0,-29
20225,1,1,365,1481,1116
20226,1,0,29,0,-29
20227,0,0,27,0,-27
20228,1,0,55,0,-55
20229,1,0,154,0,-154
20230,1,1,84,1491,1407
20231,1,1,421,1445,1024
20232,0,0,76,0,-76
20233,1,1,600,1677,1077
20234,1,1,170,1465,1295
20235,0,0,90,0,-90
20236,0,0,162,0,-162
20237,1,1,1,1295,1294
20238,1,1,681,1839,1158
20239,0,0,44,0,-44
20240,0,0,167,0,-167
20241,1,1,734,1436,702
20242,0,0,20,0,-20
20243,0,0,14,0,-14
20244,1,1,137,2986,2849
20245,1,0,56,0,-56
20246,0,0,39,0,-39
20247,0,0,60,0,-60
20248,1,1,612,1577,965
20249,0,0,17,0,-17
20250,1,0,10,0,-10
20251,1,0,57,0,-57
20252,0,0,13,0,-13
20253,1,1,658,2147,1489
20254,1,1,391,1683,1292
20255,1,0,154,0,-154
20256,0,0,6,0,-6
20257,1,0,63,0,-63
20258,1,0,83,0,-83
20259,1,1,293,1421,1128
20260,1,1,378,1459,1081
20261,1,1,1044,1517,473
20262,0,0,3,0,-3
20263,1,0,34,0,-34
20264,1,0,42,0,-42
20265,1,0,7,0,-7
20266,0,0,18,0,-18
20267,1,1,420,1466,1046
20268,0,0,17,0,-17
20269,1,1,311,1525,1214
20270,1,1,480,1366,886
20271,0,0,85,0,-85
20272,0,0,5,0,-5
20273,1,0,8,0,-8
20274,0,0,59,0,-59
20275,0,0,31,0,-31
20276,0,0,0,0,0
20277,1,0,43,0,-43
20278,0,0,26,0,-26
20279,1,1,968,1348,380
20280,1,0,135,0,-135
20281,1,1,629,9613,8984
20282,0,0,30,0,-30
20283,1,0,13,0,-13
20284,1,0,56,0,-56
20285,1,1,1291,1238,-53
20286,1,1,524,1298,774
20287,1,0,19,0,-19
20288,0,0,3,0,-3
20289,0,0,6,0,-6
20290,0,0,23,0,-23
20291,1,1,141,1297,1156
20292,0,0,21,0,-21
20293,0,0,4,0,-4
20294,1,0,0,0,0
20295,0,0,25,0,-25
20296,1,0,97,0,-97
20297,1,1,892,2318,1426
20298,1,0,32,0,-32
20299,1,1,426,1334,908
20300,1,1,451,2813,2362
20301,1,1,78,2246,2168
20302,1,0,60,0,-60
20303,0,0,124,0,-124
20304,1,0,48,0,-48
20305,1,1,150,1340,1190
20306,0,0,17,0,-17
20307,0,0,78,0,-78
20308,0,0,58,0,-58
20309,1,1,1055,1709,654
20310,1,0,5,0,-5
20311,0,0,47,0,-47
20312,1,1,913,1596,683
20313,1,0,21,0,-21
20314,1,1,1108,1255,147
20315,0,0,15,0,-15
20316,0,0,17,0,-17
20317,1,1,167,1848,1681
20318,1,1,377,1292,915
20319,0,0,89,0,-89
20320,1,1,974,1581,607
20321,0,0,21,0,-21
20322,0,0,190,0,-190
20323,0,0,9,0,-9
20324,1,1,403,1270,867
20325,1,0,1,0,-1
20326,0,0,97,0,-97
20327,1,1,213,1728,1515
20328,1,1,117,1622,1505
20329,0,0,39,0,-39
20330,0,0,12,0,-12
20331,1,0,2,0,-2
20332,1,1,990,2175,1185
20333,1,0,18,0,-18
20334,1,0,53,0,-53
20335,1,1,586,1251,665
20336,1,0,72,0,-72
20337,1,1,482,1331,849
20338,1,1,38,2372,2334
20339,1,0,96,0,-96
20340,1,1,592,1337,745
20341,1,1,639,1526,887
20342,1,0,78,0,-78
20343,0,0,11,0,-11
20344,1,0,103,0,-103
20345,0,0,11,0,-11
20346,1,1,241,2408,2167
20347,0,0,28,0,-28
20348,1,0,45,0,-45
20349,1,0,1,0,-1
20350,0,0,83,0,-83
20351,1,0,58,0,-58
20352,1,1,99,1625,1526
20353,1,0,81,0,-81
20354,1,1,118,1401,1283
20355,1,1,2114,1645,-469
20356,0,0,47,0,-47
20357,1,0,7,0,-7
20358,0,0,12,0,-12
20359,0,0,58,0,-58
20360,1,1,466,2690,2224
20361,1,0,181,0,-181
20362,1,1,147,1266,1119
20363,1,1,108,1440,1332
20364,1,1,424,1834,1410
20365,0,0,14,0,-14
20366,1,0,20,0,-20
20367,1,1,192,1383,1191
20368,0,0,110,0,-110
20369,0,0,34,0,-34
20370,0,0,27,0,-27
20371,1,0,88,0,-88
20372,1,0,6,0,-6
20373,0,0,17,0,-17
20374,1,1,1302,1371,69
20375,0,0,45,0,-45
20376,1,1,220,1605,1385
20377,0,0,46,0,-46
20378,1,1,39,1429,1390
20379,0,0,18,0,-18
20380,0,0,193,0,-193
20381,1,0,176,0,-176
20382,1,1,273,5137,4864
20383,1,1,727,1465,738
20384,0,0,7,0,-7
20385,1,0,71,0,-71
20386,0,0,6,0,-6
20387,1,0,90,0,-90
20388,1,1,1381,1275,-106
20389,0,0,61,0,-61
20390,1,0,28,0,-28
20391,1,0,32,0,-32
20392,1,1,69,1246,1177
20393,1,1,80,1618,1538
20394,1,0,69,0,-69
20395,1,1,206,1236,1030
20396,0,0,4,0,-4
20397,1,1,365,1591,1226
20398,1,1,151,1470,1319
20399,1,1,180,1748,1568
20400,1,1,257,1650,1393
20401,1,1,602,1281,679
20402,1,0,14,0,-14
20403,0,0,94,0,-94
20404,1,1,84,1721,1637
20405,0,0,87,0,-87
20406,1,0,17,0,-17
20407,1,1,1501,1358,-143
20408,0,0,66,0,-66
20409,1,0,1,0,-1
20410,0,0,83,0,-83
20411,1,1,56,1290,1234
20412,1,1,1338,1648,310
20413,1,1,455,1615,1160
20414,1,1,573,1347,774
20415,0,0,63,0,-63
20416,1,0,155,0,-155
20417,0,0,32,0,-32
20418,1,0,126,0,-126
20419,1,1,185,1281,1096
20420,0,0,53,0,-53
20421,0,0,104,0,-104
20422,1,1,1189,2112,923
20423,1,0,13,0,-13
20424,1,1,519,1420,901
20425,0,0,12,0,-12
20426,1,0,73,0,-73
20427,0,0,178,0,-178
20428,0,0,23,0,-23
20429,0,0,129,0,-129
20430,0,0,119,0,-119
20431,0,0,26,0,-26
20432,0,0,66,0,-66
20433,1,0,64,0,-64
20434,0,0,3,0,-3
20435,0,0,70,0,-70
20436,1,1,1157,1428,271
20437,0,0,80,0,-80
20438,0,0,18,0,-18
20439,1,1,573,3064,2491
20440,1,1,680,1754,1074
20441,0,0,86,0,-86
20442,1,1,844,1238,394
20443,0,0,58,0,-58
20444,0,0,4,0,-4
20445,0,0,36,0,-36
20446,0,0,50,0,-50
20447,0,0,121,0,-121
20448,0,0,5,0,-5
20449,0,0,68,0,-68
20450,0,0,3,0,-3
20451,0,0,13,0,-13
20452,1,1,2389,1281,-1108
20453,1,0,107,0,-107
20454,1,0,33,0,-33
20455,1,1,295,1976,1681
20456,0,0,115,0,-115
20457,1,0,46,0,-46
20458,1,1,225,1382,1157
20459,0,0,9,0,-9
20460,1,1,753,2746,1993
20461,0,0,0,0,0
20462,1,0,31,0,-31
20463,0,0,1,0,-1
20464,1,0,38,0,-38
20465,0,0,39,0,-39
20466,1,0,165,0,-165
20467,0,0,2,0,-2
20468,1,0,65,0,-65
20469,0,0,7,0,-7
20470,1,1,813,1601,788
20471,1,0,77,0,-77
20472,0,0,68,0,-68
20473,1,0,54,0,-54
20474,1,0,63,0,-63
20475,1,1,37,1345,1308
20476,1,1,101,1355,1254
20477,0,0,21,0,-21
20478,1,0,2,0,-2
20479,1,0,60,0,-60
20480,1,1,530,2441,1911
20481,1,1,3099,1976,-1123
20482,0,0,24,0,-24
20483,1,1,158,1269,1111
20484,0,0,17,0,-17
20485,1,1,1795,1733,-62
20486,0,0,17,0,-17
20487,1,0,1,0,-1
20488,1,0,46,0,-46
20489,1,0,129,0,-129
20490,1,1,57,1488,1431
20491,0,0,12,0,-12
20492,0,0,100,0,-100
20493,1,0,105,0,-105
20494,1,1,359,1245,886
20495,0,0,65,0,-65
20496,0,0,1,0,-1
20497,1,1,215,2303,2088
20498,1,1,630,1815,1185
20499,1,1,1626,1812,186
20500,0,0,68,0,-68
20501,0,0,7,0,-7
20502,0,0,9,0,-9
20503,0,0,78,0,-78
20504,1,0,8,0,-8
20505,0,0,84,0,-84
20506,1,0,23,0,-23
20507,1,0,30,0,-30
20508,1,1,137,1457,1320
20509,1,0,270,0,-270
20510,0,0,68,0,-68
20511,0,0,63,0,-63
20512,1,1,573,1252,679
20513,1,0,10,0,-10
20514,0,0,54,0,-54
20515,0,0,115,0,-115
20516,1,0,58,0,-58
20517,1,1,197,1312,1115
20518,0,0,54,0,-54
20519,0,0,11,0,-11
20520,1,0,105,0,-105
20521,0,0,99,0,-99
20522,1,1,316,1947,1631
20523,0,0,80,0,-80
20524,1,1,157,1379,1222
20525,0,0,138,0,-138
20526,0,0,28,0,-28
20527,1,1,257,1242,985
20528,0,0,41,0,-41
20529,1,1,1064,2222,1158
20530,0,0,39,0,-39
20531,1,0,205,0,-205
20532,0,0,44,0,-44
20533,0,0,86,0,-86
20534,0,0,2,0,-2
20535,1,1,161,1448,1287
20536,0,0,52,0,-52
20537,1,0,8,0,-8
20538,0,0,60,0,-60
20539,1,0,14,0,-14
20540,1,0,121,0,-121
20541,1,1,362,2444,2082
20542,1,1,85,1291,1206
20543,1,0,17,0,-17
20544,1,1,1757,2872,1115
20545,1,1,479,1279,800
20546,1,1,267,1261,994
20547,1,0,5,0,-5
20548,0,0,36,0,-36
20549,0,0,51,0,-51
20550,0,0,76,0,-76
20551,0,0,59,0,-59
20552,0,0,36,0,-36
20553,0,0,8,0,-8
20554,0,0,40,0,-40
20555,0,0,61,0,-61
20556,0,0,23,0,-23
20557,1,1,2200,1383,-817
20558,0,0,28,0,-28
20559,1,0,144,0,-144
20560,0,0,4,0,-4
20561,1,1,1910,2315,405
20562,0,0,15,0,-15
20563,1,0,8,0,-8
20564,1,1,837,1874,1037
20565,1,0,15,0,-15
20566,1,1,979,1651,672
20567,1,1,555,2637,2082
20568,1,0,40,0,-40
20569,0,0,4,0,-4
20570,1,1,90,1334,1244
20571,1,0,36,0,-36
20572,1,0,0,0,0
20573,0,0,5,0,-5
20574,1,1,272,1660,1388
20575,0,0,117,0,-117
20576,1,0,150,0,-150
20577,0,0,26,0,-26
20578,1,0,46,0,-46
20579,1,0,52,0,-52
20580,0,0,13,0,-13
20581,0,0,113,0,-113
20582,1,1,2002,1435,-567
20583,1,0,4,0,-4
20584,1,1,409,2129,1720
20585,1,0,7,0,-7
20586,0,0,26,0,-26
20587,0,0,119,0,-119
20588,0,0,32,0,-32
20589,1,0,7,0,-7
20590,1,0,93,0,-93
20591,0,0,12,0,-12
20592,1,0,52,0,-52
20593,1,1,10,1242,1232
20594,1,0,30,0,-30
20595,1,0,5,0,-5
20596,1,0,202,0,-202
20597,1,0,71,0,-71
20598,1,0,39,0,-39
20599,0,0,93,0,-93
20600,1,1,370,1402,1032
20601,0,0,38,0,-38
20602,1,0,7,0,-7
20603,1,1,1622,1446,-176
20604,1,1,332,1305,973
20605,0,0,57,0,-57
20606,1,1,72,1486,1414
20607,0,0,35,0,-35
20608,0,0,54,0,-54
20609,0,0,87,0,-87
20610,1,0,16,0,-16
20611,0,0,81,0,-81
20612,0,0,6,0,-6
20613,0,0,1,0,-1
20614,1,1,463,1460,997
20615,1,0,8,0,-8
20616,0,0,35,0,-35
20617,0,0,15,0,-15
20618,0,0,49,0,-49
20619,1,0,14,0,-14
20620,1,0,1,0,-1
20621,0,0,46,0,-46
20622,1,1,437,1283,846
20623,1,1,130,1598,1468
20624,1,0,45,0,-45
20625,1,0,11,0,-11
20626,1,1,64,1448,1384
20627,1,1,448,1385,937
20628,1,1,772,2100,1328
20629,1,1,86,1418,1332
20630,0,0,117,0,-117
20631,0,0,0,0,0
20632,0,0,75,0,-75
20633,0,0,22,0,-22
20634,1,0,11,0,-11
20635,1,1,594,1302,708
20636,1,1,458,1284,826
20637,1,1,355,1588,1233
20638,1,0,14,0,-14
20639,1,0,35,0,-35
20640,1,1,191,1448,1257
20641,0,0,46,0,-46
20642,1,1,691,1846,1155
20643,0,0,10,0,-10
20644,0,0,15,0,-15
20645,0,0,76,0,-76
20646,1,1,362,1396,1034
20647,0,0,2,0,-2
20648,1,0,16,0,-16
20649,1,1,808,1376,568
20650,0,0,1,0,-1
20651,1,1,482,1370,888
20652,0,0,74,0,-74
20653,1,1,275,2753,2478
20654,0,0,17,0,-17
20655,1,1,716,1417,701
20656,0,0,10,0,-10
20657,1,0,42,0,-42
20658,1,1,782,5454,4672
20659,1,1,213,1798,1585
20660,0,0,2,0,-2
20661,1,1,363,1238,875
20662,1,0,39,0,-39
20663,1,1,234,1606,1372
20664,1,0,3,0,-3
20665,1,1,16,1756,1740
20666,1,0,6,0,-6
20667,0,0,98,0,-98
20668,0,0,110,0,-110
20669,0,0,4,0,-4
20670,1,0,25,0,-25
20671,0,0,44,0,-44
20672,0,0,20,0,-20
20673,1,1,799,1278,479
20674,1,0,18,0,-18
20675,1,1,593,1396,803
20676,1,0,70,0,-70
20677,0,0,32,0,-32
20678,0,0,33,0,-33
20679,1,1,1089,1841,752
20680,1,1,461,1281,820
20681,0,0,324,0,-324
20682,0,0,11,0,-11
20683,1,1,841,1480,639
20684,0,0,53,0,-53
20685,1,1,740,1332,592
20686,0,0,36,0,-36
20687,0,0,41,0,-41
20688,0,0,8,0,-8
20689,1,0,13,0,-13
20690,1,0,59,0,-59
20691,0,0,5,0,-5
20692,1,0,21,0,-21
20693,0,0,54,0,-54
20694,1,0,151,0,-151
20695,0,0,29,0,-29
20696,0,0,29,0,-29
20697,1,1,171,1348,1177
20698,0,0,4,0,-4
20699,1,0,127,0,-127
20700,0,0,56,0,-56
20701,1,1,160,1330,1170
20702,1,0,109,0,-109
20703,1,1,250,1339,1089
20704,0,0,41,0,-41
20705,1,0,218,0,-218
20706,1,0,10,0,-10
20707,0,0,108,0,-108
20708,1,1,36,1724,1688
20709,1,1,64,1251,1187
20710,0,0,6,0,-6
20711,1,1,1815,1342,-473
20712,1,0,54,0,-54
20713,0,0,138,0,-138
20714,0,0,27,0,-27
20715,1,0,47,0,-47
20716,1,1,481,1370,889
20717,0,0,59,0,-59
20718,1,1,929,1497,568
20719,1,1,529,1269,740
20720,1,1,889,1269,380
20721,1,1,399,1260,861
20722,1,0,2,0,-2
20723,1,0,17,0,-17
20724,1,0,53,0,-53
20725,0,0,29,0,-29
20726,0,0,45,0,-45
20727,0,0,72,0,-72
20728,0,0,244,0,-244
20729,0,0,87,0,-87
20730,0,0,53,0,-53
20731,1,0,6,0,-6
20732,1,1,191,1505,1314
20733,0,0,5,0,-5
20734,1,1,208,1352,1144
20735,1,1,136,1524,1388
20736,1,1,745,1282,537
20737,1,0,4,0,-4
20738,1,0,81,0,-81
20739,0,0,69,0,-69
20740,0,0,98,0,-98
20741,1,0,28,0,-28
20742,0,0,62,0,-62
20743,1,1,376,1845,1469
20744,1,1,352,1577,1225
20745,0,0,127,0,-127
20746,0,0,76,0,-76
20747,0,0,64,0,-64
20748,1,1,263,1369,1106
20749,1,0,17,0,-17
20750,0,0,68,0,-68
20751,0,0,4,0,-4
20752,0,0,28,0,-28
20753,0,0,9,0,-9
20754,0,0,56,0,-56
20755,1,0,160,0,-160
20756,1,0,2,0,-2
20757,1,1,527,1245,718
20758,0,0,47,0,-47
20759,1,0,34,0,-34
20760,1,0,98,0,-98
20761,1,1,626,1278,652
20762,1,1,584,1263,679
20763,1,0,138,0,-138
20764,1,0,5,0,-5
20765,1,1,683,1444,761
20766,1,1,137,1617,1480
20767,0,0,26,0,-26
20768,1,1,636,1569,933
20769,0,0,49,0,-49
20770,0,0,12,0,-12
20771,0,0,34,0,-34
20772,1,0,36,0,-36
20773,1,0,65,0,-65
20774,0,0,40,0,-40
20775,0,0,236,0,-236
20776,0,0,59,0,-59
20777,0,0,59,0,-59
20778,1,0,29,0,-29
20779,0,0,3,0,-3
20780,0,0,55,0,-55
20781,0,0,82,0,-82
20782,0,0,151,0,-151
20783,1,1,267,1336,1069
20784,0,0,7,0,-7
20785,0,0,3,0,-3
20786,1,1,804,1571,767
20787,0,0,1,0,-1
20788,0,0,55,0,-55
20789,1,1,1010,1323,313
20790,1,1,89,1759,1670
20791,0,0,46,0,-46
20792,0,0,44,0,-44
20793,1,0,11,0,-11
20794,1,1,1705,1873,168
20795,1,0,59,0,-59
20796,0,0,66,0,-66
20797,1,1,60,3832,3772
20798,1,1,132,1236,1104
20799,0,0,77,0,-77
20800,1,1,2184,1242,-942
20801,0,0,25,0,-25
20802,0,0,134,0,-134
20803,1,0,86,0,-86
20804,1,1,531,1432,901
20805,1,1,241,1418,1177
20806,1,0,21,0,-21
20807,0,0,142,0,-142
20808,0,0,57,0,-57
20809,0,0,26,0,-26
20810,1,0,26,0,-26
20811,0,0,82,0,-82
20812,0,0,17,0,-17
20813,0,0,51,0,-51
20814,1,0,80,0,-80
20815,0,0,2,0,-2
20816,0,0,4,0,-4
20817,0,0,24,0,-24
20818,1,0,21,0,-21
20819,1,1,177,1949,1772
20820,1,1,466,1646,1180
20821,1,0,55,0,-55
20822,0,0,71,0,-71
20823,1,1,1184,1284,100
20824,1,0,100,0,-100
20825,0,0,56,0,-56
20826,0,0,13,0,-13
20827,0,0,66,0,-66
20828,0,0,53,0,-53
20829,1,1,560,1373,813
20830,0,0,52,0,-52
20831,0,0,4,0,-4
20832,1,1,590,1960,1370
20833,0,0,94,0,-94
20834,1,0,68,0,-68
20835,1,1,518,1286,768
20836,1,0,23,0,-23
20837,1,0,108,0,-108
20838,1,1,202,1911,1709
20839,1,1,385,1602,1217
20840,1,1,647,1413,766
20841,0,0,23,0,-23
20842,0,0,69,0,-69
20843,1,1,87,1415,1328
20844,1,1,342,2013,1671
20845,1,0,33,0,-33
20846,0,0,14,0,-14
20847,1,1,172,1547,1375
20848,1,0,86,0,-86
20849,0,0,74,0,-74
20850,1,1,459,3921,3462
20851,1,0,76,0,-76
20852,1,1,372,1495,1123
20853,1,0,7,0,-7
20854,0,0,49,0,-49
20855,1,1,546,1367,821
20856,1,0,53,0,-53
20857,1,1,142,1773,1631
20858,1,1,643,1560,917
20859,0,0,33,0,-33
20860,1,1,593,1559,966
20861,0,0,42,0,-42
20862,0,0,16,0,-16
20863,1,0,83,0,-83
20864,1,0,70,0,-70
20865,0,0,60,0,-60
20866,0,0,73,0,-73
20867,1,1,73,1289,1216
20868,0,0,22,0,-22
20869,0,0,64,0,-64
20870,0,0,17,0,-17
20871,0,0,36,0,-36
20872,1,0,3,0,-3
20873,1,1,1856,1336,-520
20874,1,0,63,0,-63
20875,0,0,1,0,-1
20876,0,0,23,0,-23
20877,1,1,1164,1377,213
20878,1,1,91,1429,1338
20879,1,0,29,0,-29
20880,1,1,579,1782,1203
20881,1,1,333,1603,1270
20882,1,1,219,2150,1931
20883,1,1,88,2356,2268
20884,1,1,239,1426,1187
20885,1,0,4,0,-4
20886,0,0,32,0,-32
20887,1,1,25,1510,1485
20888,1,0,81,0,-81
20889,0,0,16,0,-16
20890,0,0,28,0,-28
20891,0,0,9,0,-9
20892,1,0,171,0,-171
20893,0,0,11,0,-11
20894,1,0,131,0,-131
20895,1,1,247,1508,1261
20896,1,0,35,0,-35
20897,1,0,26,0,-26
20898,0,0,34,0,-34
20899,0,0,15,0,-15
20900,0,0,44,0,-44
20901,1,0,26,0,-26
20902,1,1,310,1527,1217
20903,1,1,404,1585,1181
20904,1,1,384,2189,1805
20905,1,1,1515,1290,-225
20906,1,1,204,1951,1747
20907,1,1,476,1261,785
20908,1,1,856,2226,1370
20909,1,1,194,1239,1045
20910,0,0,97,0,-97
20911,0,0,13,0,-13
20912,1,1,401,1297,896
20913,1,1,271,1269,998
20914,1,0,35,0,-35
20915,0,0,44,0,-44
20916,1,0,208,0,-208
20917,0,0,73,0,-73
20918,0,0,59,0,-59
20919,1,1,123,1420,1297
20920,0,0,44,0,-44
20921,1,0,14,0,-14
20922,0,0,156,0,-156
20923,1,0,40,0,-40
20924,0,0,44,0,-44
20925,1,0,43,0,-43
20926,1,1,1242,1396,154
20927,1,1,101,2006,1905
20928,1,1,1462,1309,-153
20929,1,1,55,2240,2185
20930,1,0,71,0,-71
20931,0,0,60,0,-60
20932,0,0,33,0,-33
20933,0,0,63,0,-63
20934,0,0,97,0,-97
20935,0,0,11,0,-11
20936,1,0,62,0,-62
20937,1,0,213,0,-213
20938,0,0,26,0,-26
20939,1,1,237,1272,1035
20940,0,0,8,0,-8
20941,1,0,11,0,-11
20942,0,0,1,0,-1
20943,0,0,43,0,-43
20944,0,0,34,0,-34
20945,0,0,26,0,-26
20946,0,0,5,0,-5
20947,1,1,1393,2279,886
20948,1,1,443,1330,887
20949,1,0,0,0,0
20950,0,0,31,0,-31
20951,0,0,28,0,-28
20952,1,0,154,0,-154
20953,0,0,8,0,-8
20954,1,1,313,1789,1476
20955,0,0,6,0,-6
20956,0,0,20,0,-20
20957,1,1,1465,1465,0
20958,1,0,3,0,-3
20959,1,1,385,1311,926
20960,1,0,186,0,-186
20961,1,1,157,1394,1237
20962,0,0,3,0,-3
20963,1,1,626,1239,613
20964,0,0,84,0,-84
20965,1,0,0,0,0
20966,0,0,11,0,-11
20967,0,0,41,0,-41
20968,0,0,18,0,-18
20969,1,1,502,1275,773
20970,0,0,10,0,-10
20971,1,0,24,0,-24
20972,0,0,122,0,-122
20973,1,1,198,1302,1104
20974,0,0,45,0,-45
20975,1,1,1696,1260,-436
20976,1,0,17,0,-17
20977,0,0,105,0,-105
20978,1,1,124,1276,1152
20979,1,0,9,0,-9
20980,1,1,390,1635,1245
20981,0,0,93,0,-93
20982,0,0,36,0,-36
20983,0,0,112,0,-112
20984,0,0,3,0,-3
20985,0,0,15,0,-15
20986,1,1,1277,1912,635
20987,1,0,110,0,-110
20988,0,0,21,0,-21
20989,0,0,60,0,-60
20990,0,0,62,0,-62
20991,0,0,14,0,-14
20992,0,0,26,0,-26
20993,0,0,27,0,-27
20994,1,1,535,1638,1103
20995,1,1,28,1510,1482
20996,1,1,347,1336,989
20997,1,0,28,0,-28
20998,0,0,15,0,-15
20999,1,0,86,0,-86
21000,1,0,300,0,-300
21001,1,0,7,0,-7
21002,1,0,118,0,-118
21003,1,0,52,0,-52
21004,1,1,728,1313,585
21005,1,1,164,1882,1718
21006,1,1,927,1249,322
21007,0,0,59,0,-59
21008,0,0,4,0,-4
21009,1,1,1013,1365,352
21010,1,0,59,0,-59
21011,1,1,899,1345,446
21012,1,0,7,0,-7
21013,1,1,76,1236,1160
21014,1,0,225,0,-225
21015,1,1,2141,1305,-836
21016,1,0,205,0,-205
21017,1,0,19,0,-19
21018,1,0,28,0,-28
21019,1,0,26,0,-26
21020,1,1,262,2454,2192
21021,1,1,340,1828,1488
21022,1,1,193,2301,2108
21023,0,0,25,0,-25
21024,1,0,30,0,-30
21025,0,0,27,0,-27
21026,1,0,8,0,-8
21027,0,0,23,0,-23
21028,1,1,174,1860,1686
21029,0,0,2,0,-2
21030,1,1,1135,1916,781
21031,1,0,93,0,-93
21032,1,0,72,0,-72
21033,1,1,844,1368,524
21034,0,0,15,0,-15
21035,1,0,16,0,-16
21036,0,0,148,0,-148
21037,1,0,109,0,-109
21038,1,1,189,1483,1294
21039,1,0,73,0,-73
21040,1,1,108,1348,1240
21041,1,1,112,1271,1159
21042,1,0,139,0,-139
21043,0,0,61,0,-61
21044,0,0,154,0,-154
21045,1,1,1003,1330,327
21046,1,1,94,1342,1248
21047,1,0,6,0,-6
21048,0,0,15,0,-15
21049,1,1,408,1286,878
21050,0,0,47,0,-47
21051,1,1,50,1797,1747
21052,1,1,231,1535,1304
21053,1,0,35,0,-35
21054,1,1,28,1302,1274
21055,0,0,1,0,-1
21056,1,0,20,0,-20
21057,1,1,34,1915,1881
21058,1,1,2151,4789,2638
21059,0,0,2,0,-2
21060,0,0,20,0,-20
21061,0,0,73,0,-73
21062,0,0,26,0,-26
21063,1,1,361,1984,1623
21064,1,1,237,2468,2231
21065,1,0,120,0,-120
21066,1,1,125,1236,1111
21067,0,0,39,0,-39
21068,0,0,35,0,-35
21069,0,0,69,0,-69
21070,1,1,914,1417,503
21071,1,0,57,0,-57
21072,0,0,25,0,-25
21073,0,0,9,0,-9
21074,1,0,182,0,-182
21075,0,0,65,0,-65
21076,1,1,133,1446,1313
21077,1,1,173,1245,1072
21078,0,0,19,0,-19
21079,1,0,96,0,-96
21080,0,0,54,0,-54
21081,0,0,10,0,-10
21082,1,1,981,1318,337
21083,0,0,109,0,-109
21084,1,0,36,0,-36
21085,1,0,90,0,-90
21086,0,0,110,0,-110
21087,0,0,10,0,-10
21088,0,0,26,0,-26
21089,0,0,89,0,-89
21090,1,1,180,1668,1488
21091,1,0,44,0,-44
21092,1,0,103,0,-103
21093,1,0,101,0,-101
21094,1,1,1052,2010,958
21095,0,0,40,0,-40
21096,0,0,5,0,-5
21097,1,0,51,0,-51
21098,0,0,120,0,-120
21099,1,0,84,0,-84
21100,1,1,49,2005,1956
21101,0,0,74,0,-74
21102,1,1,169,1449,1280
21103,1,0,5,0,-5
21104,1,1,763,1618,855
21105,0,0,41,0,-41
21106,1,1,261,1829,1568
21107,0,0,282,0,-282
21108,1,0,26,0,-26
21109,0,0,18,0,-18
21110,0,0,105,0,-105
21111,0,0,15,0,-15
21112,1,0,24,0,-24
21113,0,0,17,0,-17
21114,0,0,66,0,-66
21115,1,1,257,1255,998
21116,1,0,0,0,0
21117,1,0,36,0,-36
21118,1,0,19,0,-19
21119,0,0,137,0,-137
21120,1,0,134,0,-134
21121,0,0,124,0,-124
21122,0,0,194,0,-194
21123,0,0,155,0,-155
21124,1,1,197,1238,1041
21125,0,0,56,0,-56
21126,0,0,41,0,-41
21127,0,0,91,0,-91
21128,1,0,18,0,-18
21129,1,1,230,2154,1924
21130,0,0,21,0,-21
21131,1,1,814,1578,764
21132,1,1,1008,1345,337
21133,0,0,37,0,-37
21134,0,0,33,0,-33
21135,1,1,717,1521,804
21136,0,0,79,0,-79
21137,0,0,12,0,-12
21138,1,1,728,1578,850
21139,0,0,1,0,-1
21140,1,1,691,1650,959
21141,1,0,42,0,-42
21142,1,1,766,1698,932
21143,0,0,83,0,-83
21144,0,0,24,0,-24
21145,1,1,355,1390,1035
21146,1,1,1076,1309,233
21147,1,0,26,0,-26
21148,1,0,34,0,-34
21149,0,0,35,0,-35
21150,1,0,47,0,-47
21151,1,1,219,1243,1024
21152,1,1,1595,1290,-305
21153,1,0,12,0,-12
21154,0,0,82,0,-82
21155,0,0,24,0,-24
21156,0,0,23,0,-23
21157,0,0,39,0,-39
21158,0,0,91,0,-91
21159,0,0,21,0,-21
21160,0,0,4,0,-4
21161,1,1,1639,1241,-398
21162,1,1,61,1941,1880
21163,1,0,29,0,-29
21164,1,0,351,0,-351
21165,1,0,70,0,-70
21166,0,0,36,0,-36
21167,1,1,339,2046,1707
21168,1,1,412,1398,986
21169,0,0,5,0,-5
21170,0,0,12,0,-12
21171,1,0,7,0,-7
21172,0,0,1,0,-1
21173,1,0,14,0,-14
21174,1,1,106,1264,1158
21175,0,0,6,0,-6
21176,1,0,78,0,-78
21177,0,0,12,0,-12
21178,1,0,1,0,-1
21179,1,1,143,1496,1353
21180,0,0,28,0,-28
21181,0,0,37,0,-37
21182,0,0,18,0,-18
21183,0,0,26,0,-26
21184,0,0,35,0,-35
21185,0,0,28,0,-28
21186,0,0,71,0,-71
21187,0,0,0,0,0
21188,1,1,391,1405,1014
21189,1,0,41,0,-41
21190,0,0,56,0,-56
21191,0,0,0,0,0
21192,1,1,765,1704,939
21193,1,0,159,0,-159
21194,1,1,200,1289,1089
21195,0,0,29,0,-29
21196,1,0,232,0,-232
21197,1,1,292,1704,1412
21198,1,0,16,0,-16
21199,1,0,3,0,-3
21200,0,0,95,0,-95
21201,0,0,8,0,-8
21202,0,0,65,0,-65
21203,0,0,25,0,-25
21204,0,0,12,0,-12
21205,0,0,12,0,-12
21206,1,1,916,1272,356
21207,1,0,18,0,-18
21208,1,1,824,1637,813
21209,1,1,1069,1460,391
21210,0,0,104,0,-104
21211,1,0,58,0,-58
21212,1,1,1033,1505,472
21213,1,1,594,1426,832
21214,0,0,105,0,-105
21215,0,0,22,0,-22
21216,1,0,12,0,-12
21217,1,1,501,1976,1475
21218,0,0,16,0,-16
21219,1,1,182,1395,1213
21220,1,1,87,2242,2155
21221,1,0,46,0,-46
21222,0,0,27,0,-27
21223,1,1,1135,1337,202
21224,0,0,30,0,-30
21225,0,0,38,0,-38
21226,0,0,1,0,-1
21227,1,0,32,0,-32
21228,1,0,65,0,-65
21229,1,0,18,0,-18
21230,0,0,5,0,-5
21231,1,1,42,1305,1263
21232,1,0,47,0,-47
21233,1,0,99,0,-99
21234,0,0,86,0,-86
21235,0,0,156,0,-156
21236,0,0,155,0,-155
21237,0,0,17,0,-17
21238,1,1,146,2013,1867
21239,1,1,61,1595,1534
21240,0,0,48,0,-48
21241,1,1,326,1377,1051
21242,0,0,46,0,-46
21243,1,1,173,1807,1634
21244,0,0,70,0,-70
21245,1,1,755,1819,1064
21246,0,0,19,0,-19
21247,1,1,870,1658,788
21248,1,0,19,0,-19
21249,0,0,7,0,-7
21250,0,0,18,0,-18
21251,0,0,52,0,-52
21252,0,0,3,0,-3
21253,1,0,7,0,-7
21254,1,0,107,0,-107
21255,1,0,71,0,-71
21256,1,0,2,0,-2
21257,0,0,134,0,-134
21258,0,0,4,0,-4
21259,1,1,839,1303,464
21260,1,1,138,1265,1127
21261,1,1,234,1263,1029
21262,1,0,3,0,-3
21263,1,1,138,1538,1400
21264,0,0,82,0,-82
21265,1,1,117,2718,2601
21266,1,1,324,1972,1648
21267,1,1,1141,1267,126
21268,1,0,19,0,-19
21269,0,0,64,0,-64
21270,0,0,30,0,-30
21271,0,0,88,0,-88
21272,1,1,280,1387,1107
21273,1,0,32,0,-32
21274,0,0,24,0,-24
21275,1,0,28,0,-28
21276,0,0,8,0,-8
21277,1,0,96,0,-96
21278,1,0,66,0,-66
21279,0,0,94,0,-94
21280,0,0,3,0,-3
21281,1,0,16,0,-16
21282,1,0,28,0,-28
21283,0,0,34,0,-34
21284,1,0,147,0,-147
21285,0,0,4,0,-4
21286,0,0,16,0,-16
21287,0,0,7,0,-7
21288,0,0,5,0,-5
21289,1,1,914,1725,811
21290,1,0,5,0,-5
21291,1,1,658,1635,977
21292,0,0,2,0,-2
21293,1,1,215,1477,1262
21294,0,0,101,0,-101
21295,1,1,2643,1342,-1301
21296,1,0,142,0,-142
21297,1,0,171,0,-171
21298,0,0,2,0,-2
21299,0,0,43,0,-43
21300,0,0,155,0,-155
21301,1,0,0,0,0
21302,1,1,182,1625,1443
21303,1,1,1581,1356,-225
21304,1,1,693,1237,544
21305,0,0,23,0,-23
21306,0,0,109,0,-109
21307,0,0,33,0,-33
21308,1,1,42,1295,1253
21309,0,0,39,0,-39
21310,0,0,7,0,-7
21311,0,0,21,0,-21
21312,1,0,0,0,0
21313,0,0,21,0,-21
21314,1,0,19,0,-19
21315,1,0,0,0,0
21316,1,1,279,2244,1965
21317,1,1,88,1286,1198
21318,1,0,15,0,-15
21319,0,0,260,0,-260
21320,1,0,274,0,-274
21321,1,1,1408,1253,-155
21322,1,0,59,0,-59
21323,0,0,23,0,-23
21324,1,1,139,1528,1389
21325,1,1,571,1246,675
21326,1,0,30,0,-30
21327,0,0,5,0,-5
21328,0,0,71,0,-71
21329,0,0,77,0,-77
21330,1,0,54,0,-54
21331,0,0,38,0,-38
21332,0,0,26,0,-26
21333,1,0,123,0,-123
21334,1,1,2869,1487,-1382
21335,1,0,99,0,-99
21336,0,0,37,0,-37
21337,1,1,323,5711,5388
21338,0,0,22,0,-22
21339,0,0,9,0,-9
21340,1,1,815,1944,1129
21341,0,0,198,0,-198
21342,0,0,59,0,-59
21343,1,0,76,0,-76
21344,0,0,55,0,-55
21345,0,0,42,0,-42
21346,0,0,0,0,0
21347,1,1,274,1377,1103
21348,0,0,35,0,-35
21349,1,1,397,2403,2006
21350,1,0,55,0,-55
21351,0,0,46,0,-46
21352,0,0,25,0,-25
21353,1,0,27,0,-27
21354,0,0,3,0,-3
21355,0,0,44,0,-44
21356,1,0,35,0,-35
21357,1,0,22,0,-22
21358,1,1,1264,1342,78
21359,1,0,15,0,-15
21360,1,1,737,2178,1441
21361,0,0,39,0,-39
21362,0,0,20,0,-20
21363,1,0,18,0,-18
21364,1,1,506,1254,748
21365,0,0,92,0,-92
21366,0,0,51,0,-51
21367,0,0,75,0,-75
21368,0,0,69,0,-69
21369,1,0,124,0,-124
21370,1,0,4,0,-4
21371,1,1,389,5184,4795
21372,1,1,714,1236,522
21373,1,0,119,0,-119
21374,1,1,282,1670,1388
21375,1,0,85,0,-85
21376,0,0,36,0,-36
21377,1,1,1377,2032,655
21378,0,0,45,0,-45
21379,0,0,20,0,-20
21380,0,0,237,0,-237
21381,0,0,51,0,-51
21382,1,0,14,0,-14
21383,0,0,6,0,-6
21384,1,1,338,2239,1901
21385,1,0,12,0,-12
21386,1,0,219,0,-219
21387,1,1,285,1320,1035
21388,1,1,92,1369,1277
21389,1,1,393,3673,3280
21390,1,1,47,2850,2803
21391,0,0,51,0,-51
21392,1,0,45,0,-45
21393,0,0,82,0,-82
21394,0,0,6,0,-6
21395,0,0,5,0,-5
21396,0,0,21,0,-21
21397,0,0,19,0,-19
21398,0,0,62,0,-62
21399,1,1,783,1770,987
21400,0,0,2,0,-2
21401,0,0,25,0,-25
21402,0,0,34,0,-34
21403,1,0,31,0,-31
21404,0,0,17,0,-17
21405,0,0,20,0,-20
21406,0,0,44,0,-44
21407,0,0,47,0,-47
21408,1,1,183,2831,2648
21409,0,0,37,0,-37
21410,1,1,592,1921,1329
21411,0,0,32,0,-32
21412,1,0,3,0,-3
21413,1,1,295,1400,1105
21414,0,0,11,0,-11
21415,0,0,10,0,-10
21416,0,0,10,0,-10
21417,1,1,1202,2604,1402
21418,0,0,57,0,-57
21419,0,0,97,0,-97
21420,0,0,22,0,-22
21421,1,0,123,0,-123
21422,1,0,74,0,-74
21423,0,0,7,0,-7
21424,1,1,276,1315,1039
21425,1,1,73,1254,1181
21426,1,1,807,1507,700
21427,0,0,277,0,-277
21428,0,0,34,0,-34
21429,1,0,17,0,-17
21430,1,1,856,2351,1495
21431,1,1,525,1558,1033
21432,1,0,47,0,-47
21433,1,0,33,0,-33
21434,1,0,66,0,-66
21435,1,1,1327,1565,238
21436,0,0,68,0,-68
21437,0,0,61,0,-61
21438,0,0,112,0,-112
21439,1,1,289,1632,1343
21440,0,0,23,0,-23
21441,1,1,213,2921,2708
21442,1,1,2103,3932,1829
21443,0,0,3,0,-3
21444,1,1,924,3604,2680
21445,1,0,23,0,-23
21446,0,0,84,0,-84
21447,1,1,151,1247,1096
21448,1,1,571,1246,675
21449,1,0,28,0,-28
21450,1,1,810,1541,731
21451,1,1,818,1317,499
21452,0,0,32,0,-32
21453,1,1,522,1284,762
21454,0,0,7,0,-7
21455,0,0,109,0,-109
21456,1,1,601,1296,695
21457,1,0,23,0,-23
21458,1,1,578,1510,932
21459,0,0,22,0,-22
21460,1,1,355,1295,940
21461,1,0,62,0,-62
21462,0,0,37,0,-37
21463,0,0,43,0,-43
21464,1,0,55,0,-55
21465,0,0,57,0,-57
21466,1,1,282,1548,1266
21467,1,0,16,0,-16
21468,1,0,52,0,-52
21469,1,1,106,1392,1286
21470,1,1,1613,2078,465
21471,1,1,1143,1907,764
21472,0,0,12,0,-12
21473,1,1,1463,3119,1656
21474,1,0,0,0,0
21475,1,0,12,0,-12
21476,0,0,85,0,-85
21477,1,0,126,0,-126
21478,1,0,1,0,-1
21479,0,0,2,0,-2
21480,1,0,79,0,-79
21481,1,1,54,1251,1197
21482,0,0,49,0,-49
21483,1,0,64,0,-64
21484,1,0,5,0,-5
21485,0,0,34,0,-34
21486,0,0,39,0,-39
21487,0,0,88,0,-88
21488,1,1,412,1614,1202
21489,0,0,32,0,-32
21490,1,0,9,0,-9
21491,1,0,22,0,-22
21492,1,1,792,1606,814
21493,1,1,304,1298,994
21494,1,1,364,1818,1454
21495,0,0,47,0,-47
21496,0,0,9,0,-9
21497,0,0,112,0,-112
21498,1,0,25,0,-25
21499,1,1,60,1380,1320
21500,0,0,29,0,-29
21501,1,0,7,0,-7
21502,0,0,16,0,-16
21503,1,1,318,1638,1320
21504,0,0,40,0,-40
21505,0,0,43,0,-43
21506,1,0,1,0,-1
21507,1,0,28,0,-28
21508,1,0,30,0,-30
21509,1,0,42,0,-42
21510,1,1,1958,1261,-697
21511,1,1,443,1566,1123
21512,0,0,95,0,-95
21513,0,0,70,0,-70
21514,0,0,169,0,-169
21515,1,0,36,0,-36
21516,1,1,1083,1607,524
21517,0,0,90,0,-90
21518,1,1,1077,1266,189
21519,0,0,58,0,-58
21520,1,1,748,1387,639
21521,1,1,224,1782,1558
21522,0,0,25,0,-25
21523,1,1,755,1349,594
21524,1,1,66,1666,1600
21525,1,1,126,1254,1128
21526,1,0,143,0,-143
21527,0,0,92,0,-92
21528,0,0,11,0,-11
21529,0,0,172,0,-172
21530,1,1,309,1288,979
21531,0,0,24,0,-24
21532,1,0,134,0,-134
21533,1,0,7,0,-7
21534,1,1,211,1264,1053
21535,1,0,61,0,-61
21536,1,1,392,1761,1369
21537,1,1,9,1334,1325
21538,0,0,1,0,-1
21539,0,0,14,0,-14
21540,1,0,11,0,-11
21541,0,0,69,0,-69
21542,1,1,47,1707,1660
21543,1,1,204,1307,1103
21544,1,0,44,0,-44
21545,0,0,55,0,-55
21546,1,0,135,0,-135
21547,1,0,0,0,0
21548,1,1,225,4435,4210
21549,1,0,51,0,-51
21550,1,0,10,0,-10
21551,0,0,136,0,-136
21552,1,1,627,1277,650
21553,0,0,78,0,-78
21554,0,0,18,0,-18
21555,0,0,16,0,-16
21556,1,1,117,1620,1503
21557,0,0,1,0,-1
21558,1,1,158,1513,1355
21559,1,1,144,2011,1867
21560,0,0,18,0,-18
21561,1,0,121,0,-121
21562,1,1,143,1689,1546
21563,1,1,555,1963,1408
21564,0,0,15,0,-15
21565,0,0,54,0,-54
21566,1,0,26,0,-26
21567,0,0,139,0,-139
21568,1,1,681,1271,590
21569,0,0,180,0,-180
21570,0,0,45,0,-45
21571,1,0,26,0,-26
21572,1,1,644,1473,829
21573,1,0,112,0,-112
21574,0,0,20,0,-20
21575,0,0,25,0,-25
21576,1,1,581,2703,2122
21577,1,0,55,0,-55
21578,1,1,498,1555,1057
21579,0,0,136,0,-136
21580,1,1,824,1370,546
21581,1,0,45,0,-45
21582,1,1,211,1316,1105
21583,1,1,153,1376,1223
21584,0,0,36,0,-36
21585,1,1,292,1336,1044
21586,1,0,1,0,-1
21587,1,0,12,0,-12
21588,1,1,157,1292,1135
21589,1,0,16,0,-16
21590,0,0,20,0,-20
21591,1,1,251,1293,1042
21592,1,0,2,0,-2
21593,0,0,25,0,-25
21594,0,0,35,0,-35
21595,1,0,51,0,-51
21596,0,0,5,0,-5
21597,0,0,56,0,-56
21598,1,0,114,0,-114
21599,0,0,2,0,-2
21600,1,0,1,0,-1
21601,1,0,45,0,-45
21602,1,1,75,1428,1353
21603,1,0,31,0,-31
21604,0,0,73,0,-73
21605,0,0,4,0,-4
21606,1,0,11,0,-11
21607,1,0,2,0,-2
21608,0,0,113,0,-113
21609,0,0,86,0,-86
21610,1,0,44,0,-44
21611,1,0,45,0,-45
21612,1,1,912,1421,509
21613,1,0,7,0,-7
21614,1,0,44,0,-44
21615,1,0,120,0,-120
21616,1,1,554,2538,1984
21617,0,0,62,0,-62
21618,0,0,31,0,-31
21619,1,0,27,0,-27
21620,0,0,13,0,-13
21621,1,0,32,0,-32
21622,1,0,88,0,-88
21623,1,1,56,1775,1719
21624,0,0,8,0,-8
21625,0,0,105,0,-105
21626,0,0,27,0,-27
21627,1,0,18,0,-18
21628,1,0,24,0,-24
21629,1,1,294,2177,1883
21630,1,1,438,1275,837
21631,0,0,156,0,-156
21632,1,1,445,1375,930
21633,0,0,57,0,-57
21634,1,0,52,0,-52
21635,1,0,39,0,-39
21636,1,0,8,0,-8
21637,0,0,63,0,-63
21638,0,0,15,0,-15
21639,1,0,54,0,-54
21640,1,0,22,0,-22
21641,1,0,24,0,-24
21642,0,0,6,0,-6
21643,0,0,107,0,-107
21644,1,0,319,0,-319
21645,1,1,5,1296,1291
21646,1,1,372,2570,2198
21647,1,0,24,0,-24
21648,1,0,58,0,-58
21649,0,0,9,0,-9
21650,1,1,1725,1403,-322
21651,1,1,30,1582,1552
21652,1,0,114,0,-114
21653,0,0,84,0,-84
21654,1,0,10,0,-10
21655,1,1,704,1305,601
21656,1,1,150,1331,1181
21657,1,0,7,0,-7
21658,0,0,4,0,-4
21659,1,0,90,0,-90
21660,1,0,153,0,-153
21661,1,0,26,0,-26
21662,1,0,20,0,-20
21663,0,0,118,0,-118
21664,0,0,59,0,-59
21665,0,0,27,0,-27
21666,0,0,48,0,-48
21667,1,1,218,1239,1021
21668,1,1,82,1251,1169
21669,0,0,39,0,-39
21670,1,1,601,1773,1172
21671,0,0,27,0,-27
21672,0,0,107,0,-107
21673,1,1,167,1757,1590
21674,0,0,23,0,-23
21675,1,0,226,0,-226
21676,1,1,537,1399,862
21677,0,0,23,0,-23
21678,0,0,6,0,-6
21679,0,0,16,0,-16
21680,0,0,31,0,-31
21681,1,0,59,0,-59
21682,1,1,517,1931,1414
21683,1,1,1073,1338,265
21684,1,1,399,1393,994
21685,1,1,185,3497,3312
21686,1,0,128,0,-128
21687,1,0,121,0,-121
21688,0,0,114,0,-114
21689,0,0,78,0,-78
21690,0,0,56,0,-56
21691,1,1,259,1588,1329
21692,1,1,1731,2014,283
21693,1,1,603,1360,757
21694,1,0,63,0,-63
21695,1,0,22,0,-22
21696,1,0,8,0,-8
21697,1,1,880,1581,701
21698,1,1,23,1311,1288
21699,1,1,979,1299,320
21700,1,0,54,0,-54
21701,1,1,812,1743,931
21702,1,1,1385,1396,11
21703,1,1,1068,1306,238
21704,0,0,0,0,0
21705,1,1,694,1271,577
21706,1,0,63,0,-63
21707,1,0,1,0,-1
21708,1,0,11,0,-11
21709,1,0,51,0,-51
21710,0,0,6,0,-6
21711,1,0,1,0,-1
21712,1,1,274,1374,1100
21713,1,1,127,1370,1243
21714,1,1,398,2200,1802
21715,0,0,27,0,-27
21716,0,0,25,0,-25
21717,0,0,7,0,-7
21718,1,0,48,0,-48
21719,1,0,89,0,-89
21720,0,0,1,0,-1
21721,1,0,20,0,-20
21722,1,1,940,1291,351
21723,0,0,1,0,-1
21724,1,0,6,0,-6
21725,0,0,24,0,-24
21726,1,1,627,1847,1220
21727,1,1,528,1258,730
21728,1,0,24,0,-24
21729,0,0,162,0,-162
21730,0,0,32,0,-32
21731,1,1,222,1742,1520
21732,1,1,1933,1366,-567
21733,1,0,21,0,-21
21734,0,0,9,0,-9
21735,1,1,615,3448,2833
21736,0,0,49,0,-49
21737,0,0,48,0,-48
21738,0,0,7,0,-7
21739,1,0,1,0,-1
21740,0,0,28,0,-28
21741,0,0,6,0,-6
21742,1,0,3,0,-3
21743,1,1,52,2060,2008
21744,1,0,26,0,-26
21745,0,0,12,0,-12
21746,0,0,40,0,-40
21747,1,0,81,0,-81
21748,1,1,472,1386,914
21749,1,0,17,0,-17
21750,1,1,178,2148,1970
21751,1,1,307,1404,1097
21752,1,1,865,1304,439
21753,1,0,57,0,-57
21754,0,0,20,0,-20
21755,1,0,29,0,-29
21756,0,0,4,0,-4
21757,0,0,62,0,-62
21758,0,0,24,0,-24
21759,1,1,103,1326,1223
21760,0,0,52,0,-52
21761,1,0,110,0,-110
21762,1,1,442,1276,834
21763,1,0,0,0,0
21764,1,1,367,1617,1250
21765,1,0,31,0,-31
21766,0,0,109,0,-109
21767,1,0,8,0,-8
21768,1,0,159,0,-159
21769,1,1,105,1486,1381
21770,1,0,44,0,-44
21771,1,0,9,0,-9
21772,0,0,10,0,-10
21773,1,1,85,1368,1283
21774,1,0,19,0,-19
21775,0,0,8,0,-8
21776,1,1,195,1316,1121
21777,1,1,2268,1385,-883
21778,0,0,1,0,-1
21779,0,0,59,0,-59
21780,1,1,1077,4310,3233
21781,1,1,119,1407,1288
21782,1,1,483,1301,818
21783,1,1,207,1451,1244
21784,1,0,13,0,-13
21785,1,0,12,0,-12
21786,1,1,1078,1779,701
21787,1,1,315,1255,940
21788,0,0,207,0,-207
21789,0,0,93,0,-93
21790,0,0,32,0,-32
21791,1,0,116,0,-116
21792,1,1,61,1410,1349
21793,1,1,378,1806,1428
21794,1,0,5,0,-5
21795,1,0,33,0,-33
21796,0,0,21,0,-21
21797,0,0,2,0,-2
21798,1,1,1595,8221,6626
21799,1,1,19,1259,1240
21800,0,0,95,0,-95
21801,1,1,1920,2034,114
21802,0,0,59,0,-59
21803,0,0,30,0,-30
21804,1,0,15,0,-15
21805,0,0,52,0,-52
21806,1,1,442,3451,3009
21807,1,1,376,1295,919
21808,1,1,1011,1269,258
21809,1,1,371,1650,1279
21810,0,0,43,0,-43
21811,1,0,8,0,-8
21812,1,1,637,1815,1178
21813,1,0,7,0,-7
21814,0,0,5,0,-5
21815,0,0,52,0,-52
21816,0,0,86,0,-86
21817,1,1,170,1612,1442
21818,1,0,37,0,-37
21819,0,0,133,0,-133
21820,0,0,106,0,-106
21821,1,1,206,1248,1042
21822,0,0,28,0,-28
21823,1,0,26,0,-26
21824,0,0,164,0,-164
21825,1,1,680,1392,712
21826,1,0,21,0,-21
21827,1,0,9,0,-9
21828,0,0,15,0,-15
21829,0,0,12,0,-12
21830,1,0,214,0,-214
21831,1,0,25,0,-25
21832,1,0,15,0,-15
21833,0,0,69,0,-69
21834,1,1,753,1451,698
21835,0,0,47,0,-47
21836,1,0,16,0,-16
21837,1,0,37,0,-37
21838,1,1,460,1446,986
21839,0,0,71,0,-71
21840,0,0,36,0,-36
21841,0,0,32,0,-32
21842,1,0,117,0,-117
21843,1,1,220,1324,1104
21844,0,0,44,0,-44
21845,1,0,24,0,-24
21846,1,1,74,1535,1461
21847,1,1,739,2107,1368
21848,1,0,50,0,-50
21849,1,0,102,0,-102
21850,0,0,6,0,-6
21851,1,1,460,1699,1239
21852,0,0,6,0,-6
21853,1,0,27,0,-27
21854,1,0,15,0,-15
21855,0,0,4,0,-4
21856,1,1,332,1444,1112
21857,1,1,674,1306,632
21858,1,0,56,0,-56
21859,1,0,7,0,-7
21860,1,0,115,0,-115
21861,1,0,186,0,-186
21862,0,0,126,0,-126
21863,1,0,19,0,-19
21864,0,0,36,0,-36
21865,0,0,2,0,-2
21866,0,0,127,0,-127
21867,1,0,69,0,-69
21868,0,0,40,0,-40
21869,0,0,125,0,-125
21870,1,0,55,0,-55
21871,1,1,566,1957,1391
21872,0,0,31,0,-31
21873,1,1,349,1588,1239
21874,1,0,56,0,-56
21875,1,0,1,0,-1
21876,1,1,905,1496,591
21877,0,0,95,0,-95
21878,0,0,10,0,-10
21879,0,0,20,0,-20
21880,0,0,112,0,-112
21881,0,0,39,0,-39
21882,0,0,6,0,-6
21883,1,1,1405,2236,831
21884,1,1,429,1333,904
21885,1,0,10,0,-10
21886,1,0,2,0,-2
21887,0,0,44,0,-44
21888,1,0,142,0,-142
21889,0,0,93,0,-93
21890,1,0,1,0,-1
21891,0,0,2,0,-2
21892,0,0,27,0,-27
21893,1,0,53,0,-53
21894,1,0,97,0,-97
21895,1,1,295,1752,1457
21896,1,1,49,1341,1292
21897,1,1,269,1800,1531
21898,1,0,6,0,-6
21899,0,0,25,0,-25
21900,0,0,17,0,-17
21901,1,1,2381,1383,-998
21902,1,0,73,0,-73
21903,1,0,50,0,-50
21904,0,0,123,0,-123
21905,0,0,79,0,-79
21906,0,0,21,0,-21
21907,0,0,58,0,-58
21908,1,1,1166,1250,84
21909,1,1,214,1663,1449
21910,1,1,406,1644,1238
21911,0,0,19,0,-19
21912,1,1,136,1288,1152
21913,1,0,52,0,-52
21914,1,0,115,0,-115
21915,0,0,73,0,-73
21916,1,0,2,0,-2
21917,0,0,71,0,-71
21918,0,0,5,0,-5
21919,0,0,74,0,-74
21920,1,0,0,0,0
21921,1,1,224,1249,1025
21922,1,1,75,1743,1668
21923,1,0,36,0,-36
21924,0,0,198,0,-198
21925,0,0,143,0,-143
21926,0,0,25,0,-25
21927,0,0,20,0,-20
21928,1,0,23,0,-23
21929,1,1,91,1388,1297
21930,0,0,6,0,-6
21931,1,1,524,1283,759
21932,0,0,4,0,-4
21933,0,0,63,0,-63
21934,1,0,10,0,-10
21935,1,0,13,0,-13
21936,1,0,23,0,-23
21937,0,0,4,0,-4
21938,1,1,773,1599,826
21939,1,1,197,1423,1226
21940,0,0,7,0,-7
21941,0,0,17,0,-17
21942,1,0,88,0,-88
21943,0,0,38,0,-38
21944,1,0,20,0,-20
21945,1,0,67,0,-67
21946,0,0,35,0,-35
21947,1,0,35,0,-35
21948,0,0,25,0,-25
21949,1,1,149,1619,1470
21950,1,0,163,0,-163
21951,1,1,224,1785,1561
21952,0,0,29,0,-29
21953,0,0,34,0,-34
21954,0,0,109,0,-109
21955,1,0,57,0,-57
21956,1,0,55,0,-55
21957,1,0,29,0,-29
21958,1,1,1219,1633,414
21959,0,0,129,0,-129
21960,1,0,13,0,-13
21961,0,0,37,0,-37
21962,1,1,587,2209,1622
21963,1,0,10,0,-10
21964,1,0,19,0,-19
21965,0,0,14,0,-14
21966,1,0,56,0,-56
21967,1,1,396,1301,905
21968,0,0,100,0,-100
21969,0,0,12,0,-12
21970,1,1,588,1323,735
21971,1,0,24,0,-24
21972,1,0,47,0,-47
21973,1,0,84,0,-84
21974,0,0,1,0,-1
21975,1,0,56,0,-56
21976,0,0,4,0,-4
21977,0,0,58,0,-58
21978,0,0,20,0,-20
21979,1,1,1735,1265,-470
21980,1,1,512,1377,865
21981,0,0,4,0,-4
21982,1,1,158,1361,1203
21983,1,0,7,0,-7
21984,1,0,8,0,-8
21985,1,1,579,1243,664
21986,1,1,459,1260,801
21987,0,0,17,0,-17
21988,1,0,43,0,-43
21989,1,0,22,0,-22
21990,1,1,569,1567,998
21991,0,0,39,0,-39
21992,1,1,488,1305,817
21993,1,1,304,1372,1068
21994,0,0,14,0,-14
21995,1,1,643,1325,682
21996,1,1,436,1457,1021
21997,0,0,119,0,-119
21998,1,0,99,0,-99
21999,0,0,38,0,-38
22000,0,0,26,0,-26
22001,0,0,16,0,-16
22002,1,1,322,2281,1959
22003,0,0,8,0,-8
22004,0,0,23,0,-23
22005,1,1,525,1308,783
22006,1,1,253,1251,998
22007,1,1,59,1669,1610
22008,1,0,6,0,-6
22009,0,0,78,0,-78
22010,0,0,6,0,-6
22011,0,0,8,0,-8
22012,0,0,28,0,-28
22013,0,0,10,0,-10
22014,0,0,13,0,-13
22015,1,1,532,1293,761
22016,1,0,165,0,-165
22017,1,1,1466,1475,9
22018,1,0,89,0,-89
22019,0,0,4,0,-4
22020,1,0,141,0,-141
22021,0,0,21,0,-21
22022,1,1,567,1320,753
22023,0,0,32,0,-32
22024,0,0,15,0,-15
22025,1,0,41,0,-41
22026,1,1,1044,2323,1279
22027,1,0,43,0,-43
22028,1,0,46,0,-46
22029,1,0,138,0,-138
22030,1,1,37,1774,1737
22031,0,0,22,0,-22
22032,1,1,325,1400,1075
22033,1,1,476,1396,920
22034,1,1,178,1863,1685
22035,1,1,43,1404,1361
22036,1,1,270,1526,1256
22037,1,0,26,0,-26
22038,1,0,0,0,0
22039,1,1,434,1441,1007
22040,0,0,61,0,-61
22041,1,0,253,0,-253
22042,0,0,35,0,-35
22043,0,0,62,0,-62
22044,1,0,3,0,-3
22045,0,0,14,0,-14
22046,0,0,18,0,-18
22047,1,0,190,0,-190
22048,0,0,58,0,-58
22049,1,1,988,1635,647
22050,1,1,403,1383,980
22051,0,0,45,0,-45
22052,1,1,855,1872,1017
22053,1,1,166,1448,1282
22054,1,1,353,1465,1112
22055,0,0,62,0,-62
22056,0,0,56,0,-56
22057,1,0,40,0,-40
22058,0,0,17,0,-17
22059,1,0,37,0,-37
22060,0,0,105,0,-105
22061,1,1,1341,1432,91
22062,0,0,49,0,-49
22063,0,0,20,0,-20
22064,0,0,10,0,-10
22065,0,0,21,0,-21
22066,0,0,55,0,-55
22067,1,1,624,1820,1196
22068,0,0,8,0,-8
22069,0,0,6,0,-6
22070,1,1,108,3803,3695
22071,1,1,335,1785,1450
22072,0,0,24,0,-24
22073,1,0,1,0,-1
22074,0,0,198,0,-198
22075,0,0,22,0,-22
22076,0,0,34,0,-34
22077,1,1,662,2376,1714
22078,1,1,108,1446,1338
22079,1,1,505,1252,747
22080,1,0,3,0,-3
22081,0,0,31,0,-31
22082,0,0,4,0,-4
22083,1,1,727,1509,782
22084,1,0,94,0,-94
22085,1,0,46,0,-46
22086,0,0,90,0,-90
22087,0,0,138,0,-138
22088,0,0,14,0,-14
22089,0,0,10,0,-10
22090,0,0,135,0,-135
22091,0,0,75,0,-75
22092,1,0,62,0,-62
22093,1,1,176,1766,1590
22094,0,0,56,0,-56
22095,1,0,19,0,-19
22096,1,0,20,0,-20
22097,0,0,7,0,-7
22098,0,0,23,0,-23
22099,0,0,97,0,-97
22100,1,0,13,0,-13
22101,1,1,514,1638,1124
22102,1,0,34,0,-34
22103,0,0,17,0,-17
22104,1,0,73,0,-73
22105,1,0,25,0,-25
22106,0,0,128,0,-128
22107,1,0,17,0,-17
22108,1,0,72,0,-72
22109,1,0,82,0,-82
22110,1,0,60,0,-60
22111,0,0,10,0,-10
22112,0,0,0,0,0
22113,1,1,279,1688,1409
22114,1,0,1,0,-1
22115,1,0,23,0,-23
22116,1,1,944,1427,483
22117,0,0,161,0,-161
22118,1,0,10,0,-10
22119,0,0,141,0,-141
22120,1,1,698,1256,558
22121,1,0,186,0,-186
22122,1,1,104,1284,1180
22123,1,1,1061,1723,662
22124,0,0,66,0,-66
22125,1,0,13,0,-13
22126,0,0,42,0,-42
22127,1,1,711,1662,951
22128,0,0,138,0,-138
22129,0,0,90,0,-90
22130,1,1,400,1779,1379
22131,0,0,121,0,-121
22132,1,0,38,0,-38
22133,0,0,46,0,-46
22134,1,0,57,0,-57
22135,1,1,698,1279,581
22136,1,1,60,1733,1673
22137,1,0,1,0,-1
22138,1,0,150,0,-150
22139,1,1,194,1931,1737
22140,0,0,29,0,-29
22141,1,1,447,1395,948
22142,1,0,35,0,-35
22143,1,1,763,1850,1087
22144,1,0,10,0,-10
22145,1,0,51,0,-51
22146,1,0,66,0,-66
22147,0,0,2,0,-2
22148,1,0,31,0,-31
22149,1,0,17,0,-17
22150,0,0,34,0,-34
22151,1,1,258,1645,1387
22152,0,0,45,0,-45
22153,1,1,177,1359,1182
22154,0,0,149,0,-149
22155,1,0,30,0,-30
22156,0,0,7,0,-7
22157,1,1,1084,1303,219
22158,0,0,6,0,-6
22159,1,1,299,1306,1007
22160,0,0,141,0,-141
22161,1,1,51,1503,1452
22162,1,0,19,0,-19
22163,0,0,22,0,-22
22164,1,1,610,12460,11850
22165,0,0,63,0,-63
22166,1,0,49,0,-49
22167,1,1,740,1489,749
22168,1,0,3,0,-3
22169,1,1,261,3089,2828
22170,1,0,18,0,-18
22171,1,1,265,1554,1289
22172,1,0,17,0,-17
22173,1,1,86,1425,1339
22174,1,0,215,0,-215
22175,1,1,148,1843,1695
22176,0,0,43,0,-43
22177,0,0,1,0,-1
22178,1,0,6,0,-6
22179,1,0,15,0,-15
22180,1,1,39,1303,1264
22181,1,0,5,0,-5
22182,0,0,26,0,-26
22183,1,1,500,1474,974
22184,1,1,621,1301,680
22185,1,0,0,0,0
22186,0,0,18,0,-18
22187,1,1,215,1778,1563
22188,0,0,33,0,-33
22189,0,0,56,0,-56
22190,0,0,122,0,-122
22191,1,1,582,1414,832
22192,1,1,1038,2933,1895
22193,0,0,8,0,-8
22194,1,1,144,1387,1243
22195,0,0,1,0,-1
22196,1,1,1095,2312,1217
22197,1,1,297,1431,1134
22198,0,0,87,0,-87
22199,1,0,103,0,-103
22200,1,1,632,1469,837
22201,0,0,81,0,-81
22202,1,1,97,1598,1501
22203,0,0,0,0,0
22204,1,0,24,0,-24
22205,1,0,43,0,-43
22206,0,0,116,0,-116
22207,0,0,14,0,-14
22208,1,0,13,0,-13
22209,1,1,606,1547,941
22210,1,1,115,1435,1320
22211,0,0,33,0,-33
22212,1,0,23,0,-23
22213,0,0,21,0,-21
22214,0,0,2,0,-2
22215,0,0,4,0,-4
22216,0,0,64,0,-64
22217,0,0,55,0,-55
22218,0,0,31,0,-31
22219,0,0,28,0,-28
22220,1,0,3,0,-3
22221,0,0,21,0,-21
22222,1,0,94,0,-94
22223,0,0,46,0,-46
22224,1,0,79,0,-79
22225,1,0,42,0,-42
22226,1,1,645,1513,868
22227,1,1,208,1423,1215
22228,0,0,100,0,-100
22229,0,0,6,0,-6
22230,1,1,301,1597,1296
22231,1,0,74,0,-74
22232,1,1,1001,1236,235
22233,0,0,28,0,-28
22234,0,0,84,0,-84
22235,0,0,150,0,-150
22236,0,0,185,0,-185
22237,0,0,23,0,-23
22238,0,0,15,0,-15
22239,0,0,8,0,-8
22240,0,0,44,0,-44
22241,1,0,9,0,-9
22242,0,0,34,0,-34
22243,0,0,31,0,-31
22244,1,1,574,2906,2332
22245,0,0,19,0,-19
22246,0,0,8,0,-8
22247,1,0,4,0,-4
22248,0,0,22,0,-22
22249,1,0,129,0,-129
22250,1,0,247,0,-247
22251,0,0,32,0,-32
22252,1,1,637,4705,4068
22253,0,0,16,0,-16
22254,0,0,25,0,-25
22255,1,1,711,1472,761
22256,1,0,27,0,-27
22257,0,0,130,0,-130
22258,1,0,73,0,-73
22259,0,0,11,0,-11
22260,0,0,7,0,-7
22261,1,0,10,0,-10
22262,1,0,7,0,-7
22263,0,0,27,0,-27
22264,1,0,28,0,-28
22265,1,1,1251,1430,179
22266,1,0,15,0,-15
22267,1,0,77,0,-77
22268,1,0,62,0,-62
22269,1,1,186,1365,1179
22270,1,0,15,0,-15
22271,1,1,254,1286,1032
22272,1,1,13,1318,1305
22273,1,0,31,0,-31
22274,1,1,1715,1440,-275
22275,1,0,38,0,-38
22276,1,0,7,0,-7
22277,0,0,29,0,-29
22278,1,1,481,1339,858
22279,0,0,100,0,-100
22280,0,0,100,0,-100
22281,1,1,276,2216,1940
22282,1,1,37,1365,1328
22283,1,1,440,1246,806
22284,1,1,54,1357,1303
22285,1,1,523,1274,751
22286,1,0,59,0,-59
22287,1,1,97,2203,2106
22288,1,0,53,0,-53
22289,0,0,0,0,0
22290,1,1,716,4919,4203
22291,0,0,7,0,-7
22292,0,0,45,0,-45
22293,1,0,33,0,-33
22294,1,1,113,1508,1395
22295,1,0,5,0,-5
22296,1,0,0,0,0
22297,1,0,32,0,-32
22298,1,0,3,0,-3
22299,0,0,6,0,-6
22300,1,1,171,1533,1362
22301,1,1,119,1554,1435
22302,0,0,79,0,-79
22303,0,0,80,0,-80
22304,0,0,26,0,-26
22305,1,1,366,1385,1019
22306,0,0,22,0,-22
22307,1,0,57,0,-57
22308,0,0,7,0,-7
22309,1,0,38,0,-38
22310,0,0,22,0,-22
22311,1,0,95,0,-95
22312,1,1,660,1539,879
22313,1,0,20,0,-20
22314,0,0,51,0,-51
22315,0,0,18,0,-18
22316,1,1,489,1761,1272
22317,0,0,7,0,-7
22318,0,0,1,0,-1
22319,0,0,32,0,-32
22320,0,0,34,0,-34
22321,1,1,285,1377,1092
22322,0,0,286,0,-286
22323,0,0,78,0,-78
22324,0,0,5,0,-5
22325,0,0,26,0,-26
22326,0,0,39,0,-39
22327,0,0,1,0,-1
22328,1,1,2187,1337,-850
22329,1,1,21,1850,1829
22330,1,1,223,1710,1487
22331,0,0,77,0,-77
22332,0,0,3,0,-3
22333,1,1,162,1691,1529
22334,0,0,44,0,-44
22335,1,0,15,0,-15
22336,1,1,783,1526,743
22337,1,0,0,0,0
22338,1,0,8,0,-8
22339,0,0,32,0,-32
22340,1,1,625,1557,932
22341,0,0,25,0,-25
22342,0,0,15,0,-15
22343,0,0,5,0,-5
22344,1,1,1435,1980,545
22345,0,0,41,0,-41
22346,1,0,19,0,-19
22347,0,0,46,0,-46
22348,0,0,157,0,-157
22349,1,1,468,1270,802
22350,1,1,1156,1280,124
22351,1,0,9,0,-9
22352,1,0,5,0,-5
22353,1,1,393,1525,1132
22354,1,1,152,1321,1169
22355,1,1,275,1356,1081
22356,1,0,70,0,-70
22357,0,0,77,0,-77
22358,0,0,105,0,-105
22359,1,0,130,0,-130
22360,0,0,2,0,-2
22361,0,0,26,0,-26
22362,1,1,1730,1716,-14
22363,0,0,49,0,-49
22364,1,1,300,1442,1142
22365,1,0,7,0,-7
22366,1,1,299,1366,1067
22367,1,0,32,0,-32
22368,1,0,73,0,-73
22369,1,0,19,0,-19
22370,1,1,339,1913,1574
22371,0,0,3,0,-3
22372,0,0,61,0,-61
22373,1,0,62,0,-62
22374,0,0,24,0,-24
22375,0,0,38,0,-38
22376,0,0,1,0,-1
22377,0,0,33,0,-33
22378,1,0,13,0,-13
22379,0,0,45,0,-45
22380,1,1,523,1704,1181
22381,0,0,31,0,-31
22382,0,0,72,0,-72
22383,1,1,317,1768,1451
22384,0,0,14,0,-14
22385,1,0,49,0,-49
22386,0,0,58,0,-58
22387,0,0,35,0,-35
22388,0,0,12,0,-12
22389,1,1,1975,1739,-236
22390,1,1,153,1470,1317
22391,1,0,52,0,-52
22392,0,0,16,0,-16
22393,1,1,645,1583,938
22394,1,0,84,0,-84
22395,1,0,22,0,-22
22396,1,0,8,0,-8
22397,1,0,99,0,-99
22398,1,1,295,1303,1008
22399,0,0,21,0,-21
22400,1,0,266,0,-266
22401,0,0,26,0,-26
22402,1,0,6,0,-6
22403,0,0,110,0,-110
22404,0,0,52,0,-52
22405,0,0,46,0,-46
22406,1,1,375,1287,912
22407,1,0,67,0,-67
22408,0,0,0,0,0
22409,1,0,53,0,-53
22410,0,0,131,0,-131
22411,0,0,188,0,-188
22412,1,0,33,0,-33
22413,1,1,961,1445,484
22414,1,0,38,0,-38
22415,1,0,46,0,-46
22416,1,1,90,1377,1287
22417,1,1,600,1605,1005
22418,1,1,312,1825,1513
22419,0,0,104,0,-104
22420,1,0,19,0,-19
22421,1,0,55,0,-55
22422,1,0,25,0,-25
22423,1,1,549,1297,748
22424,0,0,118,0,-118
22425,0,0,11,0,-11
22426,0,0,63,0,-63
22427,1,1,456,1256,800
22428,0,0,1,0,-1
22429,0,0,45,0,-45
22430,1,0,22,0,-22
22431,1,0,66,0,-66
22432,1,0,12,0,-12
22433,1,1,983,1850,867
22434,0,0,0,0,0
22435,1,0,78,0,-78
22436,1,0,0,0,0
22437,1,0,21,0,-21
22438,0,0,36,0,-36
22439,0,0,332,0,-332
22440,0,0,17,0,-17
22441,1,0,18,0,-18
22442,0,0,85,0,-85
22443,0,0,12,0,-12
22444,1,1,178,1700,1522
22445,0,0,43,0,-43
22446,1,0,34,0,-34
22447,0,0,67,0,-67
22448,1,1,409,1558,1149
22449,0,0,29,0,-29
22450,0,0,14,0,-14
22451,1,1,309,2365,2056
22452,0,0,20,0,-20
22453,1,1,470,1554,1084
22454,0,0,4,0,-4
22455,1,0,2,0,-2
22456,1,0,52,0,-52
22457,1,1,371,2714,2343
22458,1,0,7,0,-7
22459,1,1,243,1344,1101
22460,1,1,314,1374,1060
22461,0,0,3,0,-3
22462,0,0,2,0,-2
22463,0,0,10,0,-10
22464,0,0,39,0,-39
22465,1,1,2040,1347,-693
22466,0,0,215,0,-215
22467,1,1,1252,1235,-17
22468,1,0,12,0,-12
22469,0,0,34,0,-34
22470,1,0,124,0,-124
22471,1,1,275,1330,1055
22472,1,1,580,1576,996
22473,0,0,15,0,-15
22474,0,0,84,0,-84
22475,1,0,69,0,-69
22476,0,0,27,0,-27
22477,0,0,68,0,-68
22478,0,0,37,0,-37
22479,0,0,3,0,-3
22480,0,0,26,0,-26
22481,0,0,3,0,-3
22482,0,0,64,0,-64
22483,1,0,130,0,-130
22484,1,0,16,0,-16
22485,0,0,5,0,-5
22486,1,1,913,1917,1004
22487,0,0,0,0,0
22488,1,1,592,1651,1059
22489,0,0,14,0,-14
22490,0,0,39,0,-39
22491,1,1,1254,1254,0
22492,1,1,315,1236,921
22493,1,0,87,0,-87
22494,1,0,160,0,-160
22495,1,1,2747,1805,-942
22496,1,0,61,0,-61
22497,0,0,75,0,-75
22498,1,1,601,1236,635
22499,0,0,37,0,-37
22500,0,0,1,0,-1
22501,1,0,51,0,-51
22502,1,1,167,1236,1069
22503,1,1,665,1527,862
22504,0,0,38,0,-38
22505,0,0,14,0,-14
22506,1,0,132,0,-132
22507,0,0,139,0,-139
22508,0,0,2,0,-2
22509,1,1,820,1281,461
22510,0,0,97,0,-97
22511,0,0,41,0,-41
22512,1,1,720,1526,806
22513,1,0,76,0,-76
22514,1,1,713,1720,1007
22515,0,0,35,0,-35
22516,1,1,272,2890,2618
22517,1,0,8,0,-8
22518,1,0,17,0,-17
22519,0,0,14,0,-14
22520,0,0,20,0,-20
22521,1,1,169,1325,1156
22522,1,1,452,1759,1307
22523,1,0,25,0,-25
22524,1,0,38,0,-38
22525,0,0,114,0,-114
22526,1,0,25,0,-25
22527,0,0,24,0,-24
22528,1,1,161,2033,1872
22529,1,1,327,1274,947
22530,0,0,155,0,-155
22531,1,0,17,0,-17
22532,0,0,1,0,-1
22533,0,0,73,0,-73
22534,0,0,61,0,-61
22535,1,1,24,1754,1730
22536,0,0,5,0,-5
22537,1,0,10,0,-10
22538,0,0,181,0,-181
22539,1,0,24,0,-24
22540,1,0,16,0,-16
22541,1,0,5,0,-5
22542,1,0,118,0,-118
22543,1,0,39,0,-39
22544,0,0,18,0,-18
22545,1,0,8,0,-8
22546,1,0,25,0,-25
22547,1,1,39,1568,1529
22548,1,0,295,0,-295
22549,1,1,311,1251,940
22550,0,0,28,0,-28
22551,1,1,63,1928,1865
22552,1,1,558,2015,1457
22553,1,0,36,0,-36
22554,1,0,4,0,-4
22555,1,1,2,1405,1403
22556,0,0,2,0,-2
22557,1,0,62,0,-62
22558,1,1,271,1397,1126
22559,0,0,56,0,-56
22560,0,0,98,0,-98
22561,0,0,24,0,-24
22562,1,0,20,0,-20
22563,1,0,19,0,-19
22564,0,0,63,0,-63
22565,1,0,40,0,-40
22566,1,1,200,1552,1352
22567,0,0,62,0,-62
22568,1,0,2,0,-2
22569,0,0,12,0,-12
22570,0,0,84,0,-84
22571,0,0,108,0,-108
22572,1,0,55,0,-55
22573,1,1,278,1277,999
22574,1,0,55,0,-55
22575,0,0,0,0,0
22576,0,0,3,0,-3
22577,1,1,936,1311,375
22578,0,0,14,0,-14
22579,1,0,20,0,-20
22580,0,0,26,0,-26
22581,1,0,63,0,-63
22582,1,0,33,0,-33
22583,0,0,55,0,-55
22584,1,1,450,1623,1173
22585,1,1,396,1421,1025
22586,1,0,23,0,-23
22587,1,0,54,0,-54
22588,1,0,50,0,-50
22589,1,1,1424,1307,-117
22590,1,0,17,0,-17
22591,1,1,617,1827,1210
22592,1,0,35,0,-35
22593,1,1,1448,1878,430
22594,1,1,1164,1277,113
22595,1,0,43,0,-43
22596,1,0,2,0,-2
22597,1,0,20,0,-20
22598,0,0,62,0,-62
22599,0,0,76,0,-76
22600,1,0,43,0,-43
22601,1,0,11,0,-11
22602,0,0,31,0,-31
22603,0,0,13,0,-13
22604,1,0,15,0,-15
22605,0,0,35,0,-35
22606,0,0,1,0,-1
22607,0,0,9,0,-9
22608,0,0,3,0,-3
22609,0,0,33,0,-33
22610,1,0,67,0,-67
22611,0,0,13,0,-13
22612,1,1,524,1664,1140
22613,0,0,84,0,-84
22614,1,1,814,1273,459
22615,0,0,16,0,-16
22616,1,0,14,0,-14
22617,1,0,14,0,-14
22618,1,1,511,3063,2552
22619,1,0,0,0,0
22620,0,0,85,0,-85
22621,1,0,13,0,-13
22622,0,0,196,0,-196
22623,1,1,309,1537,1228
22624,0,0,135,0,-135
22625,1,1,1131,1994,863
22626,0,0,31,0,-31
22627,0,0,180,0,-180
22628,1,1,89,1489,1400
22629,0,0,1,0,-1
22630,0,0,9,0,-9
22631,1,0,24,0,-24
22632,0,0,21,0,-21
22633,0,0,21,0,-21
22634,1,0,18,0,-18
22635,0,0,52,0,-52
22636,1,1,868,1451,583
22637,1,1,482,1353,871
22638,1,1,143,1346,1203
22639,1,1,552,1477,925
22640,1,0,43,0,-43
22641,1,0,37,0,-37
22642,1,0,7,0,-7
22643,0,0,12,0,-12
22644,1,0,49,0,-49
22645,1,0,6,0,-6
22646,1,1,867,1560,693
22647,0,0,33,0,-33
22648,0,0,18,0,-18
22649,1,1,125,1358,1233
22650,1,1,43,1762,1719
22651,0,0,41,0,-41
22652,1,1,202,1341,1139
22653,1,0,0,0,0
22654,1,1,758,1531,773
22655,1,1,367,1414,1047
22656,1,1,61,2208,2147
22657,0,0,55,0,-55
22658,0,0,84,0,-84
22659,0,0,50,0,-50
22660,1,0,152,0,-152
22661,1,0,25,0,-25
22662,0,0,59,0,-59
22663,1,1,683,1376,693
22664,0,0,16,0,-16
22665,0,0,306,0,-306
22666,1,0,129,0,-129
22667,1,1,707,1586,879
22668,1,0,35,0,-35
22669,1,1,1259,1425,166
22670,1,1,283,1499,1216
22671,0,0,248,0,-248
22672,1,1,1780,3304,1524
22673,1,1,566,1561,995
22674,0,0,35,0,-35
22675,0,0,51,0,-51
22676,1,0,145,0,-145
22677,0,0,29,0,-29
22678,0,0,53,0,-53
22679,1,0,102,0,-102
22680,1,0,168,0,-168
22681,0,0,4,0,-4
22682,0,0,25,0,-25
22683,0,0,50,0,-50
22684,0,0,49,0,-49
22685,1,1,2313,1267,-1046
22686,0,0,127,0,-127
22687,1,0,11,0,-11
22688,0,0,68,0,-68
22689,1,1,608,1333,725
22690,1,1,97,1890,1793
22691,0,0,77,0,-77
22692,1,1,127,1670,1543
22693,1,1,1989,1433,-556
22694,1,0,48,0,-48
22695,1,0,21,0,-21
22696,0,0,136,0,-136
22697,1,0,12,0,-12
22698,0,0,1,0,-1
22699,0,0,37,0,-37
22700,1,0,40,0,-40
22701,1,1,509,1417,908
22702,1,0,20,0,-20
22703,0,0,15,0,-15
22704,1,1,404,1269,865
22705,0,0,60,0,-60
22706,1,1,526,1419,893
22707,0,0,27,0,-27
22708,1,0,1,0,-1
22709,1,0,14,0,-14
22710,1,1,838,2937,2099
22711,0,0,36,0,-36
22712,0,0,81,0,-81
22713,1,0,28,0,-28
22714,0,0,62,0,-62
22715,0,0,14,0,-14
22716,0,0,131,0,-131
22717,1,1,754,3016,2262
22718,1,1,188,1289,1101
22719,1,0,6,0,-6
22720,1,1,1688,1240,-448
22721,1,0,157,0,-157
22722,1,0,23,0,-23
22723,1,0,9,0,-9
22724,1,1,276,1562,1286
22725,1,1,628,1259,631
22726,1,1,97,1341,1244
22727,1,1,156,1514,1358
22728,1,0,120,0,-120
22729,1,0,14,0,-14
22730,0,0,74,0,-74
22731,0,0,13,0,-13
22732,1,0,100,0,-100
22733,1,1,523,2400,1877
22734,1,1,1014,1663,649
22735,1,0,36,0,-36
22736,0,0,10,0,-10
22737,1,1,761,2957,2196
22738,1,0,28,0,-28
22739,1,0,54,0,-54
22740,1,0,8,0,-8
22741,0,0,10,0,-10
22742,1,0,88,0,-88
22743,0,0,6,0,-6
22744,0,0,31,0,-31
22745,0,0,20,0,-20
22746,1,1,926,1606,680
22747,1,0,20,0,-20
22748,1,0,39,0,-39
22749,1,1,947,1474,527
22750,1,1,278,1572,1294
22751,0,0,1,0,-1
22752,0,0,135,0,-135
22753,0,0,14,0,-14
22754,0,0,23,0,-23
22755,1,1,23,1255,1232
22756,0,0,55,0,-55
22757,1,0,92,0,-92
22758,1,0,65,0,-65
22759,1,1,507,1503,996
22760,1,1,114,1629,1515
22761,0,0,165,0,-165
22762,1,0,120,0,-120
22763,1,0,130,0,-130
22764,0,0,30,0,-30
22765,0,0,25,0,-25
22766,1,1,372,1284,912
22767,1,0,75,0,-75
22768,1,0,79,0,-79
22769,0,0,48,0,-48
22770,0,0,85,0,-85
22771,0,0,26,0,-26
22772,1,0,29,0,-29
22773,0,0,118,0,-118
22774,0,0,55,0,-55
22775,1,0,113,0,-113
22776,0,0,0,0,0
22777,0,0,37,0,-37
22778,1,1,1091,1342,251
22779,1,1,189,1392,1203
22780,1,0,143,0,-143
22781,1,0,0,0,0
22782,0,0,29,0,-29
22783,1,0,116,0,-116
22784,1,1,1186,1437,251
22785,1,1,425,1424,999
22786,0,0,243,0,-243
22787,1,1,1141,1408,267
22788,0,0,59,0,-59
22789,1,0,3,0,-3
22790,0,0,11,0,-11
22791,0,0,15,0,-15
22792,1,0,7,0,-7
22793,1,0,115,0,-115
22794,1,0,241,0,-241
22795,1,1,1072,1729,657
22796,0,0,363,0,-363
22797,1,0,4,0,-4
22798,0,0,8,0,-8
22799,1,1,127,1532,1405
22800,0,0,11,0,-11
22801,0,0,5,0,-5
22802,0,0,95,0,-95
22803,1,1,139,1280,1141
22804,1,1,222,1506,1284
22805,1,1,380,1431,1051
22806,1,1,393,1395,1002
22807,1,1,496,2698,2202
22808,0,0,87,0,-87
22809,0,0,31,0,-31
22810,0,0,51,0,-51
22811,0,0,13,0,-13
22812,1,1,664,1319,655
22813,0,0,47,0,-47
22814,0,0,18,0,-18
22815,1,0,111,0,-111
22816,1,0,88,0,-88
22817,1,1,839,1660,821
22818,1,0,30,0,-30
22819,0,0,43,0,-43
22820,1,0,81,0,-81
22821,1,0,209,0,-209
22822,1,0,10,0,-10
22823,1,1,248,1571,1323
22824,0,0,105,0,-105
22825,1,1,1296,2132,836
22826,1,0,11,0,-11
22827,1,1,559,2223,1664
22828,1,0,66,0,-66
22829,0,0,68,0,-68
22830,1,1,356,1454,1098
22831,0,0,35,0,-35
22832,1,0,1,0,-1
22833,1,1,342,1957,1615
22834,0,0,106,0,-106
22835,0,0,264,0,-264
22836,0,0,145,0,-145
22837,1,0,132,0,-132
22838,1,1,744,2448,1704
22839,0,0,64,0,-64
22840,0,0,34,0,-34
22841,1,1,470,1403,933
22842,1,1,249,1312,1063
22843,1,0,56,0,-56
22844,1,0,15,0,-15
22845,1,0,22,0,-22
22846,0,0,15,0,-15
22847,1,1,351,1462,1111
22848,1,0,17,0,-17
22849,1,1,870,1425,555
22850,0,0,3,0,-3
22851,1,0,108,0,-108
22852,1,1,291,1254,963
22853,1,1,423,1796,1373
22854,0,0,11,0,-11
22855,1,1,187,1646,1459
22856,1,0,2,0,-2
22857,0,0,34,0,-34
22858,1,1,699,1632,933
22859,1,0,21,0,-21
22860,1,0,99,0,-99
22861,0,0,127,0,-127
22862,0,0,26,0,-26
22863,0,0,27,0,-27
22864,1,0,18,0,-18
22865,1,0,49,0,-49
22866,1,1,572,1356,784
22867,1,1,779,1964,1185
22868,1,0,3,0,-3
22869,1,0,126,0,-126
22870,1,0,5,0,-5
22871,0,0,34,0,-34
22872,0,0,137,0,-137
22873,0,0,9,0,-9
22874,0,0,59,0,-59
22875,1,0,23,0,-23
22876,1,0,60,0,-60
22877,1,1,661,1405,744
22878,0,0,46,0,-46
22879,0,0,39,0,-39
22880,0,0,41,0,-41
22881,1,1,116,1291,1175
22882,0,0,94,0,-94
22883,1,0,153,0,-153
22884,1,0,28,0,-28
22885,1,1,200,1561,1361
22886,1,0,69,0,-69
22887,0,0,21,0,-21
22888,0,0,45,0,-45
22889,1,1,449,2165,1716
22890,1,1,328,1304,976
22891,0,0,28,0,-28
22892,1,1,2784,1618,-1166
22893,0,0,18,0,-18
22894,0,0,23,0,-23
22895,0,0,11,0,-11
22896,1,1,168,2096,1928
22897,1,1,1312,1357,45
22898,0,0,34,0,-34
22899,1,1,127,3024,2897
22900,1,0,15,0,-15
22901,0,0,111,0,-111
22902,1,0,20,0,-20
22903,0,0,25,0,-25
22904,1,1,1245,3070,1825
22905,1,0,86,0,-86
22906,0,0,14,0,-14
22907,1,0,93,0,-93
22908,1,1,702,1371,669
22909,1,0,16,0,-16
22910,1,0,4,0,-4
22911,0,0,200,0,-200
22912,0,0,31,0,-31
22913,0,0,30,0,-30
22914,1,0,14,0,-14
22915,0,0,69,0,-69
22916,0,0,57,0,-57
22917,0,0,55,0,-55
22918,0,0,6,0,-6
22919,0,0,112,0,-112
22920,0,0,24,0,-24
22921,1,0,2,0,-2
22922,1,1,706,1861,1155
22923,0,0,33,0,-33
22924,1,0,7,0,-7
22925,0,0,150,0,-150
22926,0,0,27,0,-27
22927,0,0,19,0,-19
22928,0,0,93,0,-93
22929,0,0,19,0,-19
22930,1,0,39,0,-39
22931,0,0,24,0,-24
22932,0,0,1,0,-1
22933,1,0,67,0,-67
22934,0,0,2,0,-2
22935,0,0,195,0,-195
22936,0,0,22,0,-22
22937,1,1,881,1386,505
22938,1,0,32,0,-32
22939,1,1,40,1482,1442
22940,1,0,1,0,-1
22941,1,1,483,2147,1664
22942,1,0,132,0,-132
22943,1,1,1282,1248,-34
22944,0,0,28,0,-28
22945,0,0,151,0,-151
22946,0,0,64,0,-64
22947,1,0,205,0,-205
22948,1,1,2198,2162,-36
22949,0,0,50,0,-50
22950,1,1,1449,1721,272
22951,1,0,22,0,-22
22952,1,0,47,0,-47
22953,1,1,1054,1324,270
22954,1,0,20,0,-20
22955,1,0,55,0,-55
22956,1,0,72,0,-72
22957,0,0,43,0,-43
22958,1,1,502,1350,848
22959,1,0,0,0,0
22960,0,0,1,0,-1
22961,1,0,54,0,-54
22962,1,0,84,0,-84
22963,0,0,7,0,-7
22964,0,0,24,0,-24
22965,0,0,1,0,-1
22966,1,1,70,1408,1338
22967,0,0,7,0,-7
22968,1,0,34,0,-34
22969,0,0,9,0,-9
22970,0,0,6,0,-6
22971,1,0,26,0,-26
22972,1,1,1046,1546,500
22973,0,0,110,0,-110
22974,1,1,21,1382,1361
22975,1,1,89,1646,1557
22976,0,0,92,0,-92
22977,0,0,23,0,-23
22978,0,0,17,0,-17
22979,1,1,213,1269,1056
22980,1,1,281,1428,1147
22981,0,0,11,0,-11
22982,1,0,159,0,-159
22983,1,0,123,0,-123
22984,0,0,87,0,-87
22985,0,0,33,0,-33
22986,1,0,11,0,-11
22987,1,1,268,1390,1122
22988,1,0,18,0,-18
22989,0,0,47,0,-47
22990,1,1,566,1474,908
22991,1,0,88,0,-88
22992,1,0,25,0,-25
22993,1,1,1302,1350,48
22994,0,0,97,0,-97
22995,1,0,42,0,-42
22996,1,0,101,0,-101
22997,0,0,121,0,-121
22998,1,1,594,1431,837
22999,0,0,28,0,-28
23000,1,0,73,0,-73
23001,1,0,59,0,-59
23002,0,0,108,0,-108
23003,0,0,95,0,-95
23004,1,0,8,0,-8
23005,1,0,26,0,-26
23006,1,1,213,6324,6111
23007,1,0,30,0,-30
23008,0,0,22,0,-22
23009,0,0,12,0,-12
23010,1,1,168,1770,1602
23011,1,1,308,1424,1116
23012,0,0,65,0,-65
23013,1,1,198,1448,1250
23014,1,1,389,1762,1373
23015,1,1,164,2393,2229
23016,1,1,1573,1508,-65
23017,1,0,9,0,-9
23018,1,1,1427,1284,-143
23019,1,1,79,1329,1250
23020,1,1,34,1411,1377
23021,1,1,177,1405,1228
23022,1,0,10,0,-10
23023,1,1,182,1479,1297
23024,0,0,42,0,-42
23025,1,0,29,0,-29
23026,1,0,32,0,-32
23027,1,1,394,1826,1432
23028,1,1,125,2042,1917
23029,1,1,757,1500,743
23030,1,1,159,1992,1833
23031,0,0,107,0,-107
23032,0,0,0,0,0
23033,1,1,376,1565,1189
23034,1,0,50,0,-50
23035,0,0,72,0,-72
23036,1,1,710,1760,1050
23037,1,1,126,1320,1194
23038,0,0,5,0,-5
23039,1,1,239,1241,1002
23040,1,1,272,1407,1135
23041,0,0,85,0,-85
23042,1,1,166,1629,1463
23043,1,1,289,1569,1280
23044,1,0,58,0,-58
23045,1,1,400,1235,835
23046,1,0,91,0,-91
23047,0,0,23,0,-23
23048,0,0,60,0,-60
23049,0,0,98,0,-98
23050,1,1,41,1412,1371
23051,1,1,779,1938,1159
23052,1,1,197,1247,1050
23053,1,0,16,0,-16
23054,1,1,610,1243,633
23055,1,0,14,0,-14
23056,0,0,15,0,-15
23057,1,1,320,1878,1558
23058,1,0,10,0,-10
23059,1,0,9,0,-9
23060,0,0,43,0,-43
23061,1,1,268,1293,1025
23062,1,1,269,1929,1660
23063,0,0,60,0,-60
23064,1,0,28,0,-28
23065,0,0,10,0,-10
23066,1,0,37,0,-37
23067,1,0,23,0,-23
23068,1,1,104,2986,2882
23069,1,0,12,0,-12
23070,1,0,57,0,-57
23071,0,0,19,0,-19
23072,1,1,427,1383,956
23073,1,1,374,2785,2411
23074,0,0,100,0,-100
23075,0,0,1,0,-1
23076,1,1,855,2069,1214
23077,1,0,53,0,-53
23078,1,1,61,1245,1184
23079,1,1,1033,1416,383
23080,1,1,1273,1263,-10
23081,0,0,59,0,-59
23082,1,1,249,3303,3054
23083,1,0,89,0,-89
23084,0,0,34,0,-34
23085,1,1,1364,1347,-17
23086,0,0,18,0,-18
23087,1,1,953,2002,1049
23088,1,0,34,0,-34
23089,1,1,145,1318,1173
23090,0,0,30,0,-30
23091,0,0,50,0,-50
23092,1,0,4,0,-4
23093,1,0,85,0,-85
23094,1,0,30,0,-30
23095,0,0,205,0,-205
23096,0,0,70,0,-70
23097,0,0,21,0,-21
23098,1,1,294,1281,987
23099,0,0,17,0,-17
23100,1,1,37,1928,1891
23101,1,1,251,1348,1097
23102,1,1,386,1313,927
23103,0,0,0,0,0
23104,1,0,42,0,-42
23105,0,0,1,0,-1
23106,1,0,5,0,-5
23107,0,0,19,0,-19
23108,1,0,140,0,-140
23109,0,0,14,0,-14
23110,1,0,14,0,-14
23111,1,0,8,0,-8
23112,0,0,7,0,-7
23113,1,1,224,1536,1312
23114,0,0,22,0,-22
23115,1,1,436,1236,800
23116,1,0,27,0,-27
23117,1,0,38,0,-38
23118,0,0,19,0,-19
23119,1,1,710,2316,1606
23120,1,1,205,1391,1186
23121,0,0,188,0,-188
23122,1,1,294,1751,1457
23123,0,0,4,0,-4
23124,0,0,34,0,-34
23125,1,1,400,1712,1312
23126,0,0,10,0,-10
23127,0,0,6,0,-6
23128,1,1,512,1292,780
23129,1,1,725,1263,538
23130,1,0,136,0,-136
23131,1,1,866,1708,842
23132,1,0,1,0,-1
23133,1,0,27,0,-27
23134,1,0,100,0,-100
23135,1,0,26,0,-26
23136,1,0,23,0,-23
23137,0,0,47,0,-47
23138,1,0,56,0,-56
23139,1,0,18,0,-18
23140,0,0,100,0,-100
23141,1,1,218,2465,2247
23142,0,0,15,0,-15
23143,0,0,45,0,-45
23144,1,1,225,1667,1442
23145,1,0,1,0,-1
23146,0,0,81,0,-81
23147,1,1,53,1340,1287
23148,0,0,125,0,-125
23149,0,0,142,0,-142
23150,1,1,59,1576,1517
23151,1,0,8,0,-8
23152,1,0,78,0,-78
23153,0,0,88,0,-88
23154,1,0,4,0,-4
23155,0,0,142,0,-142
23156,1,1,769,1982,1213
23157,1,1,504,2141,1637
23158,0,0,33,0,-33
23159,1,0,11,0,-11
23160,1,0,20,0,-20
23161,1,0,2,0,-2
23162,1,1,653,1332,679
23163,1,0,33,0,-33
23164,1,1,564,1334,770
23165,1,1,255,1745,1490
23166,1,0,148,0,-148
23167,0,0,43,0,-43
23168,1,0,60,0,-60
23169,1,1,505,3018,2513
23170,0,0,66,0,-66
23171,1,0,0,0,0
23172,0,0,34,0,-34
23173,1,1,236,1484,1248
23174,0,0,8,0,-8
23175,1,0,25,0,-25
23176,0,0,211,0,-211
23177,1,0,1,0,-1
23178,1,1,234,1876,1642
23179,1,0,12,0,-12
23180,1,1,347,1253,906
23181,1,1,383,1528,1145
23182,0,0,8,0,-8
23183,1,0,14,0,-14
23184,1,1,1463,3124,1661
23185,1,1,117,2783,2666
23186,0,0,33,0,-33
23187,1,0,32,0,-32
23188,1,1,491,1470,979
23189,1,1,297,2023,1726
23190,1,0,57,0,-57
23191,0,0,8,0,-8
23192,1,0,43,0,-43
23193,1,0,35,0,-35
23194,1,0,101,0,-101
23195,1,0,27,0,-27
23196,1,0,89,0,-89
23197,0,0,44,0,-44
23198,0,0,57,0,-57
23199,0,0,20,0,-20
23200,1,0,57,0,-57
23201,1,1,96,1895,1799
23202,0,0,3,0,-3
23203,0,0,123,0,-123
23204,0,0,243,0,-243
23205,0,0,52,0,-52
23206,1,1,840,1281,441
23207,0,0,18,0,-18
23208,1,0,12,0,-12
23209,1,0,60,0,-60
23210,1,0,58,0,-58
23211,0,0,35,0,-35
23212,0,0,38,0,-38
23213,1,0,13,0,-13
23214,0,0,23,0,-23
23215,0,0,11,0,-11
23216,1,0,11,0,-11
23217,0,0,98,0,-98
23218,1,1,556,3104,2548
23219,1,0,88,0,-88
23220,0,0,28,0,-28
23221,0,0,39,0,-39
23222,1,1,377,1259,882
23223,0,0,31,0,-31
23224,1,0,23,0,-23
23225,0,0,12,0,-12
23226,0,0,19,0,-19
23227,1,0,29,0,-29
23228,0,0,4,0,-4
23229,1,0,13,0,-13
23230,0,0,112,0,-112
23231,1,1,639,1801,1162
23232,1,1,516,1613,1097
23233,1,1,2198,1289,-909
23234,0,0,39,0,-39
23235,0,0,99,0,-99
23236,1,0,2,0,-2
23237,1,0,17,0,-17
23238,1,0,162,0,-162
23239,1,0,20,0,-20
23240,1,0,15,0,-15
23241,1,1,220,1240,1020
23242,0,0,38,0,-38
23243,1,0,4,0,-4
23244,1,1,79,5171,5092
23245,0,0,97,0,-97
23246,1,1,430,1305,875
23247,0,0,52,0,-52
23248,1,0,28,0,-28
23249,1,1,28,1430,1402
23250,1,0,73,0,-73
23251,1,0,4,0,-4
23252,1,0,27,0,-27
23253,1,1,791,1631,840
23254,1,0,52,0,-52
23255,1,0,95,0,-95
23256,0,0,58,0,-58
23257,1,0,33,0,-33
23258,1,0,22,0,-22
23259,1,1,83,1390,1307
23260,1,0,9,0,-9
23261,0,0,34,0,-34
23262,0,0,1,0,-1
23263,1,1,392,1241,849
23264,1,1,796,2595,1799
23265,1,1,172,1973,1801
23266,1,0,10,0,-10
23267,1,1,768,1400,632
23268,1,0,20,0,-20
23269,1,0,9,0,-9
23270,1,1,96,1458,1362
23271,0,0,66,0,-66
23272,1,0,3,0,-3
23273,1,1,186,1422,1236
23274,1,1,700,1356,656
23275,1,0,81,0,-81
23276,0,0,49,0,-49
23277,1,1,500,1654,1154
23278,1,1,104,1777,1673
23279,1,1,481,1559,1078
23280,0,0,42,0,-42
23281,0,0,118,0,-118
23282,1,1,159,2284,2125
23283,1,1,232,1344,1112
23284,1,1,727,1525,798
23285,0,0,32,0,-32
23286,1,1,135,1950,1815
23287,1,0,41,0,-41
23288,1,1,1778,1535,-243
23289,1,0,140,0,-140
23290,1,0,75,0,-75
23291,0,0,39,0,-39
23292,0,0,1,0,-1
23293,1,1,292,1770,1478
23294,1,1,444,2415,1971
23295,0,0,90,0,-90
23296,1,0,118,0,-118
23297,1,1,631,1868,1237
23298,0,0,47,0,-47
23299,1,1,141,1474,1333
23300,1,1,1399,1744,345
23301,1,0,7,0,-7
23302,0,0,10,0,-10
23303,0,0,248,0,-248
23304,0,0,80,0,-80
23305,1,0,24,0,-24
23306,0,0,4,0,-4
23307,1,0,52,0,-52
23308,1,1,112,1605,1493
23309,1,1,131,1895,1764
23310,1,1,386,1259,873
23311,0,0,5,0,-5
23312,1,1,714,1254,540
23313,0,0,181,0,-181
23314,1,1,11,1265,1254
23315,0,0,89,0,-89
23316,0,0,8,0,-8
23317,1,0,0,0,0
23318,1,0,10,0,-10
23319,1,1,761,1486,725
23320,0,0,31,0,-31
23321,1,1,1026,1639,613
23322,1,1,449,1443,994
23323,1,0,76,0,-76
23324,1,1,1416,1399,-17
23325,1,0,1,0,-1
23326,1,1,634,1345,711
23327,0,0,137,0,-137
23328,1,0,206,0,-206
23329,1,1,150,2536,2386
23330,1,0,4,0,-4
23331,0,0,23,0,-23
23332,1,1,80,1636,1556
23333,1,1,802,2698,1896
23334,0,0,70,0,-70
23335,1,0,18,0,-18
23336,1,1,98,1289,1191
23337,1,1,670,1245,575
23338,0,0,80,0,-80
23339,0,0,132,0,-132
23340,0,0,4,0,-4
23341,0,0,146,0,-146
23342,1,1,474,1722,1248
23343,1,0,10,0,-10
23344,1,1,401,1253,852
23345,1,1,1707,1770,63
23346,1,0,162,0,-162
23347,1,0,27,0,-27
23348,0,0,46,0,-46
23349,1,1,954,1265,311
23350,1,0,30,0,-30
23351,1,1,77,1878,1801
23352,1,0,18,0,-18
23353,0,0,17,0,-17
23354,1,0,58,0,-58
23355,1,0,65,0,-65
23356,1,1,452,1549,1097
23357,1,1,1581,1317,-264
23358,1,1,1027,2186,1159
23359,0,0,111,0,-111
23360,0,0,2,0,-2
23361,1,1,961,1529,568
23362,0,0,76,0,-76
23363,1,0,89,0,-89
23364,0,0,118,0,-118
23365,0,0,6,0,-6
23366,0,0,52,0,-52
23367,0,0,10,0,-10
23368,1,1,841,1330,489
23369,0,0,147,0,-147
23370,0,0,14,0,-14
23371,1,0,9,0,-9
23372,1,1,374,1384,1010
23373,0,0,18,0,-18
23374,0,0,114,0,-114
23375,0,0,42,0,-42
23376,0,0,34,0,-34
23377,1,0,65,0,-65
23378,1,0,1,0,-1
23379,1,0,71,0,-71
23380,1,1,1198,1884,686
23381,0,0,35,0,-35
23382,1,0,0,0,0
23383,1,0,3,0,-3
23384,1,0,38,0,-38
23385,1,0,60,0,-60
23386,0,0,69,0,-69
23387,1,1,108,1436,1328
23388,1,0,49,0,-49
23389,0,0,265,0,-265
23390,0,0,72,0,-72
23391,1,1,685,1594,909
23392,0,0,70,0,-70
23393,0,0,45,0,-45
23394,1,1,627,1712,1085
23395,1,0,33,0,-33
23396,0,0,6,0,-6
23397,1,1,780,1349,569
23398,1,0,136,0,-136
23399,1,0,66,0,-66
23400,1,1,190,1710,1520
23401,1,0,12,0,-12
23402,1,0,11,0,-11
23403,1,0,90,0,-90
23404,1,0,4,0,-4
23405,0,0,30,0,-30
23406,1,0,142,0,-142
23407,0,0,121,0,-121
23408,1,1,208,1339,1131
23409,1,0,23,0,-23
23410,0,0,0,0,0
23411,1,1,368,2061,1693
23412,1,1,394,2211,1817
23413,1,0,35,0,-35
23414,1,1,203,1241,1038
23415,1,1,92,1338,1246
23416,1,0,69,0,-69
23417,1,1,62,1267,1205
23418,1,0,22,0,-22
23419,1,0,13,0,-13
23420,0,0,73,0,-73
23421,0,0,66,0,-66
23422,1,1,86,1970,1884
23423,1,1,850,1235,385
23424,0,0,95,0,-95
23425,1,1,638,1438,800
23426,0,0,36,0,-36
23427,0,0,9,0,-9
23428,1,0,11,0,-11
23429,0,0,20,0,-20
23430,0,0,2,0,-2
23431,1,0,6,0,-6
23432,0,0,45,0,-45
23433,1,1,669,1363,694
23434,1,0,13,0,-13
23435,0,0,42,0,-42
23436,0,0,15,0,-15
23437,1,1,139,1235,1096
23438,1,0,95,0,-95
23439,1,1,1036,1938,902
23440,0,0,54,0,-54
23441,0,0,108,0,-108
23442,0,0,25,0,-25
23443,1,1,109,1297,1188
23444,0,0,1,0,-1
23445,1,1,392,1250,858
23446,0,0,1,0,-1
23447,0,0,18,0,-18
23448,0,0,53,0,-53
23449,0,0,0,0,0
23450,1,0,8,0,-8
23451,1,1,299,1519,1220
23452,0,0,46,0,-46
23453,0,0,112,0,-112
23454,0,0,44,0,-44
23455,1,0,124,0,-124
23456,1,1,557,1468,911
23457,1,1,164,1466,1302
23458,1,1,824,2024,1200
23459,0,0,91,0,-91
23460,0,0,95,0,-95
23461,1,1,312,2283,1971
23462,0,0,54,0,-54
23463,1,0,50,0,-50
23464,0,0,39,0,-39
23465,1,1,635,1315,680
23466,1,0,40,0,-40
23467,1,1,564,1536,972
23468,1,0,60,0,-60
23469,0,0,92,0,-92
23470,1,1,213,1469,1256
23471,0,0,47,0,-47
23472,1,1,1273,1414,141
23473,1,1,100,1677,1577
23474,1,0,61,0,-61
23475,1,0,42,0,-42
23476,1,0,43,0,-43
23477,1,1,1308,1574,266
23478,1,1,1187,1392,205
23479,0,0,16,0,-16
23480,0,0,3,0,-3
23481,1,0,114,0,-114
23482,1,1,462,1243,781
23483,0,0,13,0,-13
23484,1,1,826,1504,678
23485,1,0,59,0,-59
23486,0,0,106,0,-106
23487,0,0,27,0,-27
23488,1,0,1,0,-1
23489,1,0,18,0,-18
23490,0,0,47,0,-47
23491,0,0,32,0,-32
23492,0,0,51,0,-51
23493,1,1,498,1402,904
23494,1,0,42,0,-42
23495,0,0,102,0,-102
23496,0,0,38,0,-38
23497,1,0,25,0,-25
23498,1,0,11,0,-11
23499,1,0,9,0,-9
23500,0,0,110,0,-110
23501,1,1,625,1733,1108
23502,1,1,414,2316,1902
23503,0,0,49,0,-49
23504,0,0,122,0,-122
23505,1,1,430,1739,1309
23506,1,0,8,0,-8
23507,1,1,532,2566,2034
23508,1,0,61,0,-61
23509,0,0,386,0,-386
23510,0,0,15,0,-15
23511,1,1,15,1420,1405
23512,0,0,13,0,-13
23513,1,1,567,1308,741
23514,1,0,74,0,-74
23515,1,1,669,1370,701
23516,1,1,1429,1235,-194
23517,1,0,16,0,-16
23518,0,0,35,0,-35
23519,1,1,619,1432,813
23520,1,1,786,1710,924
23521,0,0,3,0,-3
23522,1,0,31,0,-31
23523,0,0,33,0,-33
23524,1,1,727,1636,909
23525,1,0,53,0,-53
23526,0,0,44,0,-44
23527,1,1,847,1484,637
23528,0,0,21,0,-21
23529,1,1,380,1722,1342
23530,0,0,39,0,-39
23531,1,0,36,0,-36
23532,1,0,168,0,-168
23533,0,0,12,0,-12
23534,1,1,79,1395,1316
23535,1,0,32,0,-32
23536,0,0,7,0,-7
23537,1,1,740,1643,903
23538,1,0,16,0,-16
23539,0,0,104,0,-104
23540,1,1,115,1645,1530
23541,0,0,48,0,-48
23542,1,0,17,0,-17
23543,0,0,33,0,-33
23544,1,0,27,0,-27
23545,0,0,86,0,-86
23546,1,0,0,0,0
23547,0,0,59,0,-59
23548,0,0,10,0,-10
23549,1,1,995,1330,335
23550,1,1,193,2722,2529
23551,1,0,110,0,-110
23552,0,0,1,0,-1
23553,1,1,94,1452,1358
23554,1,1,956,1469,513
23555,0,0,68,0,-68
23556,1,1,125,1378,1253
23557,1,0,13,0,-13
23558,1,1,179,1560,1381
23559,1,0,19,0,-19
23560,1,1,375,1390,1015
23561,1,0,31,0,-31
23562,1,1,411,1490,1079
23563,1,0,37,0,-37
23564,1,0,27,0,-27
23565,0,0,27,0,-27
23566,0,0,44,0,-44
23567,0,0,5,0,-5
23568,1,1,111,1624,1513
23569,1,1,353,2331,1978
23570,1,1,487,1988,1501
23571,1,1,391,1583,1192
23572,0,0,16,0,-16
23573,1,1,594,1956,1362
23574,1,1,665,1468,803
23575,0,0,73,0,-73
23576,0,0,46,0,-46
23577,1,1,843,1276,433
23578,0,0,92,0,-92
23579,1,1,123,1376,1253
23580,1,0,54,0,-54
23581,1,0,77,0,-77
23582,0,0,13,0,-13
23583,0,0,157,0,-157
23584,1,0,18,0,-18
23585,1,1,1185,1324,139
23586,0,0,30,0,-30
23587,1,1,618,1574,956
23588,1,1,255,1498,1243
23589,1,0,29,0,-29
23590,0,0,60,0,-60
23591,1,1,562,1358,796
23592,0,0,98,0,-98
23593,1,0,30,0,-30
23594,0,0,34,0,-34
23595,0,0,6,0,-6
23596,1,1,197,1655,1458
23597,1,0,4,0,-4
23598,0,0,5,0,-5
23599,0,0,34,0,-34
23600,1,0,34,0,-34
23601,1,0,90,0,-90
23602,0,0,44,0,-44
23603,0,0,50,0,-50
23604,0,0,31,0,-31
23605,1,0,104,0,-104
23606,0,0,3,0,-3
23607,1,1,66,2587,2521
23608,0,0,42,0,-42
23609,0,0,29,0,-29
23610,1,1,130,2041,1911
23611,1,1,627,1253,626
23612,1,0,26,0,-26
23613,0,0,34,0,-34
23614,1,1,647,1472,825
23615,0,0,57,0,-57
23616,0,0,29,0,-29
23617,1,1,710,1315,605
23618,1,0,69,0,-69
23619,1,0,44,0,-44
23620,1,0,58,0,-58
23621,1,1,770,1326,556
23622,0,0,13,0,-13
23623,0,0,298,0,-298
23624,0,0,34,0,-34
23625,0,0,33,0,-33
23626,0,0,8,0,-8
23627,1,0,21,0,-21
23628,0,0,6,0,-6
23629,0,0,30,0,-30
23630,1,1,149,1658,1509
23631,1,0,114,0,-114
23632,1,0,98,0,-98
23633,1,0,20,0,-20
23634,1,0,107,0,-107
23635,1,1,193,2169,1976
23636,0,0,14,0,-14
23637,0,0,8,0,-8
23638,0,0,48,0,-48
23639,1,0,83,0,-83
23640,1,1,1292,1305,13
23641,0,0,81,0,-81
23642,1,1,1675,1501,-174
23643,1,1,69,1238,1169
23644,0,0,192,0,-192
23645,0,0,43,0,-43
23646,0,0,2,0,-2
23647,1,1,197,1357,1160
23648,1,1,266,2393,2127
23649,1,0,106,0,-106
23650,0,0,186,0,-186
23651,0,0,108,0,-108
23652,1,0,12,0,-12
23653,0,0,35,0,-35
23654,1,0,52,0,-52
23655,0,0,145,0,-145
23656,0,0,10,0,-10
23657,0,0,13,0,-13
23658,0,0,63,0,-63
23659,1,1,1166,1512,346
23660,1,0,184,0,-184
23661,1,0,32,0,-32
23662,0,0,10,0,-10
23663,1,1,67,1556,1489
23664,1,1,205,1449,1244
23665,1,0,44,0,-44
23666,1,0,68,0,-68
23667,1,0,10,0,-10
23668,1,0,73,0,-73
23669,1,0,76,0,-76
23670,1,1,187,1606,1419
23671,0,0,8,0,-8
23672,1,0,40,0,-40
23673,0,0,15,0,-15
23674,0,0,53,0,-53
23675,0,0,0,0,0
23676,1,1,1456,1263,-193
23677,1,1,238,1312,1074
23678,1,0,24,0,-24
23679,1,0,43,0,-43
23680,1,0,51,0,-51
23681,1,1,1192,1402,210
23682,1,1,965,1236,271
23683,1,0,59,0,-59
23684,1,1,142,2781,2639
23685,1,0,32,0,-32
23686,1,1,204,1470,1266
23687,0,0,12,0,-12
23688,0,0,28,0,-28
23689,1,0,74,0,-74
23690,0,0,6,0,-6
23691,0,0,6,0,-6
23692,0,0,8,0,-8
23693,1,0,18,0,-18
23694,1,0,39,0,-39
23695,1,1,44,1527,1483
23696,0,0,68,0,-68
23697,1,0,77,0,-77
23698,1,1,1182,2987,1805
23699,1,0,114,0,-114
23700,1,0,173,0,-173
23701,0,0,37,0,-37
23702,1,0,38,0,-38
23703,1,0,17,0,-17
23704,1,0,7,0,-7
23705,1,1,797,1375,578
23706,1,0,82,0,-82
23707,0,0,16,0,-16
23708,1,1,388,1395,1007
23709,0,0,75,0,-75
23710,1,1,152,1322,1170
23711,1,1,550,1834,1284
23712,1,1,978,1508,530
23713,0,0,21,0,-21
23714,0,0,75,0,-75
23715,0,0,14,0,-14
23716,0,0,68,0,-68
23717,1,1,131,1430,1299
23718,1,0,53,0,-53
23719,1,0,14,0,-14
23720,0,0,43,0,-43
23721,0,0,1,0,-1
23722,0,0,7,0,-7
23723,0,0,2,0,-2
23724,1,0,22,0,-22
23725,1,0,9,0,-9
23726,1,0,6,0,-6
23727,0,0,30,0,-30
23728,0,0,6,0,-6
23729,0,0,36,0,-36
23730,0,0,11,0,-11
23731,0,0,58,0,-58
23732,1,1,321,1624,1303
23733,1,0,38,0,-38
23734,1,0,8,0,-8
23735,1,0,7,0,-7
23736,1,0,56,0,-56
23737,1,1,853,2702,1849
23738,1,0,53,0,-53
23739,0,0,83,0,-83
23740,1,1,1139,1570,431
23741,1,0,16,0,-16
23742,0,0,75,0,-75
23743,1,0,209,0,-209
23744,1,1,477,1386,909
23745,0,0,106,0,-106
23746,1,1,181,1340,1159
23747,1,0,10,0,-10
23748,1,0,14,0,-14
23749,0,0,43,0,-43
23750,1,1,595,1432,837
23751,1,0,37,0,-37
23752,0,0,139,0,-139
23753,0,0,20,0,-20
23754,1,0,5,0,-5
23755,0,0,120,0,-120
23756,0,0,21,0,-21
23757,0,0,67,0,-67
23758,1,0,77,0,-77
23759,0,0,92,0,-92
23760,1,1,337,2247,1910
23761,0,0,111,0,-111
23762,1,1,812,1267,455
23763,1,1,1350,1531,181
23764,0,0,12,0,-12
23765,0,0,64,0,-64
23766,0,0,128,0,-128
23767,1,0,38,0,-38
23768,0,0,5,0,-5
23769,1,1,263,1337,1074
23770,1,0,36,0,-36
23771,0,0,44,0,-44
23772,1,0,27,0,-27
23773,1,1,1070,1302,232
23774,0,0,44,0,-44
23775,0,0,77,0,-77
23776,1,0,42,0,-42
23777,0,0,35,0,-35
23778,1,0,138,0,-138
23779,1,1,685,2203,1518
23780,0,0,73,0,-73
23781,1,0,71,0,-71
23782,1,1,143,2132,1989
23783,1,1,384,1280,896
23784,1,0,1,0,-1
23785,0,0,21,0,-21
23786,0,0,121,0,-121
23787,0,0,65,0,-65
23788,1,0,5,0,-5
23789,1,0,10,0,-10
23790,1,1,830,1277,447
23791,1,1,483,1275,792
23792,1,0,36,0,-36
23793,1,1,423,1376,953
23794,1,0,16,0,-16
23795,1,1,63,1530,1467
23796,1,0,162,0,-162
23797,1,1,873,1574,701
23798,0,0,71,0,-71
23799,1,0,28,0,-28
23800,0,0,42,0,-42
23801,0,0,34,0,-34
23802,0,0,137,0,-137
23803,1,1,176,1391,1215
23804,0,0,41,0,-41
23805,1,1,112,1250,1138
23806,1,1,537,1281,744
23807,1,0,91,0,-91
23808,0,0,30,0,-30
23809,1,1,738,1239,501
23810,1,1,57,1749,1692
23811,0,0,76,0,-76
23812,1,0,4,0,-4
23813,0,0,7,0,-7
23814,0,0,40,0,-40
23815,0,0,75,0,-75
23816,1,0,45,0,-45
23817,1,1,445,1412,967
23818,0,0,0,0,0
23819,1,1,75,1464,1389
23820,0,0,18,0,-18
23821,1,0,37,0,-37
23822,0,0,167,0,-167
23823,0,0,13,0,-13
23824,0,0,30,0,-30
23825,0,0,23,0,-23
23826,0,0,86,0,-86
23827,0,0,11,0,-11
23828,0,0,73,0,-73
23829,1,0,13,0,-13
23830,1,0,22,0,-22
23831,0,0,39,0,-39
23832,1,1,472,1656,1184
23833,1,0,171,0,-171
23834,1,1,417,1246,829
23835,1,0,22,0,-22
23836,1,1,995,2538,1543
23837,0,0,30,0,-30
23838,1,0,48,0,-48
23839,0,0,6,0,-6
23840,1,0,59,0,-59
23841,0,0,157,0,-157
23842,1,1,916,1935,1019
23843,0,0,8,0,-8
23844,1,1,979,1809,830
23845,1,1,129,1622,1493
23846,0,0,4,0,-4
23847,1,0,4,0,-4
23848,1,0,23,0,-23
23849,1,0,18,0,-18
23850,1,1,1769,1825,56
23851,1,0,13,0,-13
23852,1,1,471,1239,768
23853,1,0,27,0,-27
23854,1,1,515,1646,1131
23855,1,1,276,1357,1081
23856,1,0,38,0,-38
23857,0,0,11,0,-11
23858,1,0,5,0,-5
23859,0,0,108,0,-108
23860,0,0,60,0,-60
23861,0,0,72,0,-72
23862,0,0,15,0,-15
23863,1,0,38,0,-38
23864,1,1,259,1587,1328
23865,1,0,67,0,-67
23866,1,0,0,0,0
23867,0,0,9,0,-9
23868,0,0,55,0,-55
23869,1,1,258,1604,1346
23870,0,0,54,0,-54
23871,1,1,252,1453,1201
23872,1,1,5,1786,1781
23873,1,1,42,1683,1641
23874,1,1,864,1441,577
23875,1,1,62,1640,1578
23876,1,0,59,0,-59
23877,1,0,90,0,-90
23878,0,0,17,0,-17
23879,0,0,59,0,-59
23880,1,0,0,0,0
23881,1,1,937,1663,726
23882,0,0,84,0,-84
23883,0,0,39,0,-39
23884,1,0,18,0,-18
23885,1,1,354,1591,1237
23886,0,0,4,0,-4
23887,1,1,426,1283,857
23888,0,0,20,0,-20
23889,0,0,36,0,-36
23890,1,1,120,1253,1133
23891,0,0,3,0,-3
23892,0,0,114,0,-114
23893,1,1,286,1314,1028
23894,0,0,5,0,-5
23895,0,0,86,0,-86
23896,1,0,15,0,-15
23897,1,1,313,1546,1233
23898,0,0,82,0,-82
23899,1,1,412,1804,1392
23900,0,0,4,0,-4
23901,1,1,1247,1406,159
23902,1,0,111,0,-111
23903,1,0,24,0,-24
23904,0,0,4,0,-4
23905,0,0,60,0,-60
23906,0,0,1,0,-1
23907,0,0,4,0,-4
23908,1,1,493,1393,900
23909,0,0,41,0,-41
23910,1,1,1438,1410,-28
23911,0,0,12,0,-12
23912,1,1,1103,1701,598
23913,0,0,0,0,0
23914,1,1,358,1825,1467
23915,0,0,125,0,-125
23916,1,1,1371,1343,-28
23917,1,0,16,0,-16
23918,1,0,76,0,-76
23919,1,1,862,1352,490
23920,1,0,69,0,-69
23921,1,0,51,0,-51
23922,1,1,507,1860,1353
23923,0,0,16,0,-16
23924,0,0,0,0,0
23925,0,0,15,0,-15
23926,1,0,134,0,-134
23927,1,1,173,1299,1126
23928,1,1,293,2895,2602
23929,0,0,21,0,-21
23930,1,1,968,2584,1616
23931,0,0,21,0,-21
23932,0,0,27,0,-27
23933,1,1,910,1649,739
23934,1,0,8,0,-8
23935,1,0,28,0,-28
23936,1,0,1,0,-1
23937,1,0,33,0,-33
23938,0,0,48,0,-48
23939,1,1,72,2015,1943
23940,0,0,44,0,-44
23941,1,1,111,1288,1177
23942,1,0,74,0,-74
23943,1,1,330,1367,1037
23944,1,1,1479,1777,298
23945,1,1,57,1572,1515
23946,1,0,33,0,-33
23947,0,0,61,0,-61
23948,1,1,447,1917,1470
23949,0,0,51,0,-51
23950,1,1,1098,2014,916
23951,1,0,30,0,-30
23952,1,1,402,1524,1122
23953,1,0,57,0,-57
23954,1,1,382,1906,1524
23955,1,0,24,0,-24
23956,1,1,218,3272,3054
23957,0,0,44,0,-44
23958,0,0,103,0,-103
23959,0,0,6,0,-6
23960,1,1,543,1626,1083
23961,0,0,53,0,-53
23962,1,0,131,0,-131
23963,1,0,10,0,-10
23964,1,1,382,1251,869
23965,1,0,10,0,-10
23966,0,0,36,0,-36
23967,1,0,194,0,-194
23968,1,0,34,0,-34
23969,1,0,33,0,-33
23970,1,0,4,0,-4
23971,1,0,38,0,-38
23972,1,1,1111,1435,324
23973,1,0,8,0,-8
23974,1,0,1,0,-1
23975,0,0,69,0,-69
23976,0,0,62,0,-62
23977,1,0,10,0,-10
23978,0,0,26,0,-26
23979,1,1,1308,1723,415
23980,0,0,0,0,0
23981,1,0,121,0,-121
23982,1,0,10,0,-10
23983,0,0,19,0,-19
23984,0,0,156,0,-156
23985,1,1,776,2223,1447
23986,0,0,18,0,-18
23987,0,0,27,0,-27
23988,0,0,24,0,-24
23989,0,0,17,0,-17
23990,0,0,5,0,-5
23991,0,0,0,0,0
23992,0,0,7,0,-7
23993,0,0,273,0,-273
23994,0,0,12,0,-12
23995,0,0,27,0,-27
23996,1,1,1130,1283,153
23997,1,0,0,0,0
23998,0,0,90,0,-90
23999,0,0,25,0,-25
24000,0,0,1,0,-1
24001,0,0,30,0,-30
24002,1,0,28,0,-28
24003,1,1,903,1237,334
24004,1,1,724,1571,847
24005,0,0,105,0,-105
24006,1,0,42,0,-42
24007,1,0,61,0,-61
24008,1,0,105,0,-105
24009,1,1,840,1262,422
24010,1,1,838,1513,675
24011,1,0,19,0,-19
24012,1,1,753,1259,506
24013,0,0,28,0,-28
24014,0,0,54,0,-54
24015,1,1,116,1251,1135
24016,1,1,662,1985,1323
24017,0,0,2,0,-2
24018,0,0,42,0,-42
24019,0,0,15,0,-15
24020,0,0,19,0,-19
24021,0,0,34,0,-34
24022,0,0,69,0,-69
24023,0,0,0,0,0
24024,1,1,395,1440,1045
24025,1,1,916,1673,757
24026,0,0,58,0,-58
24027,1,0,37,0,-37
24028,0,0,69,0,-69
24029,0,0,86,0,-86
24030,1,0,1,0,-1
24031,0,0,20,0,-20
24032,0,0,18,0,-18
24033,1,1,305,1583,1278
24034,1,0,165,0,-165
24035,1,0,12,0,-12
24036,1,0,33,0,-33
24037,1,0,7,0,-7
24038,1,1,1791,1530,-261
24039,0,0,31,0,-31
24040,1,1,364,1999,1635
24041,0,0,20,0,-20
24042,0,0,63,0,-63
24043,0,0,66,0,-66
24044,1,1,1270,1943,673
24045,1,0,12,0,-12
24046,0,0,45,0,-45
24047,0,0,225,0,-225
24048,0,0,68,0,-68
24049,1,0,110,0,-110
24050,0,0,8,0,-8
24051,0,0,3,0,-3
24052,1,1,475,1379,904
24053,1,0,96,0,-96
24054,0,0,32,0,-32
24055,1,0,0,0,0
24056,0,0,56,0,-56
24057,0,0,39,0,-39
24058,1,1,250,1727,1477
24059,1,1,442,1377,935
24060,1,0,9,0,-9
24061,1,1,859,1486,627
24062,1,0,1,0,-1
24063,1,0,60,0,-60
24064,1,1,292,3077,2785
24065,0,0,67,0,-67
24066,0,0,45,0,-45
24067,1,0,1,0,-1
24068,0,0,156,0,-156
24069,1,1,158,1317,1159
24070,0,0,43,0,-43
24071,0,0,43,0,-43
24072,1,1,2257,1320,-937
24073,1,0,69,0,-69
24074,0,0,11,0,-11
24075,1,1,516,1327,811
24076,0,0,180,0,-180
24077,0,0,33,0,-33
24078,1,1,201,1368,1167
24079,1,0,90,0,-90
24080,0,0,123,0,-123
24081,1,1,248,1686,1438
24082,0,0,13,0,-13
24083,0,0,22,0,-22
24084,1,1,626,1522,896
24085,0,0,62,0,-62
24086,0,0,75,0,-75
24087,1,0,37,0,-37
24088,0,0,24,0,-24
24089,0,0,79,0,-79
24090,1,1,1244,1688,444
24091,1,1,198,1659,1461
24092,1,0,45,0,-45
24093,1,1,481,1301,820
24094,1,1,513,1703,1190
24095,0,0,30,0,-30
24096,1,0,109,0,-109
24097,1,0,54,0,-54
24098,1,0,12,0,-12
24099,1,0,71,0,-71
24100,0,0,10,0,-10
24101,1,0,80,0,-80
24102,0,0,41,0,-41
24103,0,0,274,0,-274
24104,1,0,14,0,-14
24105,0,0,179,0,-179
24106,0,0,22,0,-22
24107,1,0,4,0,-4
24108,0,0,49,0,-49
24109,1,0,49,0,-49
24110,1,1,316,1311,995
24111,0,0,7,0,-7
24112,0,0,29,0,-29
24113,1,0,43,0,-43
24114,0,0,35,0,-35
24115,1,1,209,1347,1138
24116,0,0,55,0,-55
24117,0,0,138,0,-138
24118,0,0,0,0,0
24119,0,0,102,0,-102
24120,0,0,72,0,-72
24121,1,1,152,2893,2741
24122,1,0,98,0,-98
24123,0,0,39,0,-39
24124,0,0,192,0,-192
24125,1,1,1380,1686,306
24126,1,1,30,1292,1262
24127,1,1,1197,1292,95
24128,0,0,0,0,0
24129,1,0,10,0,-10
24130,1,1,127,1243,1116
24131,0,0,114,0,-114
24132,1,0,236,0,-236
24133,0,0,28,0,-28
24134,1,1,2537,1981,-556
24135,0,0,26,0,-26
24136,1,0,30,0,-30
24137,1,0,118,0,-118
24138,1,0,73,0,-73
24139,1,0,40,0,-40
24140,1,0,36,0,-36
24141,1,0,12,0,-12
24142,1,1,110,1440,1330
24143,1,1,363,1378,1015
24144,1,0,5,0,-5
24145,1,0,36,0,-36
24146,0,0,36,0,-36
24147,0,0,36,0,-36
24148,1,0,145,0,-145
24149,1,0,35,0,-35
24150,0,0,71,0,-71
24151,1,1,26,1624,1598
24152,1,0,22,0,-22
24153,0,0,2,0,-2
24154,0,0,0,0,0
24155,1,0,41,0,-41
24156,1,0,43,0,-43
24157,1,0,14,0,-14
24158,1,0,67,0,-67
24159,0,0,124,0,-124
24160,1,1,34,1289,1255
24161,0,0,370,0,-370
24162,0,0,2,0,-2
24163,1,0,101,0,-101
24164,0,0,45,0,-45
24165,1,1,1749,1395,-354
24166,1,0,3,0,-3
24167,0,0,18,0,-18
24168,1,1,89,1264,1175
24169,1,1,339,1709,1370
24170,1,0,101,0,-101
24171,1,0,19,0,-19
24172,1,0,75,0,-75
24173,1,0,34,0,-34
24174,1,0,183,0,-183
24175,1,0,51,0,-51
24176,1,1,148,1277,1129
24177,1,0,54,0,-54
24178,1,0,136,0,-136
24179,1,0,52,0,-52
24180,0,0,14,0,-14
24181,0,0,91,0,-91
24182,1,1,339,1252,913
24183,1,0,71,0,-71
24184,1,1,684,1739,1055
24185,1,1,425,1280,855
24186,0,0,5,0,-5
24187,1,1,423,1587,1164
24188,1,0,15,0,-15
24189,1,1,402,1373,971
24190,0,0,36,0,-36
24191,0,0,39,0,-39
24192,1,0,39,0,-39
24193,0,0,36,0,-36
24194,1,0,7,0,-7
24195,1,1,287,1395,1108
24196,0,0,141,0,-141
24197,0,0,192,0,-192
24198,1,0,34,0,-34
24199,0,0,205,0,-205
24200,1,0,77,0,-77
24201,0,0,95,0,-95
24202,1,1,74,1525,1451
24203,1,0,20,0,-20
24204,0,0,25,0,-25
24205,0,0,35,0,-35
24206,1,1,331,1477,1146
24207,1,1,392,1245,853
24208,0,0,46,0,-46
24209,1,1,35,1279,1244
24210,0,0,52,0,-52
24211,1,0,15,0,-15
24212,0,0,24,0,-24
24213,0,0,35,0,-35
24214,0,0,82,0,-82
24215,0,0,20,0,-20
24216,1,0,4,0,-4
24217,1,0,102,0,-102
24218,1,1,268,1778,1510
24219,0,0,9,0,-9
24220,0,0,51,0,-51
24221,1,0,185,0,-185
24222,1,1,34,1550,1516
24223,1,0,1,0,-1
24224,1,0,67,0,-67
24225,0,0,109,0,-109
24226,1,0,63,0,-63
24227,1,0,33,0,-33
24228,1,0,19,0,-19
24229,1,0,113,0,-113
24230,1,1,340,1258,918
24231,0,0,169,0,-169
24232,0,0,42,0,-42
24233,0,0,39,0,-39
24234,0,0,146,0,-146
24235,1,1,338,1325,987
24236,1,0,14,0,-14
24237,1,1,67,1341,1274
24238,1,1,226,1834,1608
24239,0,0,52,0,-52
24240,1,1,382,1365,983
24241,1,1,31,1348,1317
24242,1,1,42,1953,1911
24243,0,0,99,0,-99
24244,1,0,96,0,-96
24245,1,0,1,0,-1
24246,0,0,19,0,-19
24247,0,0,21,0,-21
24248,1,0,49,0,-49
24249,0,0,20,0,-20
24250,0,0,2,0,-2
24251,1,0,10,0,-10
24252,1,1,535,1383,848
24253,1,1,522,1238,716
24254,1,1,299,1511,1212
24255,0,0,43,0,-43
24256,1,1,989,1286,297
24257,1,1,385,1448,1063
24258,0,0,23,0,-23
24259,1,1,566,1469,903
24260,1,0,53,0,-53
24261,0,0,45,0,-45
24262,0,0,28,0,-28
24263,0,0,92,0,-92
24264,1,1,399,1345,946
24265,1,0,0,0,0
24266,0,0,4,0,-4
24267,0,0,55,0,-55
24268,1,0,148,0,-148
24269,0,0,126,0,-126
24270,0,0,68,0,-68
24271,1,1,501,1608,1107
24272,1,0,82,0,-82
24273,1,1,205,1235,1030
24274,0,0,316,0,-316
24275,1,0,17,0,-17
24276,0,0,11,0,-11
24277,1,1,3654,1443,-2211
24278,0,0,85,0,-85
24279,0,0,67,0,-67
24280,0,0,18,0,-18
24281,0,0,46,0,-46
24282,1,1,253,1524,1271
24283,1,1,1997,1337,-660
24284,1,1,573,1476,903
24285,0,0,74,0,-74
24286,1,1,437,1545,1108
24287,1,0,14,0,-14
24288,1,0,5,0,-5
24289,1,0,3,0,-3
24290,1,0,31,0,-31
24291,1,1,1800,1869,69
24292,0,0,96,0,-96
24293,1,0,39,0,-39
24294,1,1,132,1380,1248
24295,1,0,42,0,-42
24296,0,0,146,0,-146
24297,1,0,55,0,-55
24298,1,1,203,1255,1052
24299,1,0,23,0,-23
24300,1,0,7,0,-7
24301,1,0,27,0,-27
24302,1,0,31,0,-31
24303,1,1,47,2126,2079
24304,1,0,32,0,-32
24305,1,0,37,0,-37
24306,1,0,7,0,-7
24307,1,0,140,0,-140
24308,1,0,181,0,-181
24309,1,1,57,1629,1572
24310,0,0,12,0,-12
24311,0,0,16,0,-16
24312,0,0,4,0,-4
24313,1,1,123,1359,1236
24314,1,1,210,1282,1072
24315,1,0,63,0,-63
24316,0,0,3,0,-3
24317,0,0,24,0,-24
24318,0,0,49,0,-49
24319,0,0,114,0,-114
24320,0,0,248,0,-248
24321,1,1,109,1946,1837
24322,1,1,246,1764,1518
24323,1,0,88,0,-88
24324,0,0,55,0,-55
24325,1,1,2980,1492,-1488
24326,0,0,64,0,-64
24327,0,0,52,0,-52
24328,1,1,1272,1499,227
24329,1,0,99,0,-99
24330,0,0,14,0,-14
24331,1,0,36,0,-36
24332,1,0,65,0,-65
24333,1,1,528,1546,1018
24334,1,1,154,2180,2026
24335,0,0,9,0,-9
24336,0,0,23,0,-23
24337,0,0,16,0,-16
24338,0,0,43,0,-43
24339,1,0,21,0,-21
24340,1,0,85,0,-85
24341,0,0,11,0,-11
24342,0,0,39,0,-39
24343,1,0,72,0,-72
24344,1,0,99,0,-99
24345,1,1,149,1538,1389
24346,1,1,328,1788,1460
24347,0,0,18,0,-18
24348,0,0,40,0,-40
24349,0,0,47,0,-47
24350,0,0,42,0,-42
24351,0,0,38,0,-38
24352,1,1,714,1320,606
24353,0,0,50,0,-50
24354,1,1,253,2318,2065
24355,1,1,398,1563,1165
24356,0,0,7,0,-7
24357,0,0,35,0,-35
24358,0,0,1,0,-1
24359,0,0,103,0,-103
24360,1,1,186,1459,1273
24361,1,1,1231,1564,333
24362,1,0,72,0,-72
24363,0,0,5,0,-5
24364,0,0,19,0,-19
24365,1,1,657,5308,4651
24366,0,0,5,0,-5
24367,1,0,18,0,-18
24368,0,0,29,0,-29
24369,1,0,17,0,-17
24370,1,0,42,0,-42
24371,0,0,147,0,-147
24372,1,1,209,1432,1223
24373,1,1,138,1256,1118
24374,0,0,227,0,-227
24375,0,0,60,0,-60
24376,1,0,45,0,-45
24377,1,1,235,2005,1770
24378,0,0,39,0,-39
24379,0,0,6,0,-6
24380,0,0,22,0,-22
24381,1,1,175,1444,1269
24382,0,0,15,0,-15
24383,0,0,30,0,-30
24384,0,0,155,0,-155
24385,0,0,61,0,-61
24386,1,0,53,0,-53
24387,1,0,23,0,-23
24388,0,0,167,0,-167
24389,1,1,834,1947,1113
24390,1,0,50,0,-50
24391,0,0,55,0,-55
24392,1,0,100,0,-100
24393,0,0,180,0,-180
24394,1,1,78,1519,1441
24395,1,1,203,1748,1545
24396,0,0,31,0,-31
24397,0,0,10,0,-10
24398,1,1,312,2238,1926
24399,1,0,77,0,-77
24400,1,1,183,1268,1085
24401,1,0,121,0,-121
24402,1,1,144,1556,1412
24403,0,0,19,0,-19
24404,1,1,227,1272,1045
24405,1,0,66,0,-66
24406,0,0,2,0,-2
24407,0,0,77,0,-77
24408,0,0,8,0,-8
24409,1,0,31,0,-31
24410,1,0,11,0,-11
24411,1,1,1564,1364,-200
24412,1,0,39,0,-39
24413,1,1,319,1321,1002
24414,1,0,26,0,-26
24415,1,0,5,0,-5
24416,1,1,1839,1912,73
24417,0,0,53,0,-53
24418,0,0,8,0,-8
24419,0,0,2,0,-2
24420,1,1,249,1411,1162
24421,0,0,72,0,-72
24422,1,0,259,0,-259
24423,0,0,1,0,-1
24424,1,1,69,1863,1794
24425,1,0,58,0,-58
24426,1,0,43,0,-43
24427,1,1,777,1376,599
24428,1,1,298,1309,1011
24429,1,1,349,1291,942
24430,0,0,28,0,-28
24431,1,1,1275,1291,16
24432,0,0,20,0,-20
24433,0,0,72,0,-72
24434,0,0,66,0,-66
24435,0,0,18,0,-18
24436,1,0,7,0,-7
24437,1,1,62,2684,2622
24438,1,0,53,0,-53
24439,0,0,12,0,-12
24440,0,0,47,0,-47
24441,0,0,16,0,-16
24442,0,0,24,0,-24
24443,1,0,20,0,-20
24444,1,0,8,0,-8
24445,0,0,54,0,-54
24446,0,0,134,0,-134
24447,0,0,61,0,-61
24448,0,0,6,0,-6
24449,1,0,30,0,-30
24450,1,0,101,0,-101
24451,1,1,281,1906,1625
24452,1,1,524,1797,1273
24453,1,0,22,0,-22
24454,0,0,2,0,-2
24455,1,0,33,0,-33
24456,1,0,59,0,-59
24457,0,0,3,0,-3
24458,1,0,1,0,-1
24459,1,1,174,2697,2523
24460,1,1,54,1272,1218
24461,0,0,45,0,-45
24462,0,0,13,0,-13
24463,1,1,1095,1727,632
24464,0,0,26,0,-26
24465,0,0,6,0,-6
24466,1,1,971,1332,361
24467,1,1,622,1508,886
24468,0,0,209,0,-209
24469,0,0,11,0,-11
24470,1,0,36,0,-36
24471,0,0,3,0,-3
24472,0,0,8,0,-8
24473,0,0,6,0,-6
24474,1,0,49,0,-49
24475,1,1,615,2396,1781
24476,1,1,191,1713,1522
24477,1,0,13,0,-13
24478,1,0,23,0,-23
24479,1,0,0,0,0
24480,0,0,38,0,-38
24481,1,0,35,0,-35
24482,0,0,119,0,-119
24483,1,0,1,0,-1
24484,1,0,57,0,-57
24485,0,0,78,0,-78
24486,0,0,7,0,-7
24487,1,1,723,1587,864
24488,1,0,5,0,-5
24489,0,0,10,0,-10
24490,1,1,139,3178,3039
24491,1,0,20,0,-20
24492,1,1,1078,1340,262
24493,0,0,20,0,-20
24494,0,0,36,0,-36
24495,1,1,276,1291,1015
24496,0,0,113,0,-113
24497,1,0,38,0,-38
24498,0,0,16,0,-16
24499,1,0,143,0,-143
24500,1,1,154,1912,1758
24501,0,0,15,0,-15
24502,1,0,9,0,-9
24503,0,0,56,0,-56
24504,1,0,110,0,-110
24505,1,1,1307,1647,340
24506,1,1,203,2082,1879
24507,0,0,5,0,-5
24508,1,0,69,0,-69
24509,0,0,16,0,-16
24510,1,0,17,0,-17
24511,0,0,47,0,-47
24512,0,0,11,0,-11
24513,1,1,401,1829,1428
24514,0,0,41,0,-41
24515,0,0,132,0,-132
24516,0,0,36,0,-36
24517,1,0,142,0,-142
24518,0,0,119,0,-119
24519,1,1,270,1451,1181
24520,1,0,11,0,-11
24521,1,0,57,0,-57
24522,1,0,0,0,0
24523,0,0,3,0,-3
24524,0,0,58,0,-58
24525,0,0,30,0,-30
24526,1,0,41,0,-41
24527,0,0,8,0,-8
24528,0,0,90,0,-90
24529,0,0,8,0,-8
24530,1,1,273,1517,1244
24531,1,0,30,0,-30
24532,1,1,420,1268,848
24533,0,0,26,0,-26
24534,1,1,269,1586,1317
24535,0,0,12,0,-12
24536,1,0,35,0,-35
24537,1,0,19,0,-19
24538,0,0,61,0,-61
24539,1,1,757,1328,571
24540,0,0,102,0,-102
24541,0,0,69,0,-69
24542,0,0,114,0,-114
24543,1,0,18,0,-18
24544,1,0,2,0,-2
24545,0,0,4,0,-4
24546,1,1,147,1565,1418
24547,0,0,45,0,-45
24548,0,0,170,0,-170
24549,0,0,45,0,-45
24550,0,0,22,0,-22
24551,1,0,12,0,-12
24552,1,1,1532,1284,-248
24553,1,1,529,1313,784
24554,0,0,11,0,-11
24555,0,0,31,0,-31
24556,0,0,41,0,-41
24557,1,0,35,0,-35
24558,1,1,635,1503,868
24559,0,0,22,0,-22
24560,1,0,28,0,-28
24561,1,1,381,1521,1140
24562,1,0,21,0,-21
24563,1,1,1216,1463,247
24564,1,0,16,0,-16
24565,1,0,103,0,-103
24566,0,0,69,0,-69
24567,0,0,43,0,-43
24568,1,1,272,1411,1139
24569,0,0,14,0,-14
24570,0,0,11,0,-11
24571,0,0,13,0,-13
24572,0,0,14,0,-14
24573,0,0,75,0,-75
24574,1,0,46,0,-46
24575,1,1,71,1258,1187
24576,1,1,1319,2351,1032
24577,1,0,4,0,-4
24578,1,1,220,1266,1046
24579,1,0,24,0,-24
24580,1,1,1213,1826,613
24581,0,0,49,0,-49
24582,1,1,118,1424,1306
24583,1,0,10,0,-10
24584,1,0,6,0,-6
24585,0,0,27,0,-27
24586,1,1,242,1424,1182
24587,0,0,17,0,-17
24588,1,0,59,0,-59
24589,0,0,14,0,-14
24590,1,0,9,0,-9
24591,1,0,51,0,-51
24592,1,1,256,1844,1588
24593,1,1,637,1594,957
24594,0,0,27,0,-27
24595,0,0,47,0,-47
24596,1,0,160,0,-160
24597,1,0,106,0,-106
24598,0,0,23,0,-23
24599,1,0,3,0,-3
24600,0,0,56,0,-56
24601,1,0,23,0,-23
24602,1,0,6,0,-6
24603,0,0,45,0,-45
24604,1,0,42,0,-42
24605,1,1,457,1611,1154
24606,1,1,683,1470,787
24607,0,0,14,0,-14
24608,0,0,44,0,-44
24609,0,0,2,0,-2
24610,0,0,26,0,-26
24611,1,1,129,1808,1679
24612,0,0,106,0,-106
24613,1,0,122,0,-122
24614,1,0,46,0,-46
24615,1,1,1000,1292,292
24616,1,0,81,0,-81
24617,0,0,20,0,-20
24618,0,0,53,0,-53
24619,1,1,212,2369,2157
24620,1,1,781,1594,813
24621,1,1,577,2592,2015
24622,1,0,34,0,-34
24623,1,1,1138,1263,125
24624,0,0,2,0,-2
24625,1,0,28,0,-28
24626,1,0,80,0,-80
24627,1,0,15,0,-15
24628,1,1,966,2920,1954
24629,1,1,206,1471,1265
24630,0,0,5,0,-5
24631,0,0,169,0,-169
24632,0,0,95,0,-95
24633,1,1,184,1246,1062
24634,1,1,915,2082,1167
24635,0,0,3,0,-3
24636,0,0,190,0,-190
24637,0,0,129,0,-129
24638,1,1,714,1387,673
24639,0,0,130,0,-130
24640,1,0,34,0,-34
24641,0,0,125,0,-125
24642,1,1,1085,1476,391
24643,1,0,52,0,-52
24644,1,1,826,1500,674
24645,0,0,98,0,-98
24646,0,0,15,0,-15
24647,1,1,96,2358,2262
24648,1,1,1625,1397,-228
24649,1,1,95,2094,1999
24650,1,0,6,0,-6
24651,0,0,30,0,-30
24652,1,0,27,0,-27
24653,0,0,176,0,-176
24654,1,1,139,1237,1098
24655,1,0,97,0,-97
24656,1,0,67,0,-67
24657,1,1,860,1383,523
24658,1,1,1795,1289,-506
24659,1,1,692,2095,1403
24660,1,1,707,1375,668
24661,1,0,121,0,-121
24662,1,0,56,0,-56
24663,1,1,404,1675,1271
24664,1,1,1125,1295,170
24665,1,0,96,0,-96
24666,1,0,7,0,-7
24667,0,0,62,0,-62
24668,1,0,6,0,-6
24669,1,1,18,1238,1220
24670,1,0,62,0,-62
24671,1,1,488,1933,1445
24672,1,1,442,1316,874
24673,1,1,201,1310,1109
24674,1,1,672,1263,591
24675,1,1,788,1263,475
24676,1,1,273,1698,1425
24677,1,0,19,0,-19
24678,1,0,28,0,-28
24679,1,0,4,0,-4
24680,1,1,476,1510,1034
24681,1,1,1046,1406,360
24682,1,1,249,1440,1191
24683,1,1,515,1623,1108
24684,1,0,262,0,-262
24685,1,0,31,0,-31
24686,0,0,57,0,-57
24687,1,1,994,2783,1789
24688,1,0,0,0,0
24689,1,0,6,0,-6
24690,0,0,31,0,-31
24691,1,0,31,0,-31
24692,1,0,50,0,-50
24693,1,1,396,2764,2368
24694,0,0,0,0,0
24695,1,0,52,0,-52
24696,0,0,24,0,-24
24697,0,0,2,0,-2
24698,1,1,1388,1761,373
24699,0,0,1,0,-1
24700,0,0,15,0,-15
24701,1,1,193,1254,1061
24702,1,0,70,0,-70
24703,0,0,41,0,-41
24704,1,0,19,0,-19
24705,0,0,40,0,-40
24706,1,1,285,1657,1372
24707,1,1,824,1464,640
24708,0,0,86,0,-86
24709,1,1,69,1688,1619
24710,1,0,4,0,-4
24711,1,0,9,0,-9
24712,0,0,36,0,-36
24713,1,1,651,1480,829
24714,0,0,191,0,-191
24715,1,1,605,1648,1043
24716,1,0,3,0,-3
24717,1,0,5,0,-5
24718,1,1,589,1273,684
24719,1,0,93,0,-93
24720,1,1,799,2336,1537
24721,1,0,3,0,-3
24722,0,0,19,0,-19
24723,1,1,321,1245,924
24724,0,0,59,0,-59
24725,0,0,9,0,-9
24726,0,0,40,0,-40
24727,1,0,16,0,-16
24728,0,0,34,0,-34
24729,0,0,89,0,-89
24730,1,1,2558,1363,-1195
24731,1,0,16,0,-16
24732,1,0,12,0,-12
24733,0,0,138,0,-138
24734,1,0,27,0,-27
24735,0,0,42,0,-42
24736,0,0,65,0,-65
24737,0,0,129,0,-129
24738,1,1,405,1464,1059
24739,1,0,20,0,-20
24740,0,0,36,0,-36
24741,0,0,192,0,-192
24742,1,1,354,1313,959
24743,1,1,921,2393,1472
24744,0,0,37,0,-37
24745,1,1,85,1805,1720
24746,1,0,59,0,-59
24747,1,0,2,0,-2
24748,1,0,16,0,-16
24749,1,0,91,0,-91
24750,1,1,95,1989,1894
24751,0,0,86,0,-86
24752,0,0,101,0,-101
24753,0,0,68,0,-68
24754,1,0,2,0,-2
24755,1,0,146,0,-146
24756,1,1,824,1259,435
24757,0,0,53,0,-53
24758,1,1,88,1725,1637
24759,1,1,803,2077,1274
24760,1,0,95,0,-95
24761,0,0,28,0,-28
24762,1,1,686,1248,562
24763,1,1,667,1253,586
24764,1,1,998,1801,803
24765,1,0,1,0,-1
24766,0,0,97,0,-97
24767,1,0,1,0,-1
24768,1,0,79,0,-79
24769,0,0,102,0,-102
24770,1,1,1560,1717,157
24771,0,0,101,0,-101
24772,1,1,354,1793,1439
24773,1,0,22,0,-22
24774,0,0,65,0,-65
24775,0,0,0,0,0
24776,1,1,329,1323,994
24777,0,0,46,0,-46
24778,1,0,52,0,-52
24779,1,0,30,0,-30
24780,0,0,20,0,-20
24781,1,1,702,1427,725
24782,1,1,153,1532,1379
24783,0,0,87,0,-87
24784,0,0,182,0,-182
24785,1,1,645,1706,1061
24786,1,0,3,0,-3
24787,1,0,14,0,-14
24788,1,1,112,3916,3804
24789,0,0,34,0,-34
24790,0,0,23,0,-23
24791,1,0,69,0,-69
24792,0,0,12,0,-12
24793,0,0,34,0,-34
24794,0,0,61,0,-61
24795,0,0,77,0,-77
24796,1,1,696,1644,948
24797,1,0,112,0,-112
24798,1,0,151,0,-151
24799,0,0,6,0,-6
24800,1,0,13,0,-13
24801,1,0,92,0,-92
24802,0,0,12,0,-12
24803,0,0,37,0,-37
24804,1,1,316,2051,1735
24805,0,0,13,0,-13
24806,1,1,494,2645,2151
24807,0,0,33,0,-33
24808,0,0,33,0,-33
24809,0,0,21,0,-21
24810,0,0,68,0,-68
24811,0,0,15,0,-15
24812,1,0,2,0,-2
24813,1,0,233,0,-233
24814,1,0,57,0,-57
24815,0,0,10,0,-10
24816,1,0,9,0,-9
24817,1,0,1,0,-1
24818,1,1,337,2032,1695
24819,1,1,316,1373,1057
24820,0,0,9,0,-9
24821,1,0,63,0,-63
24822,0,0,26,0,-26
24823,0,0,98,0,-98
24824,0,0,38,0,-38
24825,1,0,99,0,-99
24826,1,1,603,1373,770
24827,1,1,751,1483,732
24828,0,0,23,0,-23
24829,1,1,677,1239,562
24830,0,0,32,0,-32
24831,0,0,33,0,-33
24832,1,0,22,0,-22
24833,0,0,62,0,-62
24834,1,0,14,0,-14
24835,0,0,81,0,-81
24836,1,1,1025,2878,1853
24837,1,1,317,4165,3848
24838,1,1,210,1574,1364
24839,0,0,142,0,-142
24840,1,0,15,0,-15
24841,1,1,372,2029,1657
24842,0,0,27,0,-27
24843,1,1,509,2138,1629
24844,1,0,63,0,-63
24845,1,1,426,1527,1101
24846,1,0,55,0,-55
24847,0,0,71,0,-71
24848,1,1,542,1253,711
24849,1,1,92,1678,1586
24850,1,0,115,0,-115
24851,1,0,175,0,-175
24852,1,1,97,1392,1295
24853,1,1,925,1588,663
24854,1,0,45,0,-45
24855,1,0,45,0,-45
24856,1,1,251,1251,1000
24857,0,0,66,0,-66
24858,0,0,44,0,-44
24859,0,0,4,0,-4
24860,0,0,42,0,-42
24861,0,0,10,0,-10
24862,1,1,434,1328,894
24863,0,0,51,0,-51
24864,0,0,10,0,-10
24865,0,0,54,0,-54
24866,1,1,1155,1813,658
24867,0,0,9,0,-9
24868,1,0,34,0,-34
24869,0,0,128,0,-128
24870,0,0,95,0,-95
24871,1,1,707,2145,1438
24872,1,1,1672,1588,-84
24873,0,0,72,0,-72
24874,0,0,45,0,-45
24875,0,0,59,0,-59
24876,1,0,18,0,-18
24877,1,0,1,0,-1
24878,0,0,7,0,-7
24879,0,0,4,0,-4
24880,1,1,431,1351,920
24881,1,1,1161,1264,103
24882,1,1,703,1258,555
24883,0,0,110,0,-110
24884,0,0,84,0,-84
24885,0,0,19,0,-19
24886,1,0,2,0,-2
24887,1,1,984,1407,423
24888,0,0,10,0,-10
24889,1,0,90,0,-90
24890,1,1,205,9687,9482
24891,1,1,744,1992,1248
24892,1,1,330,1271,941
24893,0,0,87,0,-87
24894,0,0,5,0,-5
24895,1,1,282,1327,1045
24896,1,0,67,0,-67
24897,0,0,44,0,-44
24898,1,0,53,0,-53
24899,1,1,406,1408,1002
24900,0,0,2,0,-2
24901,1,1,540,2474,1934
24902,0,0,25,0,-25
24903,1,1,701,1519,818
24904,1,0,38,0,-38
24905,1,1,380,1644,1264
24906,1,1,47,1841,1794
24907,1,1,1000,3711,2711
24908,0,0,46,0,-46
24909,1,1,438,1492,1054
24910,1,0,8,0,-8
24911,1,1,923,1469,546
24912,0,0,16,0,-16
24913,1,0,3,0,-3
24914,1,0,6,0,-6
24915,0,0,39,0,-39
24916,1,0,130,0,-130
24917,0,0,107,0,-107
24918,0,0,36,0,-36
24919,1,1,1175,1342,167
24920,1,0,35,0,-35
24921,1,1,571,1665,1094
24922,1,1,544,1438,894
24923,0,0,10,0,-10
24924,0,0,21,0,-21
24925,1,0,39,0,-39
24926,1,0,30,0,-30
24927,0,0,137,0,-137
24928,0,0,25,0,-25
24929,1,0,118,0,-118
24930,0,0,3,0,-3
24931,0,0,25,0,-25
24932,0,0,118,0,-118
24933,1,0,20,0,-20
24934,1,1,773,1353,580
24935,1,1,606,1346,740
24936,1,0,29,0,-29
24937,0,0,135,0,-135
24938,1,0,89,0,-89
24939,0,0,27,0,-27
24940,1,1,1160,1848,688
24941,1,1,596,1294,698
24942,0,0,12,0,-12
24943,0,0,20,0,-20
24944,0,0,5,0,-5
24945,1,1,293,1353,1060
24946,1,1,551,1455,904
24947,1,1,444,1569,1125
24948,0,0,84,0,-84
24949,0,0,12,0,-12
24950,1,1,462,1432,970
24951,1,0,0,0,0
24952,1,0,109,0,-109
24953,0,0,2,0,-2
24954,1,1,816,1242,426
24955,1,0,33,0,-33
24956,1,1,166,1794,1628
24957,0,0,1,0,-1
24958,0,0,18,0,-18
24959,1,0,24,0,-24
24960,1,0,111,0,-111
24961,1,0,23,0,-23
24962,1,1,1094,1737,643
24963,0,0,78,0,-78
24964,1,0,5,0,-5
24965,1,0,14,0,-14
24966,1,1,199,1440,1241
24967,0,0,44,0,-44
24968,1,1,326,1504,1178
24969,0,0,44,0,-44
24970,1,1,760,1394,634
24971,1,1,60,1298,1238
24972,0,0,30,0,-30
24973,0,0,71,0,-71
24974,1,0,116,0,-116
24975,1,0,31,0,-31
24976,1,1,819,1558,739
24977,0,0,2,0,-2
24978,1,0,115,0,-115
24979,0,0,7,0,-7
24980,1,0,13,0,-13
24981,1,1,308,1240,932
24982,1,1,1011,1444,433
24983,0,0,56,0,-56
24984,0,0,32,0,-32
24985,1,1,550,1440,890
24986,0,0,58,0,-58
24987,1,0,211,0,-211
24988,1,1,1318,2658,1340
24989,0,0,0,0,0
24990,1,0,25,0,-25
24991,0,0,12,0,-12
24992,1,0,20,0,-20
24993,1,1,974,1453,479
24994,1,0,9,0,-9
24995,1,1,409,1410,1001
24996,1,1,161,1530,1369
24997,1,1,529,2682,2153
24998,0,0,18,0,-18
24999,0,0,96,0,-96
25000,1,0,48,0,-48
25001,0,0,51,0,-51
25002,0,0,84,0,-84
25003,1,1,379,1524,1145
25004,0,0,39,0,-39
25005,0,0,47,0,-47
25006,0,0,10,0,-10
25007,1,1,345,1442,1097
25008,0,0,74,0,-74
25009,0,0,5,0,-5
25010,0,0,28,0,-28
25011,1,0,3,0,-3
25012,0,0,42,0,-42
25013,1,1,100,1247,1147
25014,0,0,53,0,-53
25015,0,0,45,0,-45
25016,1,1,2090,1395,-695
25017,1,0,0,0,0
25018,0,0,35,0,-35
25019,0,0,26,0,-26
25020,0,0,16,0,-16
25021,1,0,46,0,-46
25022,1,0,9,0,-9
25023,0,0,1,0,-1
25024,1,0,43,0,-43
25025,1,1,876,1475,599
25026,1,1,331,1558,1227
25027,1,0,7,0,-7
25028,1,0,113,0,-113
25029,1,1,373,2352,1979
25030,1,1,34,2006,1972
25031,0,0,20,0,-20
25032,1,1,533,1309,776
25033,0,0,76,0,-76
25034,1,0,13,0,-13
25035,0,0,32,0,-32
25036,0,0,15,0,-15
25037,1,1,769,1440,671
25038,0,0,80,0,-80
25039,1,0,31,0,-31
25040,0,0,27,0,-27
25041,1,0,119,0,-119
25042,1,0,47,0,-47
25043,1,0,40,0,-40
25044,0,0,175,0,-175
25045,0,0,29,0,-29
25046,1,0,222,0,-222
25047,0,0,32,0,-32
25048,1,0,9,0,-9
25049,1,0,191,0,-191
25050,1,0,17,0,-17
25051,1,1,1032,1686,654
25052,0,0,24,0,-24
25053,0,0,100,0,-100
25054,1,1,169,1515,1346
25055,0,0,54,0,-54
25056,0,0,39,0,-39
25057,0,0,72,0,-72
25058,1,1,1287,1603,316
25059,1,0,36,0,-36
25060,0,0,49,0,-49
25061,1,0,10,0,-10
25062,1,0,0,0,0
25063,1,0,147,0,-147
25064,1,0,195,0,-195
25065,0,0,12,0,-12
25066,1,1,541,1257,716
25067,0,0,23,0,-23
25068,1,0,92,0,-92
25069,1,1,600,1253,653
25070,1,0,45,0,-45
25071,1,0,8,0,-8
25072,0,0,223,0,-223
25073,0,0,6,0,-6
25074,0,0,71,0,-71
25075,0,0,105,0,-105
25076,0,0,0,0,0
25077,0,0,7,0,-7
25078,1,1,362,1289,927
25079,0,0,22,0,-22
25080,0,0,62,0,-62
25081,1,0,61,0,-61
25082,0,0,2,0,-2
25083,1,1,787,1539,752
25084,0,0,68,0,-68
25085,1,1,265,1608,1343
25086,0,0,83,0,-83
25087,1,1,1098,3149,2051
25088,0,0,155,0,-155
25089,0,0,23,0,-23
25090,1,0,125,0,-125
25091,1,1,792,1546,754
25092,1,0,67,0,-67
25093,1,0,52,0,-52
25094,1,1,292,1253,961
25095,0,0,128,0,-128
25096,1,0,149,0,-149
25097,1,1,92,1324,1232
25098,0,0,58,0,-58
25099,0,0,33,0,-33
25100,0,0,22,0,-22
25101,1,1,121,1463,1342
25102,0,0,5,0,-5
25103,1,1,103,2567,2464
25104,1,1,338,1824,1486
25105,0,0,28,0,-28
25106,1,1,254,1793,1539
25107,1,0,8,0,-8
25108,0,0,36,0,-36
25109,1,0,28,0,-28
25110,1,0,3,0,-3
25111,1,1,342,1618,1276
25112,0,0,1,0,-1
25113,0,0,62,0,-62
25114,0,0,51,0,-51
25115,0,0,7,0,-7
25116,0,0,12,0,-12
25117,1,0,35,0,-35
25118,0,0,61,0,-61
25119,1,1,636,1466,830
25120,0,0,43,0,-43
25121,1,0,52,0,-52
25122,1,0,114,0,-114
25123,1,0,1,0,-1
25124,1,1,1102,1537,435
25125,1,1,215,1780,1565
25126,1,1,732,2667,1935
25127,0,0,47,0,-47
25128,1,1,550,1522,972
25129,0,0,10,0,-10
25130,1,0,35,0,-35
25131,1,0,26,0,-26
25132,0,0,13,0,-13
25133,1,1,312,1273,961
25134,1,1,316,1262,946
25135,1,0,36,0,-36
25136,0,0,27,0,-27
25137,1,0,3,0,-3
25138,0,0,33,0,-33
25139,1,1,1610,1517,-93
25140,0,0,45,0,-45
25141,0,0,133,0,-133
25142,1,1,610,1333,723
25143,1,0,1,0,-1
25144,1,1,722,1526,804
25145,1,0,213,0,-213
25146,1,0,203,0,-203
25147,1,1,638,1278,640
25148,0,0,56,0,-56
25149,1,1,28,1279,1251
25150,1,1,137,1731,1594
25151,1,1,383,1370,987
25152,1,1,596,2080,1484
25153,0,0,33,0,-33
25154,1,0,18,0,-18
25155,0,0,95,0,-95
25156,1,0,9,0,-9
25157,0,0,62,0,-62
25158,1,1,468,3872,3404
25159,1,1,466,2756,2290
25160,1,1,456,1883,1427
25161,0,0,54,0,-54
25162,1,0,4,0,-4
25163,1,1,321,1628,1307
25164,1,0,2,0,-2
25165,1,0,52,0,-52
25166,0,0,81,0,-81
25167,0,0,87,0,-87
25168,1,1,1207,1572,365
25169,1,0,10,0,-10
25170,1,0,16,0,-16
25171,1,1,304,1381,1077
25172,1,0,18,0,-18
25173,1,1,543,1294,751
25174,1,0,107,0,-107
25175,1,1,952,1312,360
25176,0,0,159,0,-159
25177,0,0,37,0,-37
25178,0,0,55,0,-55
25179,1,1,529,1415,886
25180,1,0,24,0,-24
25181,0,0,21,0,-21
25182,0,0,48,0,-48
25183,0,0,4,0,-4
25184,1,1,1438,1442,4
25185,1,0,29,0,-29
25186,1,1,123,1367,1244
25187,0,0,49,0,-49
25188,0,0,148,0,-148
25189,1,0,108,0,-108
25190,1,1,630,1547,917
25191,1,0,25,0,-25
25192,0,0,1,0,-1
25193,0,0,26,0,-26
25194,1,0,20,0,-20
25195,0,0,12,0,-12
25196,0,0,48,0,-48
25197,1,1,277,1264,987
25198,1,1,41,1866,1825
25199,0,0,1,0,-1
25200,0,0,20,0,-20
25201,0,0,28,0,-28
25202,0,0,14,0,-14
25203,0,0,20,0,-20
25204,1,0,1,0,-1
25205,1,0,16,0,-16
25206,0,0,2,0,-2
25207,1,0,60,0,-60
25208,1,0,62,0,-62
25209,0,0,63,0,-63
25210,1,0,3,0,-3
25211,1,1,288,1671,1383
25212,0,0,14,0,-14
25213,1,1,89,2112,2023
25214,1,0,30,0,-30
25215,1,0,172,0,-172
25216,1,1,188,1527,1339
25217,0,0,4,0,-4
25218,0,0,139,0,-139
25219,1,0,88,0,-88
25220,0,0,59,0,-59
25221,1,1,1513,1260,-253
25222,1,0,19,0,-19
25223,1,0,11,0,-11
25224,1,1,308,1410,1102
25225,1,0,35,0,-35
25226,1,0,165,0,-165
25227,1,0,33,0,-33
25228,0,0,3,0,-3
25229,1,1,905,1854,949
25230,1,1,797,1701,904
25231,0,0,77,0,-77
25232,0,0,16,0,-16
25233,1,0,89,0,-89
25234,1,1,113,1363,1250
25235,1,0,43,0,-43
25236,0,0,54,0,-54
25237,1,1,79,2199,2120
25238,1,0,183,0,-183
25239,0,0,8,0,-8
25240,1,0,298,0,-298
25241,1,1,133,1476,1343
25242,0,0,11,0,-11
25243,1,1,105,2420,2315
25244,1,0,17,0,-17
25245,1,0,23,0,-23
25246,1,1,1155,1339,184
25247,1,0,59,0,-59
25248,1,0,66,0,-66
25249,1,1,763,1749,986
25250,1,0,64,0,-64
25251,0,0,3,0,-3
25252,0,0,9,0,-9
25253,0,0,52,0,-52
25254,1,0,33,0,-33
25255,1,1,57,1613,1556
25256,0,0,19,0,-19
25257,0,0,58,0,-58
25258,1,1,1288,1467,179
25259,0,0,9,0,-9
25260,0,0,2,0,-2
25261,1,0,82,0,-82
25262,0,0,30,0,-30
25263,0,0,35,0,-35
25264,1,0,1,0,-1
25265,0,0,14,0,-14
25266,1,0,14,0,-14
25267,1,1,8,2222,2214
25268,0,0,62,0,-62
25269,1,0,11,0,-11
25270,0,0,35,0,-35
25271,1,1,351,1442,1091
25272,1,1,604,1887,1283
25273,1,1,695,1365,670
25274,1,0,62,0,-62
25275,0,0,8,0,-8
25276,1,1,997,2005,1008
25277,0,0,63,0,-63
25278,0,0,110,0,-110
25279,1,0,61,0,-61
25280,1,0,17,0,-17
25281,1,1,1651,1659,8
25282,0,0,2,0,-2
25283,0,0,66,0,-66
25284,1,0,17,0,-17
25285,1,1,435,1238,803
25286,1,0,40,0,-40
25287,1,1,382,2079,1697
25288,0,0,10,0,-10
25289,1,1,248,2055,1807
25290,1,0,37,0,-37
25291,1,1,439,1829,1390
25292,1,0,24,0,-24
25293,1,0,48,0,-48
25294,0,0,35,0,-35
25295,0,0,66,0,-66
25296,1,0,113,0,-113
25297,1,1,103,1725,1622
25298,1,0,4,0,-4
25299,1,0,17,0,-17
25300,1,1,131,2464,2333
25301,1,1,278,1526,1248
25302,1,1,271,1285,1014
25303,1,0,6,0,-6
25304,1,0,17,0,-17
25305,1,0,9,0,-9
25306,1,0,23,0,-23
25307,1,0,48,0,-48
25308,1,1,190,1478,1288
25309,0,0,24,0,-24
25310,1,0,30,0,-30
25311,1,1,104,1653,1549
25312,1,0,2,0,-2
25313,1,0,8,0,-8
25314,1,0,66,0,-66
25315,1,1,384,1546,1162
25316,1,0,113,0,-113
25317,1,0,96,0,-96
25318,1,0,44,0,-44
25319,1,0,10,0,-10
25320,1,0,5,0,-5
25321,0,0,33,0,-33
25322,0,0,75,0,-75
25323,1,1,871,4652,3781
25324,1,1,1278,1304,26
25325,1,0,9,0,-9
25326,1,1,473,1257,784
25327,0,0,14,0,-14
25328,1,0,58,0,-58
25329,1,0,77,0,-77
25330,0,0,52,0,-52
25331,0,0,37,0,-37
25332,0,0,24,0,-24
25333,1,0,28,0,-28
25334,0,0,50,0,-50
25335,0,0,16,0,-16
25336,1,1,1244,1514,270
25337,1,0,151,0,-151
25338,1,0,4,0,-4
25339,1,0,18,0,-18
25340,1,0,61,0,-61
25341,0,0,140,0,-140
25342,0,0,0,0,0
25343,1,0,60,0,-60
25344,0,0,19,0,-19
25345,0,0,32,0,-32
25346,1,0,34,0,-34
25347,0,0,38,0,-38
25348,1,1,172,2151,1979
25349,1,0,78,0,-78
25350,1,0,4,0,-4
25351,1,0,77,0,-77
25352,0,0,21,0,-21
25353,0,0,49,0,-49
25354,1,1,991,1287,296
25355,1,1,388,1673,1285
25356,0,0,50,0,-50
25357,1,1,1329,1531,202
25358,0,0,99,0,-99
25359,1,0,6,0,-6
25360,1,1,406,1256,850
25361,1,0,53,0,-53
25362,0,0,98,0,-98
25363,0,0,4,0,-4
25364,0,0,10,0,-10
25365,1,0,52,0,-52
25366,0,0,121,0,-121
25367,0,0,95,0,-95
25368,0,0,6,0,-6
25369,0,0,6,0,-6
25370,1,1,332,1334,1002
25371,0,0,54,0,-54
25372,0,0,21,0,-21
25373,0,0,20,0,-20
25374,0,0,26,0,-26
25375,0,0,20,0,-20
25376,0,0,341,0,-341
25377,1,0,136,0,-136
25378,1,0,7,0,-7
25379,0,0,186,0,-186
25380,1,0,153,0,-153
25381,1,0,43,0,-43
25382,1,1,111,1236,1125
25383,0,0,63,0,-63
25384,0,0,58,0,-58
25385,0,0,13,0,-13
25386,1,1,488,1573,1085
25387,0,0,135,0,-135
25388,1,1,689,1473,784
25389,1,0,4,0,-4
25390,0,0,6,0,-6
25391,1,1,351,1279,928
25392,1,1,1512,1501,-11
25393,0,0,145,0,-145
25394,0,0,2,0,-2
25395,1,0,46,0,-46
25396,1,1,296,1338,1042
25397,1,1,232,1851,1619
25398,0,0,4,0,-4
25399,1,0,121,0,-121
25400,1,1,2726,1261,-1465
25401,1,0,2,0,-2
25402,1,0,135,0,-135
25403,1,1,404,2737,2333
25404,1,1,74,1860,1786
25405,0,0,66,0,-66
25406,1,1,170,1377,1207
25407,1,0,89,0,-89
25408,1,0,49,0,-49
25409,1,0,37,0,-37
25410,0,0,33,0,-33
25411,0,0,12,0,-12
25412,1,0,52,0,-52
25413,1,0,107,0,-107
25414,0,0,9,0,-9
25415,1,0,3,0,-3
25416,1,1,707,1771,1064
25417,0,0,38,0,-38
25418,0,0,58,0,-58
25419,1,1,565,2728,2163
25420,0,0,34,0,-34
25421,0,0,31,0,-31
25422,1,1,882,2271,1389
25423,1,0,0,0,0
25424,1,0,3,0,-3
25425,0,0,12,0,-12
25426,1,0,1,0,-1
25427,0,0,39,0,-39
25428,1,1,1721,2104,383
25429,1,0,108,0,-108
25430,0,0,135,0,-135
25431,0,0,24,0,-24
25432,0,0,43,0,-43
25433,0,0,16,0,-16
25434,1,1,359,1369,1010
25435,0,0,71,0,-71
25436,0,0,94,0,-94
25437,1,1,192,1734,1542
25438,1,0,63,0,-63
25439,1,1,53,1398,1345
25440,1,0,47,0,-47
25441,0,0,1,0,-1
25442,1,1,687,1460,773
25443,0,0,9,0,-9
25444,1,1,539,1268,729
25445,0,0,4,0,-4
25446,0,0,89,0,-89
25447,1,0,72,0,-72
25448,1,0,51,0,-51
25449,0,0,48,0,-48
25450,1,0,50,0,-50
25451,1,1,275,1633,1358
25452,0,0,10,0,-10
25453,1,0,9,0,-9
25454,1,0,77,0,-77
25455,1,1,425,1814,1389
25456,1,0,83,0,-83
25457,0,0,7,0,-7
25458,0,0,33,0,-33
25459,1,0,111,0,-111
25460,0,0,201,0,-201
25461,1,1,863,1857,994
25462,1,0,8,0,-8
25463,1,0,9,0,-9
25464,1,1,729,1521,792
25465,0,0,43,0,-43
25466,1,0,155,0,-155
25467,1,0,83,0,-83
25468,0,0,5,0,-5
25469,0,0,4,0,-4
25470,0,0,134,0,-134
25471,0,0,47,0,-47
25472,1,0,180,0,-180
25473,0,0,3,0,-3
25474,0,0,96,0,-96
25475,1,0,69,0,-69
25476,0,0,19,0,-19
25477,1,1,1536,2202,666
25478,1,1,181,1243,1062
25479,1,1,820,1895,1075
25480,0,0,23,0,-23
25481,1,0,37,0,-37
25482,1,1,305,1518,1213
25483,1,0,0,0,0
25484,1,0,12,0,-12
25485,0,0,2,0,-2
25486,1,0,49,0,-49
25487,0,0,14,0,-14
25488,0,0,11,0,-11
25489,1,1,241,1371,1130
25490,0,0,118,0,-118
25491,1,1,158,1266,1108
25492,1,1,208,1331,1123
25493,1,1,186,1719,1533
25494,1,0,27,0,-27
25495,1,1,179,1297,1118
25496,0,0,10,0,-10
25497,0,0,136,0,-136
25498,1,0,14,0,-14
25499,1,0,1,0,-1
25500,1,1,883,1308,425
25501,0,0,76,0,-76
25502,1,1,306,2115,1809
25503,0,0,119,0,-119
25504,1,1,11,1457,1446
25505,1,0,4,0,-4
25506,1,1,164,1423,1259
25507,0,0,3,0,-3
25508,1,1,1628,1828,200
25509,0,0,23,0,-23
25510,1,1,612,1336,724
25511,0,0,30,0,-30
25512,0,0,74,0,-74
25513,1,0,32,0,-32
25514,1,0,16,0,-16
25515,1,0,208,0,-208
25516,0,0,44,0,-44
25517,1,1,1142,1554,412
25518,0,0,50,0,-50
25519,0,0,166,0,-166
25520,1,1,173,1754,1581
25521,0,0,24,0,-24
25522,1,1,393,1852,1459
25523,1,1,131,1409,1278
25524,0,0,23,0,-23
25525,1,1,203,1502,1299
25526,0,0,135,0,-135
25527,0,0,17,0,-17
25528,1,0,24,0,-24
25529,0,0,69,0,-69
25530,1,0,45,0,-45
25531,0,0,89,0,-89
25532,0,0,44,0,-44
25533,1,1,108,1531,1423
25534,1,0,367,0,-367
25535,1,0,7,0,-7
25536,0,0,104,0,-104
25537,0,0,97,0,-97
25538,0,0,28,0,-28
25539,1,0,53,0,-53
25540,0,0,7,0,-7
25541,0,0,49,0,-49
25542,1,1,102,1270,1168
25543,1,0,272,0,-272
25544,0,0,11,0,-11
25545,1,0,9,0,-9
25546,0,0,0,0,0
25547,1,1,61,1235,1174
25548,0,0,6,0,-6
25549,0,0,30,0,-30
25550,1,0,35,0,-35
25551,1,0,65,0,-65
25552,0,0,2,0,-2
25553,0,0,23,0,-23
25554,1,0,64,0,-64
25555,1,0,5,0,-5
25556,0,0,7,0,-7
25557,0,0,66,0,-66
25558,0,0,1,0,-1
25559,0,0,0,0,0
25560,1,1,556,1292,736
25561,1,0,3,0,-3
25562,1,1,104,1735,1631
25563,1,1,439,1810,1371
25564,1,0,14,0,-14
25565,1,0,3,0,-3
25566,1,1,190,1992,1802
25567,0,0,112,0,-112
25568,1,0,6,0,-6
25569,1,0,14,0,-14
25570,1,0,9,0,-9
25571,1,0,21,0,-21
25572,0,0,77,0,-77
25573,1,1,620,1759,1139
25574,1,0,67,0,-67
25575,1,1,1400,1853,453
25576,1,1,346,1380,1034
25577,1,0,48,0,-48
25578,1,1,244,1285,1041
25579,1,1,326,1421,1095
25580,1,1,210,1277,1067
25581,0,0,32,0,-32
25582,0,0,71,0,-71
25583,0,0,56,0,-56
25584,1,1,1514,2845,1331
25585,1,1,50,1303,1253
25586,1,0,10,0,-10
25587,0,0,0,0,0
25588,1,0,3,0,-3
25589,0,0,61,0,-61
25590,1,0,153,0,-153
25591,1,1,939,2488,1549
25592,0,0,21,0,-21
25593,1,1,1683,1527,-156
25594,1,1,131,1620,1489
25595,1,1,534,1827,1293
25596,0,0,16,0,-16
25597,0,0,1,0,-1
25598,0,0,140,0,-140
25599,1,0,50,0,-50
25600,1,1,875,1606,731
25601,0,0,26,0,-26
25602,0,0,39,0,-39
25603,1,0,58,0,-58
25604,1,0,25,0,-25
25605,1,0,7,0,-7
25606,1,0,31,0,-31
25607,0,0,54,0,-54
25608,0,0,25,0,-25
25609,1,0,120,0,-120
25610,1,1,341,1490,1149
25611,0,0,23,0,-23
25612,1,1,739,1491,752
25613,1,1,523,1431,908
25614,1,1,1850,3564,1714
25615,1,1,488,3601,3113
25616,1,1,135,1630,1495
25617,0,0,10,0,-10
25618,1,1,109,1715,1606
25619,1,0,1,0,-1
25620,0,0,47,0,-47
25621,1,1,931,1300,369
25622,0,0,75,0,-75
25623,1,1,716,1270,554
25624,0,0,9,0,-9
25625,1,1,142,1252,1110
25626,0,0,2,0,-2
25627,0,0,3,0,-3
25628,0,0,31,0,-31
25629,0,0,1,0,-1
25630,1,0,29,0,-29
25631,0,0,20,0,-20
25632,1,1,1014,1523,509
25633,1,0,58,0,-58
25634,1,1,61,1380,1319
25635,0,0,24,0,-24
25636,0,0,38,0,-38
25637,0,0,53,0,-53
25638,0,0,22,0,-22
25639,1,0,12,0,-12
25640,1,0,9,0,-9
25641,1,1,470,1286,816
25642,0,0,58,0,-58
25643,0,0,28,0,-28
25644,0,0,0,0,0
25645,0,0,61,0,-61
25646,1,0,2,0,-2
25647,1,0,25,0,-25
25648,0,0,112,0,-112
25649,0,0,83,0,-83
25650,0,0,145,0,-145
25651,1,0,40,0,-40
25652,1,1,203,1353,1150
25653,1,0,34,0,-34
25654,0,0,25,0,-25
25655,1,1,433,1382,949
25656,1,1,461,1326,865
25657,0,0,1,0,-1
25658,1,1,590,1346,756
25659,0,0,5,0,-5
25660,1,0,54,0,-54
25661,1,1,191,1332,1141
25662,1,1,453,2925,2472
25663,0,0,40,0,-40
25664,0,0,140,0,-140
25665,0,0,119,0,-119
25666,1,1,756,1712,956
25667,0,0,46,0,-46
25668,1,0,16,0,-16
25669,1,1,285,1326,1041
25670,0,0,23,0,-23
25671,0,0,33,0,-33
25672,0,0,13,0,-13
25673,1,1,1280,2139,859
25674,0,0,14,0,-14
25675,1,1,574,1247,673
25676,1,1,698,1974,1276
25677,0,0,56,0,-56
25678,1,1,199,1401,1202
25679,1,0,47,0,-47
25680,0,0,90,0,-90
25681,1,0,5,0,-5
25682,0,0,81,0,-81
25683,1,1,87,2018,1931
25684,1,1,677,1408,731
25685,0,0,40,0,-40
25686,1,0,6,0,-6
25687,0,0,19,0,-19
25688,0,0,58,0,-58
25689,1,0,3,0,-3
25690,0,0,20,0,-20
25691,0,0,84,0,-84
25692,0,0,15,0,-15
25693,1,1,703,1331,628
25694,1,1,514,1479,965
25695,1,1,506,1251,745
25696,1,1,358,1913,1555
25697,1,1,195,1384,1189
25698,1,1,590,2429,1839
25699,1,0,9,0,-9
25700,1,0,8,0,-8
25701,0,0,69,0,-69
25702,1,1,138,1329,1191
25703,0,0,31,0,-31
25704,0,0,6,0,-6
25705,1,1,363,1604,1241
25706,0,0,33,0,-33
25707,0,0,13,0,-13
25708,0,0,16,0,-16
25709,1,0,62,0,-62
25710,1,1,45,1913,1868
25711,1,1,149,1271,1122
25712,0,0,166,0,-166
25713,1,1,970,1303,333
25714,1,1,1441,1754,313
25715,1,1,39,1512,1473
25716,0,0,40,0,-40
25717,1,1,611,1321,710
25718,1,0,119,0,-119
25719,0,0,25,0,-25
25720,1,0,23,0,-23
25721,1,0,18,0,-18
25722,0,0,0,0,0
25723,0,0,65,0,-65
25724,1,1,1155,1703,548
25725,0,0,28,0,-28
25726,0,0,18,0,-18
25727,0,0,49,0,-49
25728,0,0,7,0,-7
25729,1,1,1024,1371,347
25730,1,1,2751,1423,-1328
25731,0,0,68,0,-68
25732,0,0,18,0,-18
25733,0,0,74,0,-74
25734,1,1,1924,1327,-597
25735,0,0,38,0,-38
25736,0,0,147,0,-147
25737,1,1,142,2057,1915
25738,1,1,311,1270,959
25739,1,0,2,0,-2
25740,0,0,88,0,-88
25741,1,1,631,1274,643
25742,1,1,1815,1290,-525
25743,1,0,40,0,-40
25744,1,0,80,0,-80
25745,0,0,18,0,-18
25746,0,0,204,0,-204
25747,0,0,92,0,-92
25748,0,0,41,0,-41
25749,0,0,103,0,-103
25750,1,1,1381,1314,-67
25751,1,1,83,2490,2407
25752,1,0,17,0,-17
25753,1,0,51,0,-51
25754,0,0,65,0,-65
25755,1,0,138,0,-138
25756,0,0,23,0,-23
25757,0,0,2,0,-2
25758,0,0,5,0,-5
25759,0,0,62,0,-62
25760,0,0,8,0,-8
25761,0,0,31,0,-31
25762,1,0,23,0,-23
25763,0,0,48,0,-48
25764,1,0,62,0,-62
25765,1,0,16,0,-16
25766,1,1,705,1369,664
25767,0,0,46,0,-46
25768,0,0,18,0,-18
25769,1,0,2,0,-2
25770,1,0,147,0,-147
25771,1,1,991,1287,296
25772,1,0,0,0,0
25773,0,0,49,0,-49
25774,1,1,2217,1492,-725
25775,1,1,217,1664,1447
25776,1,0,7,0,-7
25777,1,1,1347,1419,72
25778,0,0,28,0,-28
25779,0,0,38,0,-38
25780,0,0,81,0,-81
25781,1,0,29,0,-29
25782,1,1,355,1579,1224
25783,0,0,134,0,-134
25784,0,0,181,0,-181
25785,0,0,117,0,-117
25786,1,0,28,0,-28
25787,1,0,29,0,-29
25788,1,1,683,1276,593
25789,0,0,69,0,-69
25790,1,0,4,0,-4
25791,0,0,12,0,-12
25792,1,0,52,0,-52
25793,1,1,1093,1726,633
25794,1,0,23,0,-23
25795,1,0,28,0,-28
25796,1,1,87,1397,1310
25797,1,1,164,1261,1097
25798,1,0,124,0,-124
25799,1,0,65,0,-65
25800,1,1,177,1412,1235
25801,1,0,65,0,-65
25802,1,0,150,0,-150
25803,1,0,18,0,-18
25804,1,0,9,0,-9
25805,1,0,128,0,-128
25806,1,1,116,1505,1389
25807,1,1,2110,1287,-823
25808,1,0,22,0,-22
25809,0,0,13,0,-13
25810,0,0,14,0,-14
25811,0,0,156,0,-156
25812,1,0,10,0,-10
25813,0,0,126,0,-126
25814,1,0,1,0,-1
25815,1,0,29,0,-29
25816,0,0,75,0,-75
25817,0,0,28,0,-28
25818,1,1,990,1441,451
25819,1,0,64,0,-64
25820,0,0,61,0,-61
25821,1,0,213,0,-213
25822,0,0,28,0,-28
25823,1,1,273,1521,1248
25824,1,0,36,0,-36
25825,0,0,180,0,-180
25826,1,0,8,0,-8
25827,1,1,131,1254,1123
25828,1,0,47,0,-47
25829,1,0,55,0,-55
25830,0,0,142,0,-142
25831,1,0,104,0,-104
25832,1,0,48,0,-48
25833,1,0,111,0,-111
25834,0,0,35,0,-35
25835,1,0,6,0,-6
25836,1,1,791,1485,694
25837,0,0,14,0,-14
25838,0,0,11,0,-11
25839,1,0,25,0,-25
25840,1,1,34,3493,3459
25841,1,0,63,0,-63
25842,0,0,8,0,-8
25843,1,0,6,0,-6
25844,0,0,15,0,-15
25845,1,1,59,1420,1361
25846,1,0,27,0,-27
25847,0,0,43,0,-43
25848,0,0,97,0,-97
25849,1,0,9,0,-9
25850,0,0,15,0,-15
25851,0,0,184,0,-184
25852,0,0,34,0,-34
25853,1,0,105,0,-105
25854,1,1,2016,1386,-630
25855,0,0,81,0,-81
25856,1,0,1,0,-1
25857,1,0,65,0,-65
25858,1,1,866,1760,894
25859,0,0,89,0,-89
25860,0,0,5,0,-5
25861,1,1,1401,1390,-11
25862,1,1,68,1605,1537
25863,1,1,214,1316,1102
25864,0,0,5,0,-5
25865,0,0,8,0,-8
25866,1,0,64,0,-64
25867,1,0,13,0,-13
25868,1,0,23,0,-23
25869,1,0,43,0,-43
25870,0,0,8,0,-8
25871,0,0,28,0,-28
25872,1,0,7,0,-7
25873,1,1,375,1823,1448
25874,0,0,35,0,-35
25875,1,1,413,1458,1045
25876,1,1,138,1604,1466
25877,0,0,51,0,-51
25878,1,0,6,0,-6
25879,1,0,45,0,-45
25880,1,1,829,1296,467
25881,1,0,24,0,-24
25882,0,0,5,0,-5
25883,1,0,79,0,-79
25884,1,1,551,2594,2043
25885,0,0,3,0,-3
25886,0,0,10,0,-10
25887,1,0,12,0,-12
25888,0,0,72,0,-72
25889,0,0,45,0,-45
25890,0,0,11,0,-11
25891,1,1,1093,1334,241
25892,1,0,15,0,-15
25893,1,1,29,2726,2697
25894,1,1,1355,1251,-104
25895,0,0,9,0,-9
25896,1,1,116,1401,1285
25897,0,0,177,0,-177
25898,0,0,60,0,-60
25899,0,0,53,0,-53
25900,0,0,25,0,-25
25901,1,0,163,0,-163
25902,1,0,126,0,-126
25903,1,0,3,0,-3
25904,0,0,1,0,-1
25905,0,0,174,0,-174
25906,1,0,63,0,-63
25907,0,0,15,0,-15
25908,0,0,44,0,-44
25909,0,0,29,0,-29
25910,1,0,41,0,-41
25911,1,0,16,0,-16
25912,0,0,51,0,-51
25913,1,1,505,1563,1058
25914,1,0,47,0,-47
25915,1,0,0,0,0
25916,1,0,54,0,-54
25917,0,0,42,0,-42
25918,1,1,522,1339,817
25919,0,0,5,0,-5
25920,0,0,46,0,-46
25921,1,1,169,1263,1094
25922,0,0,74,0,-74
25923,1,0,43,0,-43
25924,1,1,21,1257,1236
25925,0,0,140,0,-140
25926,0,0,58,0,-58
25927,0,0,34,0,-34
25928,1,0,12,0,-12
25929,1,0,39,0,-39
25930,1,0,179,0,-179
25931,1,1,892,1597,705
25932,0,0,37,0,-37
25933,1,0,102,0,-102
25934,0,0,62,0,-62
25935,1,1,494,1342,848
25936,1,1,157,1433,1276
25937,0,0,46,0,-46
25938,1,0,15,0,-15
25939,1,1,451,2614,2163
25940,1,0,39,0,-39
25941,1,0,33,0,-33
25942,1,1,1017,1726,709
25943,1,1,278,1360,1082
25944,0,0,100,0,-100
25945,0,0,92,0,-92
25946,0,0,5,0,-5
25947,1,0,61,0,-61
25948,0,0,8,0,-8
25949,0,0,16,0,-16
25950,1,0,40,0,-40
25951,1,1,60,1466,1406
25952,1,1,1251,1259,8
25953,1,1,2734,1279,-1455
25954,1,0,43,0,-43
25955,1,0,94,0,-94
25956,1,1,77,1295,1218
25957,0,0,34,0,-34
25958,1,0,49,0,-49
25959,0,0,0,0,0
25960,1,0,4,0,-4
25961,0,0,0,0,0
25962,1,1,1123,1240,117
25963,0,0,25,0,-25
25964,1,1,1614,1250,-364
25965,1,0,34,0,-34
25966,1,0,58,0,-58
25967,1,0,43,0,-43
25968,0,0,56,0,-56
25969,1,1,2237,1327,-910
25970,0,0,7,0,-7
25971,1,0,278,0,-278
25972,1,0,26,0,-26
25973,1,1,47,1750,1703
25974,0,0,49,0,-49
25975,1,1,112,1305,1193
25976,0,0,121,0,-121
25977,0,0,38,0,-38
25978,1,0,21,0,-21
25979,1,1,200,1444,1244
25980,0,0,19,0,-19
25981,0,0,19,0,-19
25982,1,1,697,1668,971
25983,0,0,37,0,-37
25984,1,1,266,1382,1116
25985,1,0,32,0,-32
25986,1,0,13,0,-13
25987,1,0,70,0,-70
25988,0,0,31,0,-31
25989,0,0,0,0,0
25990,0,0,11,0,-11
25991,1,1,1108,1325,217
25992,1,1,602,1469,867
25993,1,1,800,1505,705
25994,0,0,52,0,-52
25995,0,0,9,0,-9
25996,1,1,456,1338,882
25997,1,1,966,1280,314
25998,0,0,73,0,-73
25999,1,0,93,0,-93
26000,1,1,75,1255,1180
26001,1,0,129,0,-129
26002,1,1,857,1265,408
26003,1,0,59,0,-59
26004,0,0,1,0,-1
26005,0,0,53,0,-53
26006,0,0,93,0,-93
26007,0,0,18,0,-18
26008,0,0,8,0,-8
26009,0,0,51,0,-51
26010,0,0,20,0,-20
26011,1,1,674,1777,1103
26012,1,0,118,0,-118
26013,1,1,104,1446,1342
26014,1,1,430,1581,1151
26015,0,0,42,0,-42
26016,1,0,15,0,-15
26017,1,0,88,0,-88
26018,1,1,122,1986,1864
26019,0,0,1,0,-1
26020,1,1,72,1991,1919
26021,1,0,69,0,-69
26022,1,0,98,0,-98
26023,1,0,44,0,-44
26024,0,0,30,0,-30
26025,1,1,709,1403,694
26026,0,0,5,0,-5
26027,1,1,232,1284,1052
26028,1,1,403,1299,896
26029,1,0,134,0,-134
26030,1,1,153,1336,1183
26031,0,0,3,0,-3
26032,1,1,239,1262,1023
26033,1,1,603,1636,1033
26034,1,0,41,0,-41
26035,1,0,54,0,-54
26036,1,1,683,1705,1022
26037,1,1,21,1241,1220
26038,0,0,315,0,-315
26039,1,1,129,1268,1139
26040,1,0,163,0,-163
26041,1,0,6,0,-6
26042,0,0,72,0,-72
26043,1,0,39,0,-39
26044,1,1,37,1581,1544
26045,1,0,4,0,-4
26046,0,0,46,0,-46
26047,0,0,15,0,-15
26048,1,1,1773,1698,-75
26049,1,0,24,0,-24
26050,0,0,44,0,-44
26051,1,0,71,0,-71
26052,0,0,40,0,-40
26053,0,0,123,0,-123
26054,0,0,128,0,-128
26055,0,0,114,0,-114
26056,1,0,30,0,-30
26057,0,0,53,0,-53
26058,0,0,67,0,-67
26059,0,0,15,0,-15
26060,1,1,304,1619,1315
26061,0,0,105,0,-105
26062,1,1,241,3401,3160
26063,1,0,22,0,-22
26064,1,1,429,1699,1270
26065,0,0,143,0,-143
26066,0,0,16,0,-16
26067,1,0,61,0,-61
26068,1,1,282,1242,960
26069,1,1,117,4971,4854
26070,0,0,37,0,-37
26071,1,0,88,0,-88
26072,0,0,55,0,-55
26073,1,0,139,0,-139
26074,0,0,69,0,-69
26075,1,0,35,0,-35
26076,0,0,50,0,-50
26077,0,0,49,0,-49
26078,1,0,26,0,-26
26079,0,0,11,0,-11
26080,1,0,77,0,-77
26081,1,1,1273,1269,-4
26082,0,0,22,0,-22
26083,1,1,782,1680,898
26084,1,1,897,1695,798
26085,1,0,35,0,-35
26086,0,0,15,0,-15
26087,1,0,96,0,-96
26088,0,0,3,0,-3
26089,0,0,3,0,-3
26090,1,1,2410,1392,-1018
26091,0,0,111,0,-111
26092,0,0,4,0,-4
26093,0,0,118,0,-118
26094,1,0,48,0,-48
26095,1,1,462,1276,814
26096,0,0,4,0,-4
26097,0,0,33,0,-33
26098,0,0,118,0,-118
26099,0,0,25,0,-25
26100,1,0,8,0,-8
26101,1,1,396,1272,876
26102,1,1,457,2270,1813
26103,1,0,8,0,-8
26104,1,1,189,1420,1231
26105,1,0,100,0,-100
26106,1,0,140,0,-140
26107,1,0,21,0,-21
26108,1,1,408,1633,1225
26109,0,0,6,0,-6
26110,0,0,36,0,-36
26111,0,0,15,0,-15
26112,1,1,236,1272,1036
26113,1,0,4,0,-4
26114,0,0,37,0,-37
26115,0,0,2,0,-2
26116,1,1,1704,1358,-346
26117,1,0,19,0,-19
26118,1,1,1392,1524,132
26119,0,0,28,0,-28
26120,1,1,436,1534,1098
26121,1,1,232,1274,1042
26122,1,0,48,0,-48
26123,0,0,14,0,-14
26124,0,0,10,0,-10
26125,1,1,244,1362,1118
26126,1,1,560,1239,679
26127,0,0,29,0,-29
26128,1,0,31,0,-31
26129,1,1,193,1541,1348
26130,0,0,2,0,-2
26131,1,0,221,0,-221
26132,1,1,1086,1682,596
26133,1,1,287,1335,1048
26134,1,0,39,0,-39
26135,0,0,34,0,-34
26136,1,1,982,1357,375
26137,1,1,157,1276,1119
26138,0,0,146,0,-146
26139,0,0,46,0,-46
26140,1,1,328,2330,2002
26141,0,0,14,0,-14
26142,1,0,7,0,-7
26143,0,0,32,0,-32
26144,1,0,57,0,-57
26145,1,0,214,0,-214
26146,0,0,70,0,-70
26147,0,0,194,0,-194
26148,1,1,380,1314,934
26149,1,1,388,1559,1171
26150,1,0,6,0,-6
26151,1,0,130,0,-130
26152,0,0,34,0,-34
26153,1,1,661,1447,786
26154,0,0,0,0,0
26155,1,1,619,1428,809
26156,1,0,28,0,-28
26157,0,0,87,0,-87
26158,1,0,24,0,-24
26159,1,1,219,2516,2297
26160,0,0,10,0,-10
26161,1,0,94,0,-94
26162,0,0,13,0,-13
26163,1,0,42,0,-42
26164,0,0,80,0,-80
26165,1,0,207,0,-207
26166,1,0,14,0,-14
26167,1,1,163,1970,1807
26168,0,0,51,0,-51
26169,1,0,36,0,-36
26170,1,1,301,1667,1366
26171,1,0,18,0,-18
26172,0,0,27,0,-27
26173,0,0,5,0,-5
26174,0,0,36,0,-36
26175,0,0,47,0,-47
26176,0,0,4,0,-4
26177,1,0,24,0,-24
26178,1,0,12,0,-12
26179,0,0,107,0,-107
26180,0,0,17,0,-17
26181,1,1,210,1480,1270
26182,1,0,62,0,-62
26183,1,1,1615,1437,-178
26184,1,0,48,0,-48
26185,0,0,11,0,-11
26186,0,0,49,0,-49
26187,1,1,96,1384,1288
26188,1,1,2678,1493,-1185
26189,0,0,14,0,-14
26190,0,0,90,0,-90
26191,0,0,103,0,-103
26192,1,1,262,1421,1159
26193,0,0,34,0,-34
26194,0,0,148,0,-148
26195,1,1,589,3693,3104
26196,1,0,4,0,-4
26197,1,1,581,1324,743
26198,0,0,9,0,-9
26199,0,0,48,0,-48
26200,0,0,60,0,-60
26201,0,0,15,0,-15
26202,1,1,1190,1466,276
26203,0,0,119,0,-119
26204,0,0,5,0,-5
26205,1,0,11,0,-11
26206,0,0,48,0,-48
26207,1,1,239,1282,1043
26208,0,0,67,0,-67
26209,0,0,16,0,-16
26210,0,0,90,0,-90
26211,1,0,5,0,-5
26212,1,0,122,0,-122
26213,1,0,43,0,-43
26214,0,0,18,0,-18
26215,0,0,9,0,-9
26216,1,0,16,0,-16
26217,1,0,22,0,-22
26218,0,0,130,0,-130
26219,1,0,6,0,-6
26220,1,0,32,0,-32
26221,0,0,62,0,-62
26222,0,0,78,0,-78
26223,1,0,62,0,-62
26224,1,0,2,0,-2
26225,1,0,27,0,-27
26226,1,1,246,1616,1370
26227,0,0,16,0,-16
26228,1,1,109,1300,1191
26229,1,0,120,0,-120
26230,1,0,5,0,-5
26231,1,1,1403,1441,38
26232,0,0,212,0,-212
26233,0,0,73,0,-73
26234,1,1,352,1264,912
26235,0,0,83,0,-83
26236,1,0,5,0,-5
26237,0,0,43,0,-43
26238,1,0,195,0,-195
26239,0,0,6,0,-6
26240,0,0,22,0,-22
26241,1,1,163,1275,1112
26242,1,0,42,0,-42
26243,0,0,8,0,-8
26244,0,0,2,0,-2
26245,0,0,39,0,-39
26246,0,0,11,0,-11
26247,1,0,0,0,0
26248,0,0,22,0,-22
26249,1,0,40,0,-40
26250,0,0,115,0,-115
26251,1,1,381,1740,1359
26252,0,0,38,0,-38
26253,1,0,38,0,-38
26254,1,0,103,0,-103
26255,1,1,249,1462,1213
26256,0,0,10,0,-10
26257,1,1,123,1578,1455
26258,0,0,2,0,-2
26259,1,0,21,0,-21
26260,0,0,42,0,-42
26261,1,1,963,3696,2733
26262,1,0,87,0,-87
26263,1,1,634,2063,1429
26264,1,0,22,0,-22
26265,1,1,1662,1463,-199
26266,1,0,20,0,-20
26267,1,1,307,1970,1663
26268,1,0,34,0,-34
26269,1,1,336,1694,1358
26270,1,1,168,1314,1146
26271,1,1,22,1793,1771
26272,1,0,23,0,-23
26273,0,0,35,0,-35
26274,0,0,13,0,-13
26275,0,0,44,0,-44
26276,1,0,12,0,-12
26277,1,0,29,0,-29
26278,0,0,79,0,-79
26279,1,1,190,2914,2724
26280,0,0,3,0,-3
26281,0,0,16,0,-16
26282,0,0,137,0,-137
26283,1,1,1174,1978,804
26284,0,0,5,0,-5
26285,1,1,572,1414,842
26286,0,0,64,0,-64
26287,1,0,152,0,-152
26288,1,1,77,1742,1665
26289,0,0,22,0,-22
26290,1,0,12,0,-12
26291,0,0,72,0,-72
26292,0,0,49,0,-49
26293,0,0,18,0,-18
26294,1,1,932,1340,408
26295,1,0,143,0,-143
26296,0,0,208,0,-208
26297,1,1,558,1594,1036
26298,1,1,487,1292,805
26299,1,0,26,0,-26
26300,1,1,225,1754,1529
26301,1,1,256,1511,1255
26302,1,0,20,0,-20
26303,1,1,359,1393,1034
26304,0,0,66,0,-66
26305,1,0,16,0,-16
26306,1,0,17,0,-17
26307,1,0,13,0,-13
26308,1,0,9,0,-9
26309,0,0,144,0,-144
26310,0,0,44,0,-44
26311,1,1,207,1243,1036
26312,1,1,996,1811,815
26313,0,0,122,0,-122
26314,1,1,158,1617,1459
26315,0,0,51,0,-51
26316,0,0,21,0,-21
26317,0,0,80,0,-80
26318,1,0,24,0,-24
26319,1,1,1578,1257,-321
26320,1,0,142,0,-142
26321,1,0,10,0,-10
26322,1,1,1085,1281,196
26323,1,1,736,1337,601
26324,1,0,37,0,-37
26325,1,1,3024,1302,-1722
26326,0,0,52,0,-52
26327,1,1,425,1647,1222
26328,1,1,770,1464,694
26329,0,0,4,0,-4
26330,1,1,300,1237,937
26331,0,0,62,0,-62
26332,1,0,103,0,-103
26333,1,1,513,1333,820
26334,0,0,36,0,-36
26335,0,0,16,0,-16
26336,1,0,30,0,-30
26337,0,0,29,0,-29
26338,0,0,144,0,-144
26339,0,0,42,0,-42
26340,0,0,41,0,-41
26341,0,0,3,0,-3
26342,1,1,676,1356,680
26343,0,0,11,0,-11
26344,0,0,102,0,-102
26345,1,0,74,0,-74
26346,0,0,27,0,-27
26347,1,1,1015,1511,496
26348,0,0,182,0,-182
26349,1,1,233,1467,1234
26350,0,0,12,0,-12
26351,0,0,61,0,-61
26352,0,0,51,0,-51
26353,1,1,584,1926,1342
26354,0,0,6,0,-6
26355,0,0,201,0,-201
26356,1,0,10,0,-10
26357,1,1,644,1235,591
26358,1,1,258,1257,999
26359,1,1,471,2738,2267
26360,0,0,25,0,-25
26361,1,1,655,1329,674
26362,0,0,19,0,-19
26363,1,0,1,0,-1
26364,1,1,354,1438,1084
26365,1,1,997,3809,2812
26366,1,1,552,4017,3465
26367,1,0,206,0,-206
26368,1,1,146,1428,1282
26369,1,0,157,0,-157
26370,1,0,79,0,-79
26371,0,0,64,0,-64
26372,1,0,21,0,-21
26373,0,0,39,0,-39
26374,1,0,84,0,-84
26375,1,1,3272,1527,-1745
26376,1,0,87,0,-87
26377,0,0,46,0,-46
26378,1,0,119,0,-119
26379,1,0,30,0,-30
26380,0,0,161,0,-161
26381,0,0,49,0,-49
26382,1,1,271,1639,1368
26383,1,1,401,1399,998
26384,1,1,276,1633,1357
26385,1,1,271,1334,1063
26386,0,0,4,0,-4
26387,1,0,83,0,-83
26388,1,1,519,1643,1124
26389,1,0,48,0,-48
26390,1,0,0,0,0
26391,1,1,403,1841,1438
26392,1,0,9,0,-9
26393,1,1,243,1681,1438
26394,0,0,34,0,-34
26395,1,0,48,0,-48
26396,0,0,2,0,-2
26397,1,0,20,0,-20
26398,0,0,135,0,-135
26399,1,1,451,1259,808
26400,1,0,9,0,-9
26401,1,1,958,3204,2246
26402,0,0,1,0,-1
26403,1,1,280,1427,1147
26404,1,1,129,1429,1300
26405,0,0,51,0,-51
26406,0,0,99,0,-99
26407,1,0,74,0,-74
26408,0,0,169,0,-169
26409,1,1,455,1349,894
26410,0,0,150,0,-150
26411,1,0,87,0,-87
26412,0,0,24,0,-24
26413,0,0,9,0,-9
26414,0,0,6,0,-6
26415,0,0,2,0,-2
26416,1,0,8,0,-8
26417,0,0,6,0,-6
26418,1,1,636,1340,704
26419,1,1,325,1269,944
26420,1,1,612,1354,742
26421,0,0,43,0,-43
26422,0,0,0,0,0
26423,0,0,21,0,-21
26424,1,0,39,0,-39
26425,1,0,31,0,-31
26426,0,0,42,0,-42
26427,1,0,25,0,-25
26428,1,1,339,6335,5996
26429,0,0,74,0,-74
26430,0,0,81,0,-81
26431,0,0,32,0,-32
26432,0,0,11,0,-11
26433,1,0,38,0,-38
26434,0,0,3,0,-3
26435,1,1,382,2458,2076
26436,1,1,218,1380,1162
26437,1,0,26,0,-26
26438,0,0,1,0,-1
26439,1,1,98,1604,1506
26440,1,1,275,1630,1355
26441,1,0,9,0,-9
26442,0,0,8,0,-8
26443,1,0,27,0,-27
26444,0,0,45,0,-45
26445,0,0,34,0,-34
26446,1,1,347,1264,917
26447,0,0,8,0,-8
26448,0,0,22,0,-22
26449,1,0,31,0,-31
26450,0,0,79,0,-79
26451,1,1,161,1355,1194
26452,0,0,26,0,-26
26453,0,0,34,0,-34
26454,1,0,45,0,-45
26455,1,1,248,1279,1031
26456,1,1,1755,1460,-295
26457,1,1,1538,1683,145
26458,0,0,151,0,-151
26459,1,0,59,0,-59
26460,0,0,34,0,-34
26461,1,1,1234,2424,1190
26462,1,0,30,0,-30
26463,1,0,7,0,-7
26464,1,1,286,1235,949
26465,0,0,63,0,-63
26466,1,1,417,1494,1077
26467,1,0,84,0,-84
26468,0,0,46,0,-46
26469,1,1,107,1398,1291
26470,0,0,81,0,-81
26471,1,1,236,1672,1436
26472,1,0,28,0,-28
26473,0,0,14,0,-14
26474,0,0,5,0,-5
26475,1,0,45,0,-45
26476,1,0,34,0,-34
26477,0,0,37,0,-37
26478,0,0,5,0,-5
26479,1,0,1,0,-1
26480,1,1,102,1238,1136
26481,0,0,200,0,-200
26482,0,0,9,0,-9
26483,1,1,52,3422,3370
26484,1,0,3,0,-3
26485,1,1,281,1443,1162
26486,1,0,61,0,-61
26487,0,0,1,0,-1
26488,1,1,93,1586,1493
26489,0,0,56,0,-56
26490,1,0,8,0,-8
26491,1,0,12,0,-12
26492,1,0,67,0,-67
26493,1,0,2,0,-2
26494,1,0,60,0,-60
26495,1,1,510,1432,922
26496,0,0,86,0,-86
26497,1,1,284,1323,1039
26498,0,0,15,0,-15
26499,1,0,14,0,-14
26500,0,0,27,0,-27
26501,1,0,6,0,-6
26502,1,1,71,1310,1239
26503,0,0,53,0,-53
26504,1,1,80,1511,1431
26505,1,0,21,0,-21
26506,1,0,7,0,-7
26507,0,0,112,0,-112
26508,1,0,41,0,-41
26509,0,0,0,0,0
26510,1,0,46,0,-46
26511,1,1,3628,1641,-1987
26512,0,0,38,0,-38
26513,0,0,16,0,-16
26514,1,0,155,0,-155
26515,1,1,193,1608,1415
26516,1,1,546,1447,901
26517,1,1,102,1863,1761
26518,1,0,50,0,-50
26519,1,1,2266,1327,-939
26520,1,0,16,0,-16
26521,1,0,54,0,-54
26522,0,0,178,0,-178
26523,1,0,5,0,-5
26524,0,0,26,0,-26
26525,0,0,6,0,-6
26526,0,0,5,0,-5
26527,0,0,1,0,-1
26528,0,0,79,0,-79
26529,1,0,2,0,-2
26530,1,0,23,0,-23
26531,0,0,95,0,-95
26532,1,1,986,2778,1792
26533,1,1,22,1276,1254
26534,1,0,57,0,-57
26535,1,1,192,1811,1619
26536,1,1,414,1280,866
26537,1,1,811,1391,580
26538,0,0,11,0,-11
26539,0,0,27,0,-27
26540,1,0,10,0,-10
26541,1,1,547,1899,1352
26542,0,0,36,0,-36
26543,1,1,357,1443,1086
26544,1,1,643,1236,593
26545,1,1,415,1466,1051
26546,1,0,19,0,-19
26547,1,1,247,1885,1638
26548,1,0,11,0,-11
26549,1,0,11,0,-11
26550,0,0,34,0,-34
26551,1,0,55,0,-55
26552,1,0,120,0,-120
26553,0,0,29,0,-29
26554,0,0,5,0,-5
26555,1,0,49,0,-49
26556,0,0,104,0,-104
26557,0,0,33,0,-33
26558,0,0,7,0,-7
26559,1,1,1009,1332,323
26560,0,0,39,0,-39
26561,1,1,829,1685,856
26562,0,0,5,0,-5
26563,1,1,835,1392,557
26564,0,0,62,0,-62
26565,0,0,62,0,-62
26566,0,0,42,0,-42
26567,1,0,47,0,-47
26568,1,0,52,0,-52
26569,0,0,54,0,-54
26570,1,1,155,1388,1233
26571,1,0,74,0,-74
26572,0,0,106,0,-106
26573,1,0,1,0,-1
26574,1,0,97,0,-97
26575,1,0,24,0,-24
26576,1,1,2216,1404,-812
26577,1,0,61,0,-61
26578,1,1,203,2031,1828
26579,1,0,6,0,-6
26580,0,0,12,0,-12
26581,0,0,137,0,-137
26582,0,0,90,0,-90
26583,1,0,41,0,-41
26584,1,1,572,1732,1160
26585,1,0,177,0,-177
26586,0,0,53,0,-53
26587,1,0,3,0,-3
26588,0,0,5,0,-5
26589,1,0,33,0,-33
26590,1,0,23,0,-23
26591,1,1,125,1241,1116
26592,1,1,350,1459,1109
26593,1,0,3,0,-3
26594,1,1,553,1967,1414
26595,0,0,34,0,-34
26596,1,0,105,0,-105
26597,1,1,211,1289,1078
26598,0,0,120,0,-120
26599,0,0,13,0,-13
26600,0,0,0,0,0
26601,0,0,50,0,-50
26602,1,1,662,1338,676
26603,1,0,96,0,-96
26604,0,0,5,0,-5
26605,1,1,1924,1538,-386
26606,1,0,54,0,-54
26607,1,1,369,1267,898
26608,1,0,29,0,-29
26609,0,0,29,0,-29
26610,0,0,47,0,-47
26611,0,0,64,0,-64
26612,1,1,82,1258,1176
26613,1,1,909,1437,528
26614,0,0,3,0,-3
26615,1,0,5,0,-5
26616,0,0,66,0,-66
26617,0,0,15,0,-15
26618,0,0,3,0,-3
26619,0,0,28,0,-28
26620,0,0,60,0,-60
26621,1,0,129,0,-129
26622,1,0,31,0,-31
26623,1,1,733,2141,1408
26624,1,1,535,1359,824
26625,1,1,768,1315,547
26626,1,1,265,1376,1111
26627,0,0,26,0,-26
26628,0,0,48,0,-48
26629,1,0,81,0,-81
26630,1,0,9,0,-9
26631,0,0,20,0,-20
26632,1,0,16,0,-16
26633,1,0,22,0,-22
26634,1,1,118,1495,1377
26635,0,0,14,0,-14
26636,1,0,59,0,-59
26637,1,0,1,0,-1
26638,1,0,89,0,-89
26639,0,0,20,0,-20
26640,1,0,34,0,-34
26641,1,1,56,1475,1419
26642,0,0,178,0,-178
26643,1,0,192,0,-192
26644,1,1,1291,1351,60
26645,0,0,36,0,-36
26646,1,0,55,0,-55
26647,0,0,10,0,-10
26648,0,0,35,0,-35
26649,0,0,16,0,-16
26650,1,1,193,1352,1159
26651,0,0,92,0,-92
26652,0,0,92,0,-92
26653,1,0,88,0,-88
26654,0,0,39,0,-39
26655,1,0,5,0,-5
26656,0,0,38,0,-38
26657,1,0,34,0,-34
26658,0,0,20,0,-20
26659,1,1,768,1455,687
26660,1,0,54,0,-54
26661,0,0,9,0,-9
26662,1,1,395,2406,2011
26663,1,1,444,3037,2593
26664,0,0,10,0,-10
26665,1,0,66,0,-66
26666,1,0,25,0,-25
26667,0,0,85,0,-85
26668,0,0,14,0,-14
26669,1,1,1139,1632,493
26670,1,0,3,0,-3
26671,1,0,27,0,-27
26672,0,0,184,0,-184
26673,0,0,5,0,-5
26674,1,1,1010,1373,363
26675,1,0,58,0,-58
26676,1,0,7,0,-7
26677,1,0,9,0,-9
26678,1,1,97,1236,1139
26679,1,0,26,0,-26
26680,1,0,19,0,-19
26681,1,1,1997,1419,-578
26682,0,0,34,0,-34
26683,1,0,148,0,-148
26684,1,1,278,1678,1400
26685,1,1,965,1885,920
26686,1,0,5,0,-5
26687,1,0,138,0,-138
26688,1,1,350,1406,1056
26689,1,0,41,0,-41
26690,0,0,36,0,-36
26691,0,0,91,0,-91
26692,1,0,102,0,-102
26693,1,1,60,1280,1220
26694,1,1,536,1244,708
26695,1,0,4,0,-4
26696,0,0,44,0,-44
26697,1,0,0,0,0
26698,1,1,1293,1250,-43
26699,0,0,60,0,-60
26700,1,1,304,1516,1212
26701,0,0,24,0,-24
26702,0,0,16,0,-16
26703,0,0,50,0,-50
26704,0,0,235,0,-235
26705,0,0,113,0,-113
26706,0,0,17,0,-17
26707,0,0,6,0,-6
26708,1,1,2502,1607,-895
26709,1,1,464,1751,1287
26710,0,0,63,0,-63
26711,1,1,274,1579,1305
26712,0,0,27,0,-27
26713,1,0,94,0,-94
26714,1,1,702,1543,841
26715,0,0,4,0,-4
26716,1,1,77,1387,1310
26717,1,0,3,0,-3
26718,1,1,199,1287,1088
26719,1,0,5,0,-5
26720,0,0,32,0,-32
26721,0,0,72,0,-72
26722,0,0,75,0,-75
26723,0,0,16,0,-16
26724,0,0,57,0,-57
26725,1,1,444,1260,816
26726,0,0,45,0,-45
26727,1,0,40,0,-40
26728,0,0,78,0,-78
26729,1,0,148,0,-148
26730,0,0,251,0,-251
26731,0,0,35,0,-35
26732,1,1,317,1365,1048
26733,0,0,79,0,-79
26734,1,1,305,2432,2127
26735,1,0,89,0,-89
26736,0,0,212,0,-212
26737,0,0,85,0,-85
26738,1,1,506,1261,755
26739,1,1,1083,1292,209
26740,0,0,100,0,-100
26741,0,0,31,0,-31
26742,0,0,0,0,0
26743,1,0,20,0,-20
26744,0,0,8,0,-8
26745,0,0,140,0,-140
26746,0,0,52,0,-52
26747,0,0,3,0,-3
26748,0,0,88,0,-88
26749,1,1,103,1764,1661
26750,0,0,86,0,-86
26751,1,1,198,1252,1054
26752,1,0,49,0,-49
26753,1,1,2157,2484,327
26754,1,0,63,0,-63
26755,1,1,1061,2557,1496
26756,0,0,51,0,-51
26757,1,0,37,0,-37
26758,0,0,9,0,-9
26759,0,0,128,0,-128
26760,1,0,84,0,-84
26761,0,0,25,0,-25
26762,0,0,49,0,-49
26763,1,1,559,1487,928
26764,0,0,8,0,-8
26765,0,0,3,0,-3
26766,0,0,89,0,-89
26767,1,0,54,0,-54
26768,0,0,18,0,-18
26769,1,1,314,5399,5085
26770,1,0,4,0,-4
26771,0,0,10,0,-10
26772,1,1,933,1241,308
26773,0,0,54,0,-54
26774,0,0,0,0,0
26775,1,1,288,1292,1004
26776,0,0,40,0,-40
26777,0,0,36,0,-36
26778,1,1,528,1468,940
26779,0,0,12,0,-12
26780,1,1,227,1647,1420
26781,1,1,288,1399,1111
26782,1,0,13,0,-13
26783,1,1,527,1235,708
26784,0,0,48,0,-48
26785,0,0,2,0,-2
26786,0,0,37,0,-37
26787,0,0,85,0,-85
26788,1,1,627,1723,1096
26789,0,0,5,0,-5
26790,0,0,38,0,-38
26791,1,0,41,0,-41
26792,0,0,0,0,0
26793,1,1,192,1335,1143
26794,1,0,22,0,-22
26795,0,0,29,0,-29
26796,1,0,22,0,-22
26797,0,0,32,0,-32
26798,1,0,20,0,-20
26799,1,1,342,3135,2793
26800,1,0,51,0,-51
26801,1,1,455,1270,815
26802,1,0,60,0,-60
26803,1,0,15,0,-15
26804,1,1,1671,2046,375
26805,1,0,4,0,-4
26806,0,0,41,0,-41
26807,0,0,91,0,-91
26808,1,0,148,0,-148
26809,0,0,28,0,-28
26810,0,0,49,0,-49
26811,0,0,69,0,-69
26812,0,0,24,0,-24
26813,1,0,211,0,-211
26814,1,1,86,1524,1438
26815,1,1,577,1509,932
26816,0,0,215,0,-215
26817,0,0,16,0,-16
26818,1,1,556,1346,790
26819,1,1,403,1763,1360
26820,1,0,23,0,-23
26821,1,0,98,0,-98
26822,0,0,36,0,-36
26823,0,0,53,0,-53
26824,1,1,141,1262,1121
26825,1,0,23,0,-23
26826,0,0,81,0,-81
26827,0,0,4,0,-4
26828,0,0,11,0,-11
26829,1,1,221,1541,1320
26830,0,0,26,0,-26
26831,0,0,76,0,-76
26832,0,0,28,0,-28
26833,0,0,11,0,-11
26834,1,0,10,0,-10
26835,1,0,54,0,-54
26836,1,0,57,0,-57
26837,1,1,441,1325,884
26838,0,0,10,0,-10
26839,1,0,11,0,-11
26840,1,1,624,1498,874
26841,0,0,26,0,-26
26842,0,0,20,0,-20
26843,1,1,731,1606,875
26844,0,0,64,0,-64
26845,0,0,0,0,0
26846,1,1,355,1947,1592
26847,1,0,17,0,-17
26848,0,0,6,0,-6
26849,1,1,584,1235,651
26850,0,0,18,0,-18
26851,1,0,12,0,-12
26852,1,1,827,1839,1012
26853,1,1,405,1528,1123
26854,0,0,16,0,-16
26855,0,0,16,0,-16
26856,1,1,1450,1238,-212
26857,1,1,399,1500,1101
26858,0,0,33,0,-33
26859,0,0,20,0,-20
26860,1,1,1519,1483,-36
26861,0,0,106,0,-106
26862,1,0,11,0,-11
26863,0,0,5,0,-5
26864,1,0,8,0,-8
26865,0,0,99,0,-99
26866,0,0,45,0,-45
26867,0,0,20,0,-20
26868,1,0,31,0,-31
26869,0,0,16,0,-16
26870,0,0,20,0,-20
26871,0,0,5,0,-5
26872,1,0,21,0,-21
26873,1,1,356,1625,1269
26874,1,1,183,1997,1814
26875,1,1,745,1246,501
26876,1,1,965,1318,353
26877,1,0,111,0,-111
26878,0,0,0,0,0
26879,0,0,38,0,-38
26880,0,0,46,0,-46
26881,1,0,21,0,-21
26882,1,0,100,0,-100
26883,1,0,57,0,-57
26884,0,0,9,0,-9
26885,1,0,62,0,-62
26886,0,0,45,0,-45
26887,1,1,237,2075,1838
26888,0,0,9,0,-9
26889,1,1,341,1541,1200
26890,1,0,50,0,-50
26891,0,0,2,0,-2
26892,1,1,627,1579,952
26893,1,1,697,1553,856
26894,1,1,566,1348,782
26895,1,1,290,2043,1753
26896,1,0,40,0,-40
26897,0,0,31,0,-31
26898,1,1,1251,1241,-10
26899,0,0,16,0,-16
26900,0,0,203,0,-203
26901,1,0,166,0,-166
26902,0,0,13,0,-13
26903,1,1,520,1383,863
26904,1,1,150,1492,1342
26905,1,1,158,1324,1166
26906,1,1,172,1458,1286
26907,1,0,14,0,-14
26908,1,0,34,0,-34
26909,1,1,585,1262,677
26910,1,0,13,0,-13
26911,1,0,50,0,-50
26912,0,0,86,0,-86
26913,1,0,67,0,-67
26914,0,0,2,0,-2
26915,1,1,350,1239,889
26916,1,1,92,1403,1311
26917,1,1,554,2725,2171
26918,1,0,38,0,-38
26919,1,0,14,0,-14
26920,0,0,2,0,-2
26921,0,0,15,0,-15
26922,1,0,27,0,-27
26923,1,0,32,0,-32
26924,0,0,119,0,-119
26925,1,1,162,1326,1164
26926,1,0,54,0,-54
26927,0,0,48,0,-48
26928,0,0,52,0,-52
26929,0,0,168,0,-168
26930,1,1,553,1589,1036
26931,0,0,18,0,-18
26932,0,0,96,0,-96
26933,1,1,33,1292,1259
26934,1,1,1348,1359,11
26935,1,0,57,0,-57
26936,1,0,5,0,-5
26937,0,0,18,0,-18
26938,1,1,484,1695,1211
26939,1,0,15,0,-15
26940,1,0,29,0,-29
26941,0,0,59,0,-59
26942,0,0,47,0,-47
26943,0,0,3,0,-3
26944,0,0,6,0,-6
26945,1,1,674,2003,1329
26946,1,0,19,0,-19
26947,1,0,33,0,-33
26948,1,0,31,0,-31
26949,1,1,29,1585,1556
26950,1,1,793,1782,989
26951,1,1,225,2443,2218
26952,1,1,59,1574,1515
26953,1,1,1139,1490,351
26954,1,0,8,0,-8
26955,1,1,154,1567,1413
26956,0,0,28,0,-28
26957,1,1,387,1557,1170
26958,0,0,0,0,0
26959,1,0,10,0,-10
26960,0,0,15,0,-15
26961,1,0,120,0,-120
26962,1,1,1326,1577,251
26963,0,0,6,0,-6
26964,1,0,81,0,-81
26965,0,0,40,0,-40
26966,0,0,38,0,-38
26967,1,1,732,2216,1484
26968,1,1,566,1235,669
26969,0,0,8,0,-8
26970,0,0,37,0,-37
26971,0,0,140,0,-140
26972,1,1,130,1367,1237
26973,1,1,1117,1285,168
26974,1,1,103,1381,1278
26975,0,0,123,0,-123
26976,1,0,26,0,-26
26977,0,0,22,0,-22
26978,1,0,209,0,-209
26979,1,0,73,0,-73
26980,1,0,34,0,-34
26981,0,0,5,0,-5
26982,1,1,729,1539,810
26983,0,0,3,0,-3
26984,0,0,52,0,-52
26985,1,0,3,0,-3
26986,1,0,13,0,-13
26987,1,0,29,0,-29
26988,0,0,10,0,-10
26989,0,0,30,0,-30
26990,0,0,85,0,-85
26991,0,0,41,0,-41
26992,1,0,0,0,0
26993,1,1,348,1410,1062
26994,1,0,3,0,-3
26995,1,0,9,0,-9
26996,1,1,558,1286,728
26997,0,0,44,0,-44
26998,1,1,58,1263,1205
26999,1,0,4,0,-4
27000,1,1,105,1743,1638
27001,0,0,13,0,-13
27002,0,0,88,0,-88
27003,0,0,28,0,-28
27004,0,0,141,0,-141
27005,0,0,8,0,-8
27006,1,1,373,1828,1455
27007,1,0,33,0,-33
27008,0,0,71,0,-71
27009,0,0,84,0,-84
27010,1,1,100,2596,2496
27011,1,0,100,0,-100
27012,1,1,92,1447,1355
27013,0,0,9,0,-9
27014,1,1,1054,4444,3390
27015,1,1,355,1697,1342
27016,0,0,26,0,-26
27017,1,1,1163,1301,138
27018,0,0,20,0,-20
27019,1,1,106,1275,1169
27020,1,0,16,0,-16
27021,1,0,59,0,-59
27022,1,1,622,1461,839
27023,0,0,65,0,-65
27024,1,0,5,0,-5
27025,1,1,612,3541,2929
27026,1,0,55,0,-55
27027,0,0,129,0,-129
27028,0,0,55,0,-55
27029,1,1,230,1266,1036
27030,1,1,1331,2137,806
27031,0,0,29,0,-29
27032,0,0,201,0,-201
27033,1,0,39,0,-39
27034,1,1,254,1345,1091
27035,1,1,86,1319,1233
27036,0,0,7,0,-7
27037,0,0,0,0,0
27038,1,1,415,1258,843
27039,0,0,50,0,-50
27040,0,0,43,0,-43
27041,1,1,502,3020,2518
27042,1,0,77,0,-77
27043,0,0,43,0,-43
27044,0,0,49,0,-49
27045,1,1,562,1269,707
27046,1,0,84,0,-84
27047,1,0,26,0,-26
27048,0,0,25,0,-25
27049,0,0,15,0,-15
27050,0,0,7,0,-7
27051,0,0,69,0,-69
27052,1,1,1417,1240,-177
27053,1,0,14,0,-14
27054,1,0,37,0,-37
27055,0,0,2,0,-2
27056,0,0,67,0,-67
27057,0,0,163,0,-163
27058,1,1,171,1634,1463
27059,0,0,152,0,-152
27060,1,1,656,1393,737
27061,1,0,144,0,-144
27062,0,0,88,0,-88
27063,1,0,74,0,-74
27064,0,0,234,0,-234
27065,1,1,234,1366,1132
27066,1,0,51,0,-51
27067,1,0,42,0,-42
27068,1,1,48,1435,1387
27069,0,0,7,0,-7
27070,1,0,15,0,-15
27071,0,0,20,0,-20
27072,1,0,88,0,-88
27073,0,0,44,0,-44
27074,0,0,80,0,-80
27075,1,0,4,0,-4
27076,1,0,65,0,-65
27077,0,0,13,0,-13
27078,1,1,1814,1787,-27
27079,1,1,83,1310,1227
27080,1,1,261,2998,2737
27081,1,0,50,0,-50
27082,1,0,51,0,-51
27083,1,0,21,0,-21
27084,1,0,53,0,-53
27085,1,1,7,2536,2529
27086,1,1,956,1341,385
27087,0,0,28,0,-28
27088,1,1,599,1327,728
27089,1,1,797,1575,778
27090,1,0,13,0,-13
27091,0,0,46,0,-46
27092,1,0,22,0,-22
27093,0,0,6,0,-6
27094,1,1,60,1506,1446
27095,0,0,33,0,-33
27096,0,0,34,0,-34
27097,0,0,18,0,-18
27098,0,0,17,0,-17
27099,1,1,803,1316,513
27100,0,0,15,0,-15
27101,0,0,54,0,-54
27102,1,1,480,1503,1023
27103,1,1,725,1312,587
27104,1,1,209,1615,1406
27105,1,0,88,0,-88
27106,1,1,335,1275,940
27107,0,0,28,0,-28
27108,0,0,12,0,-12
27109,1,1,185,1716,1531
27110,0,0,91,0,-91
27111,0,0,90,0,-90
27112,0,0,160,0,-160
27113,1,1,462,2850,2388
27114,1,1,1125,1242,117
27115,0,0,153,0,-153
27116,0,0,25,0,-25
27117,1,0,2,0,-2
27118,1,1,341,2357,2016
27119,1,1,84,2019,1935
27120,1,1,870,1487,617
27121,0,0,18,0,-18
27122,1,1,384,1645,1261
27123,1,1,30,1358,1328
27124,1,0,22,0,-22
27125,1,1,241,1405,1164
27126,0,0,24,0,-24
27127,0,0,27,0,-27
27128,0,0,19,0,-19
27129,1,1,119,1340,1221
27130,1,1,412,1941,1529
27131,1,0,18,0,-18
27132,1,1,461,1515,1054
27133,1,0,102,0,-102
27134,0,0,18,0,-18
27135,0,0,43,0,-43
27136,1,1,190,1263,1073
27137,1,1,521,2054,1533
27138,1,1,93,1367,1274
27139,1,0,43,0,-43
27140,1,0,22,0,-22
27141,0,0,125,0,-125
27142,0,0,0,0,0
27143,1,0,40,0,-40
27144,1,0,11,0,-11
27145,1,0,14,0,-14
27146,0,0,43,0,-43
27147,0,0,60,0,-60
27148,1,0,75,0,-75
27149,0,0,27,0,-27
27150,0,0,87,0,-87
27151,1,1,1228,1579,351
27152,1,1,167,1292,1125
27153,0,0,58,0,-58
27154,1,0,48,0,-48
27155,1,0,26,0,-26
27156,0,0,39,0,-39
27157,0,0,47,0,-47
27158,0,0,177,0,-177
27159,1,1,508,2117,1609
27160,1,0,0,0,0
27161,1,0,77,0,-77
27162,0,0,32,0,-32
27163,1,1,147,3294,3147
27164,1,0,11,0,-11
27165,0,0,112,0,-112
27166,1,0,20,0,-20
27167,1,0,4,0,-4
27168,1,0,66,0,-66
27169,0,0,37,0,-37
27170,0,0,143,0,-143
27171,1,0,99,0,-99
27172,1,1,161,2625,2464
27173,1,0,31,0,-31
27174,0,0,63,0,-63
27175,1,0,12,0,-12
27176,1,0,20,0,-20
27177,1,1,180,1417,1237
27178,0,0,58,0,-58
27179,0,0,10,0,-10
27180,1,0,81,0,-81
27181,1,0,15,0,-15
27182,0,0,28,0,-28
27183,0,0,94,0,-94
27184,0,0,26,0,-26
27185,0,0,9,0,-9
27186,0,0,40,0,-40
27187,1,0,71,0,-71
27188,1,0,24,0,-24
27189,0,0,36,0,-36
27190,0,0,9,0,-9
27191,1,0,6,0,-6
27192,1,1,2176,1504,-672
27193,1,0,23,0,-23
27194,1,0,51,0,-51
27195,1,0,50,0,-50
27196,0,0,155,0,-155
27197,1,1,413,1404,991
27198,1,0,34,0,-34
27199,0,0,224,0,-224
27200,1,0,39,0,-39
27201,0,0,50,0,-50
27202,0,0,242,0,-242
27203,0,0,35,0,-35
27204,1,1,721,1235,514
27205,1,1,88,3024,2936
27206,0,0,6,0,-6
27207,1,0,2,0,-2
27208,0,0,15,0,-15
27209,1,1,377,1898,1521
27210,0,0,70,0,-70
27211,1,0,31,0,-31
27212,0,0,75,0,-75
27213,0,0,1,0,-1
27214,1,0,5,0,-5
27215,1,1,702,1283,581
27216,1,1,576,1655,1079
27217,1,1,1022,1350,328
27218,0,0,86,0,-86
27219,1,1,557,1361,804
27220,1,0,33,0,-33
27221,0,0,20,0,-20
27222,1,0,90,0,-90
27223,0,0,78,0,-78
27224,1,0,6,0,-6
27225,0,0,87,0,-87
27226,0,0,98,0,-98
27227,0,0,59,0,-59
27228,0,0,16,0,-16
27229,1,1,838,2134,1296
27230,1,0,30,0,-30
27231,0,0,12,0,-12
27232,1,0,20,0,-20
27233,1,1,654,1348,694
27234,1,0,156,0,-156
27235,1,1,864,1703,839
27236,0,0,136,0,-136
27237,1,0,27,0,-27
27238,0,0,42,0,-42
27239,1,0,18,0,-18
27240,0,0,6,0,-6
27241,1,1,1729,1891,162
27242,1,0,7,0,-7
27243,0,0,16,0,-16
27244,0,0,14,0,-14
27245,0,0,105,0,-105
27246,1,0,54,0,-54
27247,1,0,150,0,-150
27248,1,0,5,0,-5
27249,1,0,89,0,-89
27250,0,0,45,0,-45
27251,1,0,75,0,-75
27252,1,1,63,1296,1233
27253,0,0,30,0,-30
27254,0,0,56,0,-56
27255,0,0,58,0,-58
27256,1,0,2,0,-2
27257,1,1,72,1490,1418
27258,0,0,58,0,-58
27259,1,0,79,0,-79
27260,1,0,45,0,-45
27261,0,0,6,0,-6
27262,1,0,106,0,-106
27263,1,0,75,0,-75
27264,1,0,82,0,-82
27265,1,1,339,1276,937
27266,0,0,15,0,-15
27267,0,0,50,0,-50
27268,1,1,284,1475,1191
27269,1,1,118,1257,1139
27270,1,1,560,1908,1348
27271,1,0,6,0,-6
27272,0,0,137,0,-137
27273,1,1,1396,1603,207
27274,1,1,578,1307,729
27275,0,0,26,0,-26
27276,1,0,3,0,-3
27277,1,1,425,3016,2591
27278,1,0,27,0,-27
27279,0,0,38,0,-38
27280,1,1,408,1418,1010
27281,1,1,588,2570,1982
27282,1,1,91,1284,1193
27283,1,0,105,0,-105
27284,0,0,29,0,-29
27285,1,0,130,0,-130
27286,0,0,4,0,-4
27287,0,0,128,0,-128
27288,1,1,1270,1670,400
27289,0,0,62,0,-62
27290,1,0,108,0,-108
27291,1,1,107,1354,1247
27292,1,1,1359,1331,-28
27293,0,0,52,0,-52
27294,0,0,8,0,-8
27295,0,0,60,0,-60
27296,1,1,454,2104,1650
27297,0,0,8,0,-8
27298,1,0,21,0,-21
27299,0,0,55,0,-55
27300,0,0,67,0,-67
27301,1,0,15,0,-15
27302,1,0,9,0,-9
27303,0,0,9,0,-9
27304,1,0,26,0,-26
27305,1,0,99,0,-99
27306,1,0,35,0,-35
27307,1,1,927,1587,660
27308,0,0,34,0,-34
27309,1,0,91,0,-91
27310,1,1,841,1609,768
27311,1,0,15,0,-15
27312,1,0,88,0,-88
27313,1,0,41,0,-41
27314,0,0,12,0,-12
27315,1,0,4,0,-4
27316,1,0,16,0,-16
27317,0,0,2,0,-2
27318,1,1,88,1559,1471
27319,1,1,854,1243,389
27320,0,0,9,0,-9
27321,1,1,715,1540,825
27322,1,1,542,1237,695
27323,1,1,207,1308,1101
27324,0,0,39,0,-39
27325,0,0,10,0,-10
27326,1,0,13,0,-13
27327,1,1,228,1250,1022
27328,0,0,61,0,-61
27329,1,1,385,6162,5777
27330,1,0,5,0,-5
27331,0,0,4,0,-4
27332,1,1,799,1501,702
27333,1,1,745,1413,668
27334,0,0,105,0,-105
27335,0,0,83,0,-83
27336,1,1,2954,1521,-1433
27337,0,0,10,0,-10
27338,1,0,8,0,-8
27339,0,0,79,0,-79
27340,1,0,85,0,-85
27341,1,1,258,2066,1808
27342,1,1,684,1360,676
27343,0,0,89,0,-89
27344,1,1,110,1278,1168
27345,1,1,93,1852,1759
27346,1,0,2,0,-2
27347,1,1,1045,2048,1003
27348,0,0,57,0,-57
27349,0,0,45,0,-45
27350,1,0,70,0,-70
27351,1,0,58,0,-58
27352,0,0,71,0,-71
27353,0,0,14,0,-14
27354,1,0,54,0,-54
27355,1,1,493,1411,918
27356,0,0,26,0,-26
27357,1,0,11,0,-11
27358,1,0,31,0,-31
27359,1,0,115,0,-115
27360,1,0,1,0,-1
27361,1,1,1482,1391,-91
27362,1,0,50,0,-50
27363,1,0,6,0,-6
27364,0,0,16,0,-16
27365,1,1,281,1325,1044
27366,0,0,48,0,-48
27367,1,1,158,1392,1234
27368,1,1,944,2868,1924
27369,1,0,67,0,-67
27370,0,0,80,0,-80
27371,0,0,177,0,-177
27372,0,0,163,0,-163
27373,1,1,487,2175,1688
27374,0,0,63,0,-63
27375,1,1,472,1246,774
27376,0,0,2,0,-2
27377,1,1,132,1266,1134
27378,1,0,115,0,-115
27379,0,0,33,0,-33
27380,0,0,20,0,-20
27381,0,0,27,0,-27
27382,1,0,65,0,-65
27383,1,0,102,0,-102
27384,1,0,5,0,-5
27385,0,0,27,0,-27
27386,1,1,180,1561,1381
27387,0,0,108,0,-108
27388,1,0,58,0,-58
27389,1,1,164,1351,1187
27390,1,1,696,1323,627
27391,1,1,365,1690,1325
27392,0,0,33,0,-33
27393,0,0,31,0,-31
27394,0,0,57,0,-57
27395,1,1,167,1875,1708
27396,0,0,51,0,-51
27397,0,0,10,0,-10
27398,1,1,22,1357,1335
27399,0,0,22,0,-22
27400,1,0,54,0,-54
27401,1,0,24,0,-24
27402,0,0,19,0,-19
27403,1,0,20,0,-20
27404,1,0,22,0,-22
27405,1,1,1198,1424,226
27406,0,0,19,0,-19
27407,0,0,75,0,-75
27408,1,1,125,1365,1240
27409,0,0,12,0,-12
27410,1,0,2,0,-2
27411,1,0,35,0,-35
27412,1,0,7,0,-7
27413,0,0,35,0,-35
27414,0,0,12,0,-12
27415,1,1,511,1247,736
27416,0,0,78,0,-78
27417,0,0,46,0,-46
27418,1,1,768,1650,882
27419,0,0,35,0,-35
27420,1,1,239,1582,1343
27421,1,1,329,2412,2083
27422,0,0,112,0,-112
27423,0,0,1,0,-1
27424,1,0,75,0,-75
27425,1,1,294,2008,1714
27426,1,0,0,0,0
27427,0,0,111,0,-111
27428,0,0,5,0,-5
27429,0,0,36,0,-36
27430,1,1,262,1521,1259
27431,0,0,30,0,-30
27432,0,0,7,0,-7
27433,1,0,15,0,-15
27434,1,0,40,0,-40
27435,1,0,23,0,-23
27436,0,0,16,0,-16
27437,0,0,305,0,-305
27438,0,0,92,0,-92
27439,0,0,21,0,-21
27440,1,1,1176,1273,97
27441,1,0,146,0,-146
27442,1,1,2006,1488,-518
27443,0,0,42,0,-42
27444,1,0,137,0,-137
27445,1,1,178,1385,1207
27446,0,0,47,0,-47
27447,1,1,1005,1238,233
27448,1,0,61,0,-61
27449,1,0,36,0,-36
27450,0,0,0,0,0
27451,1,1,300,1271,971
27452,0,0,78,0,-78
27453,1,1,1125,1357,232
27454,1,1,576,1863,1287
27455,0,0,18,0,-18
27456,0,0,24,0,-24
27457,1,1,135,1704,1569
27458,1,1,254,1305,1051
27459,0,0,126,0,-126
27460,0,0,20,0,-20
27461,0,0,18,0,-18
27462,1,1,78,1511,1433
27463,1,0,46,0,-46
27464,0,0,25,0,-25
27465,0,0,109,0,-109
27466,0,0,52,0,-52
27467,1,0,33,0,-33
27468,0,0,47,0,-47
27469,1,1,280,1574,1294
27470,0,0,41,0,-41
27471,1,1,248,1801,1553
27472,1,1,185,1850,1665
27473,0,0,8,0,-8
27474,1,1,98,1508,1410
27475,1,1,355,1347,992
27476,1,1,312,1405,1093
27477,0,0,11,0,-11
27478,1,1,211,1375,1164
27479,1,1,1029,1498,469
27480,1,0,13,0,-13
27481,0,0,0,0,0
27482,1,1,1958,1729,-229
27483,1,1,435,1557,1122
27484,1,1,814,1751,937
27485,1,0,33,0,-33
27486,1,0,1,0,-1
27487,1,1,84,1395,1311
27488,1,1,138,1939,1801
27489,1,1,846,2138,1292
27490,0,0,81,0,-81
27491,0,0,45,0,-45
27492,0,0,52,0,-52
27493,1,0,0,0,0
27494,0,0,159,0,-159
27495,1,0,18,0,-18
27496,0,0,4,0,-4
27497,0,0,8,0,-8
27498,0,0,19,0,-19
27499,1,0,44,0,-44
27500,1,0,2,0,-2
27501,1,0,24,0,-24
27502,1,0,1,0,-1
27503,1,1,64,1339,1275
27504,0,0,52,0,-52
27505,1,1,183,1614,1431
27506,1,0,6,0,-6
27507,1,0,65,0,-65
27508,1,1,319,2736,2417
27509,0,0,22,0,-22
27510,0,0,5,0,-5
27511,0,0,109,0,-109
27512,1,0,81,0,-81
27513,0,0,47,0,-47
27514,1,0,160,0,-160
27515,0,0,13,0,-13
27516,0,0,64,0,-64
27517,1,1,804,1809,1005
27518,1,0,74,0,-74
27519,1,0,13,0,-13
27520,1,1,180,1497,1317
27521,1,1,994,1800,806
27522,1,0,37,0,-37
27523,0,0,167,0,-167
27524,1,0,62,0,-62
27525,1,1,602,1745,1143
27526,0,0,10,0,-10
27527,1,0,62,0,-62
27528,1,1,380,1481,1101
27529,0,0,136,0,-136
27530,0,0,4,0,-4
27531,1,1,1466,1240,-226
27532,1,1,177,1747,1570
27533,1,0,45,0,-45
27534,1,0,63,0,-63
27535,1,1,224,1444,1220
27536,0,0,12,0,-12
27537,0,0,83,0,-83
27538,1,0,45,0,-45
27539,1,1,204,2026,1822
27540,0,0,33,0,-33
27541,1,1,272,1266,994
27542,0,0,36,0,-36
27543,1,0,7,0,-7
27544,1,1,170,1316,1146
27545,1,1,493,1390,897
27546,0,0,25,0,-25
27547,1,1,473,1902,1429
27548,0,0,20,0,-20
27549,0,0,47,0,-47
27550,1,1,640,1749,1109
27551,0,0,43,0,-43
27552,1,0,2,0,-2
27553,1,0,4,0,-4
27554,0,0,46,0,-46
27555,1,1,112,1769,1657
27556,0,0,10,0,-10
27557,0,0,9,0,-9
27558,0,0,6,0,-6
27559,1,0,29,0,-29
27560,1,1,464,1383,919
27561,1,0,177,0,-177
27562,1,0,62,0,-62
27563,1,1,132,2943,2811
27564,0,0,26,0,-26
27565,0,0,86,0,-86
27566,1,0,17,0,-17
27567,0,0,62,0,-62
27568,0,0,10,0,-10
27569,0,0,6,0,-6
27570,0,0,95,0,-95
27571,0,0,17,0,-17
27572,0,0,121,0,-121
27573,1,1,389,1522,1133
27574,0,0,7,0,-7
27575,1,1,330,1239,909
27576,1,1,256,1956,1700
27577,0,0,17,0,-17
27578,0,0,54,0,-54
27579,0,0,0,0,0
27580,1,0,142,0,-142
27581,1,0,13,0,-13
27582,1,1,1322,3052,1730
27583,0,0,14,0,-14
27584,0,0,9,0,-9
27585,0,0,112,0,-112
27586,1,1,339,1683,1344
27587,1,1,2372,1368,-1004
27588,1,0,63,0,-63
27589,0,0,81,0,-81
27590,0,0,95,0,-95
27591,0,0,53,0,-53
27592,1,1,244,1450,1206
27593,1,1,2067,1250,-817
27594,0,0,42,0,-42
27595,1,1,510,1743,1233
27596,0,0,14,0,-14
27597,1,1,352,1679,1327
27598,0,0,111,0,-111
27599,1,1,1087,1487,400
27600,1,0,9,0,-9
27601,1,1,1506,1282,-224
27602,1,0,124,0,-124
27603,0,0,192,0,-192
27604,1,1,832,1397,565
27605,0,0,46,0,-46
27606,1,0,221,0,-221
27607,0,0,14,0,-14
27608,1,1,166,1263,1097
27609,1,0,1,0,-1
27610,1,1,33,1608,1575
27611,1,0,52,0,-52
27612,0,0,86,0,-86
27613,1,1,493,1522,1029
27614,1,1,352,1309,957
27615,0,0,80,0,-80
27616,0,0,45,0,-45
27617,0,0,31,0,-31
27618,0,0,2,0,-2
27619,0,0,11,0,-11
27620,0,0,40,0,-40
27621,0,0,123,0,-123
27622,1,1,41,1272,1231
27623,0,0,6,0,-6
27624,1,0,7,0,-7
27625,0,0,28,0,-28
27626,0,0,26,0,-26
27627,1,1,244,1873,1629
27628,0,0,20,0,-20
27629,0,0,4,0,-4
27630,1,1,435,10960,10525
27631,0,0,4,0,-4
27632,0,0,16,0,-16
27633,0,0,22,0,-22
27634,0,0,55,0,-55
27635,0,0,9,0,-9
27636,0,0,17,0,-17
27637,1,1,208,1325,1117
27638,0,0,28,0,-28
27639,1,1,291,1262,971
27640,0,0,21,0,-21
27641,1,1,331,2131,1800
27642,1,0,14,0,-14
27643,0,0,103,0,-103
27644,0,0,32,0,-32
27645,1,1,1010,1627,617
27646,1,1,438,1505,1067
27647,1,0,9,0,-9
27648,1,0,168,0,-168
27649,1,0,40,0,-40
27650,1,1,38,1263,1225
27651,1,1,942,1254,312
27652,1,1,1939,1415,-524
27653,1,1,218,1442,1224
27654,1,0,39,0,-39
27655,1,1,248,1891,1643
27656,0,0,50,0,-50
27657,1,0,1,0,-1
27658,0,0,34,0,-34
27659,1,0,30,0,-30
27660,0,0,32,0,-32
27661,1,1,142,1459,1317
27662,1,0,106,0,-106
27663,0,0,28,0,-28
27664,1,0,17,0,-17
27665,1,0,126,0,-126
27666,0,0,162,0,-162
27667,0,0,10,0,-10
27668,1,0,1,0,-1
27669,0,0,0,0,0
27670,0,0,27,0,-27
27671,1,0,65,0,-65
27672,0,0,41,0,-41
27673,0,0,17,0,-17
27674,1,0,6,0,-6
27675,1,0,15,0,-15
27676,0,0,178,0,-178
27677,1,0,20,0,-20
27678,1,0,41,0,-41
27679,0,0,18,0,-18
27680,1,1,773,1314,541
27681,1,0,47,0,-47
27682,1,1,98,2371,2273
27683,0,0,19,0,-19
27684,1,1,53,1562,1509
27685,1,0,20,0,-20
27686,0,0,31,0,-31
27687,1,1,189,1364,1175
27688,1,0,0,0,0
27689,0,0,23,0,-23
27690,1,1,186,1367,1181
27691,1,0,21,0,-21
27692,1,0,39,0,-39
27693,1,0,27,0,-27
27694,1,1,497,1331,834
27695,1,0,111,0,-111
27696,0,0,46,0,-46
27697,0,0,20,0,-20
27698,0,0,166,0,-166
27699,1,0,15,0,-15
27700,1,1,455,1516,1061
27701,1,1,382,1545,1163
27702,1,1,479,1335,856
27703,1,0,160,0,-160
27704,0,0,16,0,-16
27705,1,1,189,1246,1057
27706,0,0,14,0,-14
27707,1,0,73,0,-73
27708,1,0,49,0,-49
27709,0,0,138,0,-138
27710,1,0,21,0,-21
27711,1,0,94,0,-94
27712,1,1,325,1341,1016
27713,0,0,1,0,-1
27714,1,0,30,0,-30
27715,1,1,164,1432,1268
27716,1,0,268,0,-268
27717,0,0,8,0,-8
27718,1,0,22,0,-22
27719,0,0,29,0,-29
27720,1,0,4,0,-4
27721,0,0,69,0,-69
27722,1,0,40,0,-40
27723,0,0,109,0,-109
27724,1,1,657,1819,1162
27725,1,0,17,0,-17
27726,0,0,101,0,-101
27727,1,1,101,1277,1176
27728,1,0,26,0,-26
27729,1,1,851,1312,461
27730,1,0,16,0,-16
27731,1,0,74,0,-74
27732,1,1,64,1515,1451
27733,1,1,533,1348,815
27734,0,0,21,0,-21
27735,1,0,0,0,0
27736,0,0,157,0,-157
27737,1,0,17,0,-17
27738,1,1,233,1566,1333
27739,1,1,439,1816,1377
27740,1,0,35,0,-35
27741,1,0,42,0,-42
27742,1,1,421,1322,901
27743,1,1,349,1434,1085
27744,0,0,14,0,-14
27745,1,1,244,1414,1170
27746,1,1,1443,1804,361
27747,1,1,628,1305,677
27748,1,0,115,0,-115
27749,0,0,41,0,-41
27750,1,0,42,0,-42
27751,1,0,149,0,-149
27752,0,0,185,0,-185
27753,0,0,112,0,-112
27754,0,0,4,0,-4
27755,1,0,12,0,-12
27756,1,0,11,0,-11
27757,1,1,526,1472,946
27758,0,0,34,0,-34
27759,1,0,1,0,-1
27760,1,0,26,0,-26
27761,0,0,0,0,0
27762,0,0,1,0,-1
27763,1,0,26,0,-26
27764,1,0,24,0,-24
27765,1,0,28,0,-28
27766,1,0,15,0,-15
27767,0,0,2,0,-2
27768,1,0,59,0,-59
27769,0,0,16,0,-16
27770,0,0,7,0,-7
27771,1,1,1328,1387,59
27772,0,0,24,0,-24
27773,1,0,63,0,-63
27774,0,0,77,0,-77
27775,1,0,36,0,-36
27776,1,0,2,0,-2
27777,1,1,549,1309,760
27778,1,1,1674,1284,-390
27779,1,1,255,1499,1244
27780,0,0,63,0,-63
27781,0,0,12,0,-12
27782,1,0,35,0,-35
27783,0,0,13,0,-13
27784,1,0,45,0,-45
27785,1,1,69,1431,1362
27786,1,0,85,0,-85
27787,1,1,303,1508,1205
27788,1,0,22,0,-22
27789,1,1,962,1588,626
27790,0,0,78,0,-78
27791,0,0,11,0,-11
27792,1,0,12,0,-12
27793,0,0,34,0,-34
27794,0,0,39,0,-39
27795,1,1,674,1636,962
27796,1,1,2016,1717,-299
27797,1,0,53,0,-53
27798,0,0,32,0,-32
27799,0,0,45,0,-45
27800,1,1,786,1385,599
27801,1,1,644,1262,618
27802,1,0,12,0,-12
27803,1,0,5,0,-5
27804,1,1,93,3266,3173
27805,1,1,1205,1630,425
27806,0,0,102,0,-102
27807,1,1,1664,1428,-236
27808,0,0,85,0,-85
27809,0,0,26,0,-26
27810,1,0,74,0,-74
27811,1,0,19,0,-19
27812,1,0,97,0,-97
27813,1,1,354,1561,1207
27814,0,0,34,0,-34
27815,0,0,15,0,-15
27816,1,0,16,0,-16
27817,0,0,27,0,-27
27818,0,0,271,0,-271
27819,0,0,5,0,-5
27820,1,1,936,1427,491
27821,1,0,7,0,-7
27822,1,0,91,0,-91
27823,0,0,20,0,-20
27824,0,0,11,0,-11
27825,1,0,53,0,-53
27826,0,0,1,0,-1
27827,1,1,283,1334,1051
27828,1,0,8,0,-8
27829,1,0,16,0,-16
27830,0,0,32,0,-32
27831,1,1,48,1783,1735
27832,0,0,36,0,-36
27833,1,1,521,1557,1036
27834,1,0,21,0,-21
27835,1,1,337,1450,1113
27836,0,0,149,0,-149
27837,0,0,48,0,-48
27838,1,0,99,0,-99
27839,1,1,498,1809,1311
27840,1,0,64,0,-64
27841,1,0,25,0,-25
27842,1,0,20,0,-20
27843,1,1,1297,1821,524
27844,1,0,11,0,-11
27845,0,0,21,0,-21
27846,0,0,57,0,-57
27847,1,0,105,0,-105
27848,1,1,674,1547,873
27849,0,0,14,0,-14
27850,1,1,698,1393,695
27851,0,0,14,0,-14
27852,0,0,167,0,-167
27853,0,0,49,0,-49
27854,0,0,9,0,-9
27855,1,0,81,0,-81
27856,0,0,54,0,-54
27857,0,0,39,0,-39
27858,1,1,269,1822,1553
27859,1,1,1325,2310,985
27860,1,1,2142,1264,-878
27861,0,0,93,0,-93
27862,1,0,224,0,-224
27863,1,0,110,0,-110
27864,0,0,76,0,-76
27865,1,0,88,0,-88
27866,0,0,153,0,-153
27867,0,0,55,0,-55
27868,0,0,130,0,-130
27869,1,1,440,1637,1197
27870,1,1,961,1394,433
27871,0,0,48,0,-48
27872,1,0,25,0,-25
27873,1,0,5,0,-5
27874,0,0,24,0,-24
27875,0,0,105,0,-105
27876,1,0,60,0,-60
27877,0,0,54,0,-54
27878,0,0,89,0,-89
27879,1,0,5,0,-5
27880,1,0,88,0,-88
27881,1,0,31,0,-31
27882,0,0,18,0,-18
27883,1,1,434,1258,824
27884,0,0,28,0,-28
27885,1,1,238,1281,1043
27886,1,1,1691,1543,-148
27887,1,1,446,1244,798
27888,1,0,17,0,-17
27889,1,0,52,0,-52
27890,1,1,727,1276,549
27891,1,1,301,1917,1616
27892,0,0,81,0,-81
27893,1,1,1742,1241,-501
27894,0,0,58,0,-58
27895,1,1,943,1415,472
27896,0,0,18,0,-18
27897,1,1,185,1554,1369
27898,1,1,954,1968,1014
27899,1,0,106,0,-106
27900,0,0,12,0,-12
27901,1,1,615,1787,1172
27902,0,0,105,0,-105
27903,1,1,74,1457,1383
27904,1,1,717,1354,637
27905,0,0,12,0,-12
27906,0,0,1,0,-1
27907,1,0,10,0,-10
27908,1,0,35,0,-35
27909,0,0,20,0,-20
27910,0,0,5,0,-5
27911,1,0,19,0,-19
27912,0,0,1,0,-1
27913,0,0,106,0,-106
27914,0,0,56,0,-56
27915,0,0,19,0,-19
27916,1,0,0,0,0
27917,1,0,17,0,-17
27918,1,0,20,0,-20
27919,0,0,23,0,-23
27920,0,0,3,0,-3
27921,1,0,187,0,-187
27922,0,0,7,0,-7
27923,1,0,12,0,-12
27924,1,0,6,0,-6
27925,0,0,5,0,-5
27926,1,0,46,0,-46
27927,1,1,529,1591,1062
27928,0,0,87,0,-87
27929,1,1,1216,2274,1058
27930,0,0,28,0,-28
27931,0,0,115,0,-115
27932,0,0,107,0,-107
27933,1,0,7,0,-7
27934,1,0,3,0,-3
27935,1,1,207,1352,1145
27936,1,0,35,0,-35
27937,0,0,7,0,-7
27938,1,1,722,2178,1456
27939,1,1,710,1918,1208
27940,0,0,3,0,-3
27941,1,0,36,0,-36
27942,1,1,65,1494,1429
27943,1,1,275,1294,1019
27944,0,0,33,0,-33
27945,0,0,69,0,-69
27946,0,0,23,0,-23
27947,0,0,36,0,-36
27948,0,0,1,0,-1
27949,0,0,166,0,-166
27950,0,0,13,0,-13
27951,0,0,18,0,-18
27952,1,0,3,0,-3
27953,0,0,92,0,-92
27954,1,1,222,1978,1756
27955,1,1,299,1515,1216
27956,1,1,432,1436,1004
27957,0,0,25,0,-25
27958,0,0,27,0,-27
27959,0,0,49,0,-49
27960,0,0,7,0,-7
27961,0,0,5,0,-5
27962,1,0,73,0,-73
27963,0,0,80,0,-80
27964,0,0,143,0,-143
27965,1,0,27,0,-27
27966,1,0,65,0,-65
27967,0,0,41,0,-41
27968,1,0,34,0,-34
27969,1,0,19,0,-19
27970,0,0,76,0,-76
27971,1,0,87,0,-87
27972,0,0,25,0,-25
27973,1,0,65,0,-65
27974,1,1,355,1704,1349
27975,1,1,220,1671,1451
27976,1,1,221,2875,2654
27977,1,0,166,0,-166
27978,1,1,197,1317,1120
27979,1,0,96,0,-96
27980,1,1,474,1527,1053
27981,0,0,32,0,-32
27982,0,0,14,0,-14
27983,1,1,48,3761,3713
27984,1,0,30,0,-30
27985,1,0,503,0,-503
27986,1,1,571,1283,712
27987,1,0,25,0,-25
27988,1,0,33,0,-33
27989,1,1,438,1646,1208
27990,1,1,545,1398,853
27991,1,1,245,1515,1270
27992,0,0,54,0,-54
27993,1,0,5,0,-5
27994,1,1,106,1332,1226
27995,0,0,7,0,-7
27996,0,0,2,0,-2
27997,0,0,183,0,-183
27998,1,1,158,1835,1677
27999,1,1,285,2127,1842
28000,0,0,31,0,-31
28001,0,0,56,0,-56
28002,1,0,22,0,-22
28003,0,0,84,0,-84
28004,0,0,19,0,-19
28005,1,1,214,1818,1604
28006,0,0,23,0,-23
28007,0,0,163,0,-163
28008,0,0,22,0,-22
28009,0,0,113,0,-113
28010,1,0,4,0,-4
28011,1,1,180,1310,1130
28012,0,0,146,0,-146
28013,0,0,10,0,-10
28014,0,0,54,0,-54
28015,1,1,1366,1520,154
28016,1,0,69,0,-69
28017,0,0,7,0,-7
28018,0,0,2,0,-2
28019,0,0,108,0,-108
28020,0,0,8,0,-8
28021,0,0,34,0,-34
28022,0,0,76,0,-76
28023,1,0,7,0,-7
28024,0,0,48,0,-48
28025,1,1,107,1735,1628
28026,0,0,52,0,-52
28027,1,0,13,0,-13
28028,1,1,296,1482,1186
28029,1,0,8,0,-8
28030,0,0,8,0,-8
28031,1,0,35,0,-35
28032,1,0,1,0,-1
28033,1,1,1230,2578,1348
28034,1,0,174,0,-174
28035,1,1,443,1923,1480
28036,1,1,155,1646,1491
28037,0,0,3,0,-3
28038,0,0,86,0,-86
28039,0,0,16,0,-16
28040,1,1,1760,1505,-255
28041,0,0,110,0,-110
28042,0,0,1,0,-1
28043,0,0,9,0,-9
28044,0,0,19,0,-19
28045,1,1,1452,1235,-217
28046,1,1,86,1912,1826
28047,1,0,21,0,-21
28048,1,1,723,3113,2390
28049,1,1,593,1366,773
28050,0,0,12,0,-12
28051,0,0,16,0,-16
28052,0,0,22,0,-22
28053,1,1,757,1550,793
28054,0,0,62,0,-62
28055,1,1,184,1731,1547
28056,1,0,87,0,-87
28057,1,0,28,0,-28
28058,0,0,4,0,-4
28059,0,0,9,0,-9
28060,0,0,3,0,-3
28061,0,0,11,0,-11
28062,0,0,66,0,-66
28063,1,0,112,0,-112
28064,1,1,155,1550,1395
28065,0,0,20,0,-20
28066,0,0,25,0,-25
28067,0,0,0,0,0
28068,0,0,5,0,-5
28069,1,0,6,0,-6
28070,0,0,15,0,-15
28071,0,0,111,0,-111
28072,0,0,49,0,-49
28073,1,0,91,0,-91
28074,1,0,49,0,-49
28075,0,0,6,0,-6
28076,1,1,2429,1262,-1167
28077,0,0,39,0,-39
28078,0,0,74,0,-74
28079,0,0,27,0,-27
28080,0,0,38,0,-38
28081,1,1,499,2270,1771
28082,0,0,8,0,-8
28083,1,0,30,0,-30
28084,0,0,54,0,-54
28085,1,1,370,2333,1963
28086,0,0,28,0,-28
28087,1,0,42,0,-42
28088,1,0,37,0,-37
28089,0,0,17,0,-17
28090,1,0,128,0,-128
28091,1,1,52,1263,1211
28092,1,1,35,1404,1369
28093,0,0,6,0,-6
28094,1,0,6,0,-6
28095,0,0,32,0,-32
28096,0,0,0,0,0
28097,0,0,27,0,-27
28098,0,0,139,0,-139
28099,1,0,41,0,-41
28100,1,0,95,0,-95
28101,1,0,13,0,-13
28102,0,0,48,0,-48
28103,0,0,57,0,-57
28104,0,0,111,0,-111
28105,1,1,127,1469,1342
28106,1,0,18,0,-18
28107,1,1,1329,1311,-18
28108,0,0,167,0,-167
28109,1,1,1705,1522,-183
28110,1,1,516,2047,1531
28111,0,0,137,0,-137
28112,1,0,27,0,-27
28113,0,0,39,0,-39
28114,1,1,880,1375,495
28115,0,0,2,0,-2
28116,0,0,66,0,-66
28117,1,1,728,1368,640
28118,0,0,9,0,-9
28119,1,1,425,1266,841
28120,1,0,15,0,-15
28121,1,1,1846,1927,81
28122,1,1,519,2005,1486
28123,1,1,1337,1475,138
28124,0,0,3,0,-3
28125,0,0,41,0,-41
28126,1,0,0,0,0
28127,1,0,80,0,-80
28128,1,1,182,1531,1349
28129,0,0,83,0,-83
28130,1,0,9,0,-9
28131,1,0,51,0,-51
28132,0,0,55,0,-55
28133,0,0,4,0,-4
28134,0,0,13,0,-13
28135,1,0,111,0,-111
28136,1,1,419,1621,1202
28137,1,1,258,1935,1677
28138,1,1,102,1400,1298
28139,1,1,356,1302,946
28140,0,0,20,0,-20
28141,1,0,5,0,-5
28142,1,0,8,0,-8
28143,0,0,1,0,-1
28144,1,1,321,1291,970
28145,1,0,44,0,-44
28146,1,0,51,0,-51
28147,0,0,22,0,-22
28148,0,0,140,0,-140
28149,1,1,43,1534,1491
28150,1,0,75,0,-75
28151,0,0,21,0,-21
28152,1,1,708,1328,620
28153,1,1,247,1449,1202
28154,0,0,23,0,-23
28155,0,0,27,0,-27
28156,0,0,72,0,-72
28157,1,1,474,1957,1483
28158,0,0,69,0,-69
28159,0,0,82,0,-82
28160,0,0,77,0,-77
28161,0,0,0,0,0
28162,1,0,37,0,-37
28163,1,0,5,0,-5
28164,0,0,51,0,-51
28165,0,0,4,0,-4
28166,1,1,6,2132,2126
28167,0,0,9,0,-9
28168,1,1,357,1366,1009
28169,1,1,38,1624,1586
28170,1,0,30,0,-30
28171,0,0,58,0,-58
28172,0,0,2,0,-2
28173,1,0,21,0,-21
28174,1,0,38,0,-38
28175,1,1,434,1798,1364
28176,1,1,2716,1638,-1078
28177,0,0,114,0,-114
28178,0,0,62,0,-62
28179,0,0,8,0,-8
28180,1,1,216,2021,1805
28181,1,0,67,0,-67
28182,1,1,174,1434,1260
28183,1,1,141,1396,1255
28184,1,1,1043,2044,1001
28185,1,0,1,0,-1
28186,0,0,133,0,-133
28187,1,0,20,0,-20
28188,1,1,708,1419,711
28189,1,1,176,1430,1254
28190,1,1,258,1945,1687
28191,0,0,52,0,-52
28192,1,0,25,0,-25
28193,0,0,29,0,-29
28194,1,0,41,0,-41
28195,0,0,0,0,0
28196,1,0,5,0,-5
28197,0,0,82,0,-82
28198,1,0,122,0,-122
28199,1,1,47,1518,1471
28200,1,1,163,1295,1132
28201,1,0,20,0,-20
28202,1,0,5,0,-5
28203,1,1,435,1337,902
28204,1,0,6,0,-6
28205,1,0,75,0,-75
28206,1,1,61,1341,1280
28207,0,0,198,0,-198
28208,0,0,25,0,-25
28209,0,0,29,0,-29
28210,0,0,51,0,-51
28211,0,0,42,0,-42
28212,0,0,37,0,-37
28213,1,0,16,0,-16
28214,0,0,84,0,-84
28215,0,0,2,0,-2
28216,1,0,15,0,-15
28217,1,0,50,0,-50
28218,0,0,51,0,-51
28219,0,0,59,0,-59
28220,1,1,444,1508,1064
28221,1,1,268,1557,1289
28222,0,0,165,0,-165
28223,0,0,0,0,0
28224,1,0,46,0,-46
28225,0,0,85,0,-85
28226,0,0,36,0,-36
28227,1,0,14,0,-14
28228,1,1,153,1783,1630
28229,1,0,9,0,-9
28230,0,0,55,0,-55
28231,1,0,4,0,-4
28232,0,0,17,0,-17
28233,0,0,50,0,-50
28234,0,0,37,0,-37
28235,0,0,118,0,-118
28236,1,1,100,1303,1203
28237,0,0,98,0,-98
28238,1,1,260,2093,1833
28239,0,0,56,0,-56
28240,1,1,828,1261,433
28241,1,0,111,0,-111
28242,1,0,5,0,-5
28243,1,1,342,1300,958
28244,1,1,42,1386,1344
28245,1,0,46,0,-46
28246,0,0,103,0,-103
28247,0,0,11,0,-11
28248,0,0,18,0,-18
28249,1,0,52,0,-52
28250,0,0,25,0,-25
28251,0,0,49,0,-49
28252,1,1,568,2401,1833
28253,1,0,11,0,-11
28254,0,0,41,0,-41
28255,1,1,206,2137,1931
28256,1,1,223,1725,1502
28257,1,1,184,1239,1055
28258,1,1,263,1270,1007
28259,0,0,36,0,-36
28260,0,0,62,0,-62
28261,1,0,80,0,-80
28262,1,1,343,1318,975
28263,0,0,4,0,-4
28264,1,1,126,1354,1228
28265,0,0,99,0,-99
28266,0,0,91,0,-91
28267,1,1,1871,1609,-262
28268,1,1,159,1628,1469
28269,1,0,99,0,-99
28270,0,0,24,0,-24
28271,1,0,2,0,-2
28272,0,0,68,0,-68
28273,1,0,16,0,-16
28274,0,0,63,0,-63
28275,1,1,214,1263,1049
28276,0,0,47,0,-47
28277,1,1,53,1368,1315
28278,0,0,69,0,-69
28279,0,0,118,0,-118
28280,0,0,53,0,-53
28281,1,0,211,0,-211
28282,0,0,7,0,-7
28283,1,0,65,0,-65
28284,1,0,5,0,-5
28285,1,1,189,1369,1180
28286,0,0,11,0,-11
28287,0,0,39,0,-39
28288,1,1,2589,2120,-469
28289,0,0,45,0,-45
28290,1,1,790,2782,1992
28291,0,0,49,0,-49
28292,0,0,96,0,-96
28293,1,1,460,1588,1128
28294,1,0,34,0,-34
28295,1,0,48,0,-48
28296,0,0,71,0,-71
28297,1,0,29,0,-29
28298,1,0,32,0,-32
28299,1,1,259,1470,1211
28300,0,0,6,0,-6
28301,1,1,926,1409,483
28302,0,0,62,0,-62
28303,0,0,11,0,-11
28304,0,0,121,0,-121
28305,1,0,100,0,-100
28306,1,1,54,1728,1674
28307,0,0,48,0,-48
28308,1,0,0,0,0
28309,1,1,1782,1485,-297
28310,1,0,11,0,-11
28311,1,1,640,1818,1178
28312,1,1,190,1719,1529
28313,0,0,38,0,-38
28314,0,0,12,0,-12
28315,0,0,27,0,-27
28316,1,1,564,3741,3177
28317,0,0,84,0,-84
28318,1,1,608,1278,670
28319,1,1,1191,1305,114
28320,0,0,125,0,-125
28321,1,1,1392,1978,586
28322,1,0,107,0,-107
28323,1,0,64,0,-64
28324,1,1,254,1587,1333
28325,0,0,18,0,-18
28326,1,1,325,1249,924
28327,0,0,29,0,-29
28328,1,0,56,0,-56
28329,1,1,305,1821,1516
28330,0,0,18,0,-18
28331,1,0,88,0,-88
28332,1,1,644,1938,1294
28333,1,0,50,0,-50
28334,1,0,65,0,-65
28335,1,0,47,0,-47
28336,0,0,9,0,-9
28337,0,0,43,0,-43
28338,1,0,2,0,-2
28339,0,0,61,0,-61
28340,1,0,32,0,-32
28341,0,0,64,0,-64
28342,1,0,25,0,-25
28343,0,0,91,0,-91
28344,1,1,139,1524,1385
28345,1,1,287,1508,1221
28346,1,1,782,1307,525
28347,1,1,534,7061,6527
28348,0,0,8,0,-8
28349,1,0,9,0,-9
28350,1,0,56,0,-56
28351,0,0,46,0,-46
28352,1,1,76,1394,1318
28353,0,0,26,0,-26
28354,0,0,60,0,-60
28355,1,1,650,1626,976
28356,0,0,14,0,-14
28357,0,0,28,0,-28
28358,0,0,34,0,-34
28359,0,0,0,0,0
28360,1,1,390,1943,1553
28361,1,0,5,0,-5
28362,1,1,160,1550,1390
28363,0,0,2,0,-2
28364,1,1,892,1650,758
28365,0,0,0,0,0
28366,1,1,311,3179,2868
28367,1,0,29,0,-29
28368,1,0,65,0,-65
28369,1,1,290,1476,1186
28370,1,1,314,1294,980
28371,1,1,91,1418,1327
28372,1,0,18,0,-18
28373,0,0,9,0,-9
28374,1,1,937,1393,456
28375,0,0,28,0,-28
28376,0,0,1,0,-1
28377,1,0,13,0,-13
28378,1,0,12,0,-12
28379,1,1,64,1728,1664
28380,1,0,59,0,-59
28381,1,1,419,2437,2018
28382,1,0,65,0,-65
28383,0,0,49,0,-49
28384,1,0,3,0,-3
28385,0,0,62,0,-62
28386,0,0,12,0,-12
28387,1,0,29,0,-29
28388,0,0,51,0,-51
28389,1,1,1079,1242,163
28390,1,1,49,1263,1214
28391,0,0,194,0,-194
28392,1,1,383,1827,1444
28393,1,1,1679,1293,-386
28394,1,1,628,1447,819
28395,0,0,100,0,-100
28396,1,0,57,0,-57
28397,1,1,951,1378,427
28398,0,0,46,0,-46
28399,0,0,19,0,-19
28400,1,1,673,1259,586
28401,1,0,164,0,-164
28402,1,0,27,0,-27
28403,1,0,9,0,-9
28404,1,0,3,0,-3
28405,0,0,75,0,-75
28406,1,0,92,0,-92
28407,0,0,96,0,-96
28408,1,1,607,1727,1120
28409,0,0,16,0,-16
28410,0,0,23,0,-23
28411,0,0,30,0,-30
28412,0,0,99,0,-99
28413,1,1,1080,1322,242
28414,0,0,6,0,-6
28415,1,0,7,0,-7
28416,0,0,12,0,-12
28417,1,0,59,0,-59
28418,1,0,68,0,-68
28419,1,1,559,1606,1047
28420,1,0,9,0,-9
28421,0,0,35,0,-35
28422,1,0,5,0,-5
28423,1,0,59,0,-59
28424,0,0,90,0,-90
28425,0,0,11,0,-11
28426,0,0,35,0,-35
28427,0,0,20,0,-20
28428,1,1,1558,1397,-161
28429,1,0,42,0,-42
28430,0,0,100,0,-100
28431,0,0,22,0,-22
28432,1,1,1190,1520,330
28433,1,1,140,1492,1352
28434,0,0,138,0,-138
28435,1,1,377,2138,1761
28436,1,0,31,0,-31
28437,1,1,1012,1392,380
28438,0,0,44,0,-44
28439,1,0,9,0,-9
28440,1,1,481,1733,1252
28441,1,0,119,0,-119
28442,1,1,519,1258,739
28443,0,0,67,0,-67
28444,1,0,15,0,-15
28445,1,0,58,0,-58
28446,1,1,427,1362,935
28447,1,0,96,0,-96
28448,1,0,23,0,-23
28449,1,1,120,1290,1170
28450,1,1,191,1236,1045
28451,1,0,45,0,-45
28452,1,0,166,0,-166
28453,1,1,117,1633,1516
28454,1,1,180,2893,2713
28455,1,0,35,0,-35
28456,1,1,130,1484,1354
28457,0,0,0,0,0
28458,1,0,321,0,-321
28459,1,1,289,2664,2375
28460,1,1,162,1433,1271
28461,0,0,8,0,-8
28462,1,0,166,0,-166
28463,1,1,160,1334,1174
28464,1,1,939,1375,436
28465,1,1,49,1529,1480
28466,0,0,52,0,-52
28467,0,0,7,0,-7
28468,1,0,3,0,-3
28469,0,0,7,0,-7
28470,0,0,34,0,-34
28471,0,0,18,0,-18
28472,1,0,5,0,-5
28473,1,0,36,0,-36
28474,1,1,695,1411,716
28475,0,0,38,0,-38
28476,0,0,28,0,-28
28477,0,0,120,0,-120
28478,1,1,185,1433,1248
28479,1,1,86,2182,2096
28480,1,0,50,0,-50
28481,1,0,11,0,-11
28482,0,0,6,0,-6
28483,0,0,149,0,-149
28484,0,0,38,0,-38
28485,1,1,342,1730,1388
28486,1,1,395,1256,861
28487,0,0,6,0,-6
28488,0,0,78,0,-78
28489,1,0,29,0,-29
28490,1,1,1203,1486,283
28491,1,1,575,1533,958
28492,0,0,73,0,-73
28493,0,0,156,0,-156
28494,1,1,474,1290,816
28495,0,0,85,0,-85
28496,1,1,2249,1572,-677
28497,0,0,51,0,-51
28498,1,0,99,0,-99
28499,1,0,3,0,-3
28500,0,0,146,0,-146
28501,1,0,23,0,-23
28502,1,0,60,0,-60
28503,0,0,135,0,-135
28504,1,1,265,1608,1343
28505,1,1,326,1568,1242
28506,1,0,165,0,-165
28507,1,1,20,1537,1517
28508,1,1,126,1372,1246
28509,0,0,100,0,-100
28510,1,1,152,1365,1213
28511,1,1,260,1759,1499
28512,0,0,42,0,-42
28513,0,0,34,0,-34
28514,1,1,337,1333,996
28515,0,0,56,0,-56
28516,1,0,18,0,-18
28517,0,0,8,0,-8
28518,0,0,9,0,-9
28519,1,1,246,2189,1943
28520,0,0,16,0,-16
28521,1,0,59,0,-59
28522,1,1,296,1360,1064
28523,1,0,13,0,-13
28524,1,1,501,1333,832
28525,1,1,645,1700,1055
28526,1,1,1046,1538,492
28527,1,1,697,1247,550
28528,0,0,52,0,-52
28529,1,0,25,0,-25
28530,0,0,48,0,-48
28531,1,1,1051,1261,210
28532,1,0,228,0,-228
28533,0,0,102,0,-102
28534,0,0,1,0,-1
28535,0,0,48,0,-48
28536,0,0,74,0,-74
28537,1,1,1138,1369,231
28538,0,0,66,0,-66
28539,0,0,20,0,-20
28540,0,0,11,0,-11
28541,1,1,846,1886,1040
28542,0,0,69,0,-69
28543,0,0,1,0,-1
28544,0,0,141,0,-141
28545,1,0,11,0,-11
28546,1,1,402,1384,982
28547,0,0,38,0,-38
28548,0,0,33,0,-33
28549,0,0,94,0,-94
28550,1,1,120,1673,1553
28551,0,0,15,0,-15
28552,0,0,28,0,-28
28553,0,0,26,0,-26
28554,1,1,296,3353,3057
28555,0,0,4,0,-4
28556,0,0,20,0,-20
28557,1,1,181,1434,1253
28558,1,0,1,0,-1
28559,0,0,84,0,-84
28560,1,0,47,0,-47
28561,0,0,60,0,-60
28562,1,0,25,0,-25
28563,0,0,101,0,-101
28564,1,0,22,0,-22
28565,0,0,49,0,-49
28566,1,0,31,0,-31
28567,1,1,357,3565,3208
28568,1,1,610,1418,808
28569,1,0,32,0,-32
28570,0,0,77,0,-77
28571,1,1,167,2356,2189
28572,1,1,1121,2436,1315
28573,1,1,101,1822,1721
28574,0,0,37,0,-37
28575,0,0,80,0,-80
28576,1,1,490,1245,755
28577,1,1,732,2666,1934
28578,1,1,200,2752,2552
28579,1,1,931,1293,362
28580,1,1,623,1425,802
28581,0,0,28,0,-28
28582,1,0,1,0,-1
28583,1,0,175,0,-175
28584,0,0,15,0,-15
28585,1,1,329,1282,953
28586,1,0,9,0,-9
28587,1,1,751,1706,955
28588,0,0,132,0,-132
28589,1,0,7,0,-7
28590,1,0,34,0,-34
28591,1,0,4,0,-4
28592,0,0,46,0,-46
28593,0,0,30,0,-30
28594,0,0,17,0,-17
28595,1,0,46,0,-46
28596,1,0,78,0,-78
28597,0,0,57,0,-57
28598,1,0,62,0,-62
28599,1,0,148,0,-148
28600,1,1,44,1301,1257
28601,1,0,113,0,-113
28602,1,0,13,0,-13
28603,1,1,280,1243,963
28604,1,1,150,1644,1494
28605,1,0,24,0,-24
28606,1,1,244,1260,1016
28607,0,0,27,0,-27
28608,1,1,315,2532,2217
28609,0,0,120,0,-120
28610,1,1,130,1332,1202
28611,1,0,95,0,-95
28612,1,1,88,1444,1356
28613,1,1,634,1416,782
28614,0,0,33,0,-33
28615,1,1,739,1484,745
28616,1,0,66,0,-66
28617,1,1,549,1404,855
28618,1,1,249,1287,1038
28619,1,0,9,0,-9
28620,1,0,55,0,-55
28621,1,1,28,1893,1865
28622,1,1,197,1358,1161
28623,0,0,26,0,-26
28624,1,1,1063,1242,179
28625,1,1,134,1511,1377
28626,0,0,26,0,-26
28627,1,1,375,1451,1076
28628,1,1,362,1397,1035
28629,0,0,3,0,-3
28630,1,1,79,1708,1629
28631,1,0,9,0,-9
28632,1,0,46,0,-46
28633,0,0,81,0,-81
28634,1,0,12,0,-12
28635,0,0,60,0,-60
28636,0,0,39,0,-39
28637,1,1,309,1454,1145
28638,0,0,20,0,-20
28639,1,1,521,1371,850
28640,0,0,9,0,-9
28641,0,0,4,0,-4
28642,0,0,78,0,-78
28643,1,1,935,1286,351
28644,1,0,153,0,-153
28645,1,0,43,0,-43
28646,1,0,21,0,-21
28647,1,0,130,0,-130
28648,0,0,21,0,-21
28649,1,0,34,0,-34
28650,1,1,164,1367,1203
28651,1,0,18,0,-18
28652,0,0,85,0,-85
28653,1,1,625,2049,1424
28654,1,0,8,0,-8
28655,0,0,69,0,-69
28656,1,0,199,0,-199
28657,1,1,656,1751,1095
28658,1,0,5,0,-5
28659,0,0,121,0,-121
28660,0,0,57,0,-57
28661,0,0,131,0,-131
28662,0,0,129,0,-129
28663,0,0,11,0,-11
28664,1,1,83,1254,1171
28665,1,0,161,0,-161
28666,0,0,27,0,-27
28667,1,1,346,1357,1011
28668,0,0,47,0,-47
28669,1,1,1159,1486,327
28670,1,0,18,0,-18
28671,1,1,587,1869,1282
